Date,Id,AlgerianSales,SyrianSales,IndianSales,ChineseSales,EuropeanSales,TotalSales
2022-01-01,1,2389,2904,3934,3245,2113,14585
2022-01-02,1,1411,2217,2409,3841,3862,13740
2022-01-03,1,1806,2555,1292,4086,2064,11803
2022-01-04,1,3223,1872,2366,3011,2634,13106
2022-01-05,1,4528,803,2103,2633,3502,13569
2022-01-06,1,1494,1754,2871,3383,4113,13615
2022-01-07,1,2208,2744,2354,4193,2740,14239
2022-01-08,1,3836,2229,3570,2194,2715,14544
2022-01-09,1,1117,2629,1693,3005,4046,12490
2022-01-10,1,1286,2520,1738,3286,3928,12758
2022-01-11,1,4255,1893,3005,4459,4414,18026
2022-01-12,1,4486,1892,3076,2734,2805,14993
2022-01-13,1,4465,1341,3498,3585,4467,17356
2022-01-14,1,1688,2349,3073,2582,5462,15154
2022-01-15,1,2595,2945,3404,2996,3871,15811
2022-01-16,1,2025,2017,1937,1932,5804,13715
2022-01-17,1,3420,882,3556,2080,4754,14692
2022-01-18,1,1104,805,2546,3273,5387,13115
2022-01-19,1,1345,2500,3079,2779,2086,11789
2022-01-20,1,1666,2218,2942,4083,5196,16105
2022-01-21,1,3091,2267,3354,2061,2146,12919
2022-01-22,1,3614,873,3019,4234,4200,15940
2022-01-23,1,1774,2862,3545,4373,5979,18533
2022-01-24,1,2080,1521,2584,3489,2729,12403
2022-01-25,1,2655,863,3311,1602,5893,14324
2022-01-26,1,2101,2828,3590,1622,5378,15519
2022-01-27,1,4260,2979,3174,2985,4462,17860
2022-01-28,1,4331,1193,2789,3185,3783,15281
2022-01-29,1,1237,1973,3047,4214,4686,15157
2022-01-30,1,3779,1353,1516,2910,5921,15479
2022-01-31,1,4470,2596,3352,2396,4240,17054
2022-02-01,1,4990,910,3915,3684,4060,17559
2022-02-02,1,2993,1889,2293,2525,5254,14954
2022-02-03,1,4855,1890,1276,2861,3022,13904
2022-02-04,1,3221,2836,2535,3906,2372,14870
2022-02-05,1,4584,2512,2790,1762,5845,17493
2022-02-06,1,2346,1006,3917,3602,4561,15432
2022-02-07,1,4614,1613,2435,4228,2937,15827
2022-02-08,1,4813,1409,3292,1501,2449,13464
2022-02-09,1,2064,1399,1538,1562,3753,10316
2022-02-10,1,1941,1248,3683,4383,5583,16838
2022-02-11,1,1670,2390,1775,3591,5555,14981
2022-02-12,1,4796,1932,1860,2568,2321,13477
2022-02-13,1,4007,2117,2154,3415,2976,14669
2022-02-14,1,2858,818,2542,1775,2701,10694
2022-02-15,1,1874,1807,2379,2975,5786,14821
2022-02-16,1,4814,1909,3200,2624,3399,15946
2022-02-17,1,1078,2483,1497,4039,4642,13739
2022-02-18,1,4972,2735,1201,2364,3433,14705
2022-02-19,1,1164,2044,2102,3371,4431,13112
2022-02-20,1,4098,1392,1579,3838,5968,16875
2022-02-21,1,1932,1425,2198,1542,4958,12055
2022-02-22,1,2354,2308,1998,1575,5620,13855
2022-02-23,1,2326,1047,2071,3190,5613,14247
2022-02-24,1,1993,1922,3690,2234,2977,12816
2022-02-25,1,2250,2504,2033,4336,2747,13870
2022-02-26,1,4143,2366,2706,2562,2993,14770
2022-02-27,1,3079,1365,2163,3225,2583,12415
2022-02-28,1,1050,2625,3371,2129,5256,14431
2022-03-01,1,1353,1744,3486,4176,5087,15846
2022-03-02,1,4507,1282,2528,2714,4887,15918
2022-03-03,1,2694,1462,2764,3849,5419,16188
2022-03-04,1,2291,2241,3214,3709,5125,16580
2022-03-05,1,4254,2936,3388,3506,3217,17301
2022-03-06,1,3905,967,3129,3351,5219,16571
2022-03-07,1,4960,2552,3838,1634,3162,16146
2022-03-08,1,3810,1998,2888,4294,3354,16344
2022-03-09,1,2560,2143,1412,1906,4658,12679
2022-03-10,1,1867,1056,1944,3007,3625,11499
2022-03-11,1,1048,1931,3120,2843,3372,12314
2022-03-12,1,4389,893,1658,1987,4455,13382
2022-03-13,1,2210,1807,1388,2560,4071,12036
2022-03-14,1,2195,2845,1814,3353,4832,15039
2022-03-15,1,4366,2157,3376,4265,3336,17500
2022-03-16,1,4907,1998,3321,1588,2450,14264
2022-03-17,1,1140,1644,3403,2972,3331,12490
2022-03-18,1,2749,1212,2316,2377,2159,10813
2022-03-19,1,4661,2858,1445,3232,2810,15006
2022-03-20,1,1152,1653,2110,2086,4178,11179
2022-03-21,1,3902,1545,1226,4046,2910,13629
2022-03-22,1,1647,1516,3139,3546,4414,14262
2022-03-23,1,3427,1916,3229,2501,4324,15397
2022-03-24,1,1046,2260,3149,1526,4131,12112
2022-03-25,1,2362,2215,2870,2927,3451,13825
2022-03-26,1,3613,1571,2586,3273,4844,15887
2022-03-27,1,3491,2949,2687,4442,3653,17222
2022-03-28,1,2114,2923,3699,1867,2758,13361
2022-03-29,1,1461,2229,3010,2873,5283,14856
2022-03-30,1,3760,2436,1927,3955,4620,16698
2022-03-31,1,3995,2605,1923,4077,2642,15242
2022-04-01,1,3052,2135,3820,3534,2799,15340
2022-04-02,1,1399,1556,2118,3398,3018,11489
2022-04-03,1,3295,960,3134,1700,5349,14438
2022-04-04,1,4547,1917,1447,3380,2100,13391
2022-04-05,1,2837,2714,1657,3846,5847,16901
2022-04-06,1,2245,937,3780,3925,5775,16662
2022-04-07,1,3759,1799,2859,2193,2509,13119
2022-04-08,1,2583,2174,3705,2493,3379,14334
2022-04-09,1,1538,1095,1898,3491,2255,10277
2022-04-10,1,3044,1525,2784,2384,5505,15242
2022-04-11,1,2242,1648,3194,1576,3880,12540
2022-04-12,1,3995,2072,1236,1992,5519,14814
2022-04-13,1,4116,1370,1731,2786,2863,12866
2022-04-14,1,3977,2928,3974,4265,5040,20184
2022-04-15,1,1043,2941,1701,3087,3101,11873
2022-04-16,1,4121,2251,3613,1511,3109,14605
2022-04-17,1,3484,1508,1724,1676,4477,12869
2022-04-18,1,4268,2774,3999,3791,2015,16847
2022-04-19,1,2633,2732,1630,2964,2550,12509
2022-04-20,1,2755,1980,2094,2694,5926,15449
2022-04-21,1,4605,1940,1690,2246,2279,12760
2022-04-22,1,3142,2631,1471,3498,2091,12833
2022-04-23,1,1418,1452,3454,4147,5002,15473
2022-04-24,1,3109,1044,3417,2583,5991,16144
2022-04-25,1,2016,2101,1414,3414,2326,11271
2022-04-26,1,1742,2399,1718,1571,4161,11591
2022-04-27,1,3869,1975,1425,1645,4439,13353
2022-04-28,1,3796,2073,1569,2650,2744,12832
2022-04-29,1,2126,1679,2667,1720,5478,13670
2022-04-30,1,1699,2189,1823,2722,2839,11272
2022-05-01,1,1261,1232,3354,4068,2792,12707
2022-05-02,1,2054,1293,2304,3902,2145,11698
2022-05-03,1,3122,1428,1712,4251,2617,13130
2022-05-04,1,1136,2245,2017,4089,4461,13948
2022-05-05,1,3508,1443,2492,3260,4356,15059
2022-05-06,1,4189,1994,2470,2712,5668,17033
2022-05-07,1,2162,1507,2745,2760,2331,11505
2022-05-08,1,1106,2149,2746,3057,3420,12478
2022-05-09,1,3925,1250,3170,1718,3936,13999
2022-05-10,1,2558,2465,3982,1759,2839,13603
2022-05-11,1,3779,1883,3009,3525,3488,15684
2022-05-12,1,3461,2628,2775,2469,3267,14600
2022-05-13,1,4599,2763,3877,3725,4367,19331
2022-05-14,1,3471,1996,2188,4071,4564,16290
2022-05-15,1,3465,2086,2856,3369,5495,17271
2022-05-16,1,2789,2448,1999,2055,4611,13902
2022-05-17,1,1269,2014,3045,1674,3520,11522
2022-05-18,1,4113,1821,3502,2493,3765,15694
2022-05-19,1,1035,2940,3898,1769,2494,12136
2022-05-20,1,3949,1261,3222,2492,4210,15134
2022-05-21,1,4993,2497,3354,2484,4331,17659
2022-05-22,1,1371,1191,1703,4280,5679,14224
2022-05-23,1,3239,2366,1205,2963,3328,13101
2022-05-24,1,1185,2493,2137,3988,4275,14078
2022-05-25,1,4025,1056,3167,3414,4472,16134
2022-05-26,1,1877,1557,2198,1666,4817,12115
2022-05-27,1,1437,2067,3104,3968,2792,13368
2022-05-28,1,3674,2786,1451,4457,5152,17520
2022-05-29,1,1663,1472,2679,2586,3349,11749
2022-05-30,1,3688,1077,1558,3495,2117,11935
2022-05-31,1,3384,1962,3286,3773,5352,17757
2022-06-01,1,4535,2649,1385,2664,3861,15094
2022-06-02,1,2646,1586,2210,3636,5880,15958
2022-06-03,1,1480,2418,2915,3694,5040,15547
2022-06-04,1,2515,2493,2163,2286,5609,15066
2022-06-05,1,4398,954,3375,2941,5986,17654
2022-06-06,1,3224,2566,2463,4435,2062,14750
2022-06-07,1,4712,2701,1558,2430,2310,13711
2022-06-08,1,4508,2424,1780,1803,5495,16010
2022-06-09,1,1928,1273,1245,3671,4973,13090
2022-06-10,1,4984,2941,1841,2265,2478,14509
2022-06-11,1,3464,1487,2336,2436,3426,13149
2022-06-12,1,4738,2085,1712,4354,4713,17602
2022-06-13,1,1708,2803,1852,2515,3463,12341
2022-06-14,1,3305,1716,1838,2711,4807,14377
2022-06-15,1,4742,998,2410,3721,3700,15571
2022-06-16,1,3246,850,2913,3273,3712,13994
2022-06-17,1,2737,2399,3423,2100,4018,14677
2022-06-18,1,3140,1907,1684,2851,3201,12783
2022-06-19,1,4300,1614,2752,1965,3603,14234
2022-06-20,1,3510,2984,2075,2401,5908,16878
2022-06-21,1,3894,1753,2908,1601,3734,13890
2022-06-22,1,1269,1991,3491,2004,2822,11577
2022-06-23,1,1892,2107,1209,3363,2767,11338
2022-06-24,1,4607,1003,3154,1730,2437,12931
2022-06-25,1,3796,2717,3276,4029,5345,19163
2022-06-26,1,1484,1783,2892,4014,4473,14646
2022-06-27,1,3173,2999,3240,3298,3054,15764
2022-06-28,1,4129,2115,1558,3213,4313,15328
2022-06-29,1,3362,1316,1617,3590,3646,13531
2022-06-30,1,4438,1525,1373,4279,5065,16680
2022-07-01,1,4289,1846,2976,3122,3464,15697
2022-07-02,1,1222,2763,3021,3029,3508,13543
2022-07-03,1,2964,2703,1608,2495,3424,13194
2022-07-04,1,4254,1757,3334,3686,2149,15180
2022-07-05,1,4235,2609,2988,2627,3123,15582
2022-07-06,1,3015,1913,3636,4241,4462,17267
2022-07-07,1,4155,2484,3227,1987,3503,15356
2022-07-08,1,2391,2918,2747,1780,3273,13109
2022-07-09,1,3582,2879,1619,2579,4569,15228
2022-07-10,1,1532,1273,3662,4458,3309,14234
2022-07-11,1,3968,1155,2799,3648,5573,17143
2022-07-12,1,2707,1039,2114,3719,5195,14774
2022-07-13,1,1294,2693,2822,2251,5596,14656
2022-07-14,1,4811,858,3024,1583,2649,12925
2022-07-15,1,3598,1266,2385,2603,2165,12017
2022-07-16,1,3004,1158,3414,1876,4378,13830
2022-07-17,1,1191,2241,2356,3925,4988,14701
2022-07-18,1,1765,1220,1648,2860,2917,10410
2022-07-19,1,4601,1897,3138,3979,4141,17756
2022-07-20,1,2410,2316,2191,2342,2223,11482
2022-07-21,1,3058,2309,1352,2539,2940,12198
2022-07-22,1,1562,802,2044,3117,3439,10964
2022-07-23,1,1346,2439,2992,2567,3992,13336
2022-07-24,1,3773,922,2435,3099,4514,14743
2022-07-25,1,1233,1038,1942,2139,2880,9232
2022-07-26,1,2136,1094,3707,3768,4773,15478
2022-07-27,1,4115,1821,2192,4036,5000,17164
2022-07-28,1,3555,1374,1577,2458,2473,11437
2022-07-29,1,2182,2535,3826,2549,4751,15843
2022-07-30,1,1370,2978,2317,4338,3076,14079
2022-07-31,1,3178,2173,1673,4195,5203,16422
2022-08-01,1,3067,903,1220,3312,2028,10530
2022-08-02,1,2108,2559,3438,4036,3636,15777
2022-08-03,1,2545,2929,1752,3687,5352,16265
2022-08-04,1,4712,2451,3005,4153,2901,17222
2022-08-05,1,2324,2951,1862,2756,5393,15286
2022-08-06,1,1449,1301,3124,3529,2681,12084
2022-08-07,1,2379,1231,3741,3311,2910,13572
2022-08-08,1,4976,803,3468,2931,4425,16603
2022-08-09,1,2431,801,2883,1838,3764,11717
2022-08-10,1,2211,905,2107,2347,5895,13465
2022-08-11,1,4272,828,3949,2370,4578,15997
2022-08-12,1,3863,1478,3481,2065,2322,13209
2022-08-13,1,2998,2691,1913,3074,2058,12734
2022-08-14,1,1262,1840,2850,4034,2475,12461
2022-08-15,1,2663,1217,2277,2076,2399,10632
2022-08-16,1,4815,1965,3731,3916,3859,18286
2022-08-17,1,3376,2587,2645,3471,4610,16689
2022-08-18,1,1891,2715,1531,2420,5933,14490
2022-08-19,1,2327,1317,3169,4111,4699,15623
2022-08-20,1,4143,2872,3040,3792,2947,16794
2022-08-21,1,4985,1035,2735,3264,5789,17808
2022-08-22,1,1051,2326,3704,2102,3055,12238
2022-08-23,1,1559,2846,3224,4019,3487,15135
2022-08-24,1,2065,1790,3891,2458,2792,12996
2022-08-25,1,1367,922,2564,1806,3778,10437
2022-08-26,1,2053,2739,2062,2099,2314,11267
2022-08-27,1,4681,2802,2960,2720,5216,18379
2022-08-28,1,3615,2264,1625,1806,4464,13774
2022-08-29,1,1148,1552,2412,1620,4111,10843
2022-08-30,1,4640,1351,2628,2038,2517,13174
2022-08-31,1,4049,2109,1296,4062,2019,13535
2022-09-01,1,4540,2129,2865,2207,4779,16520
2022-09-02,1,3536,2853,2989,2637,3282,15297
2022-09-03,1,4233,2630,2404,1938,4505,15710
2022-09-04,1,4331,2945,1491,1507,2661,12935
2022-09-05,1,3094,2782,2727,2224,4226,15053
2022-09-06,1,4706,2994,1805,4151,4318,17974
2022-09-07,1,4627,1809,2674,2445,3776,15331
2022-09-08,1,1817,1994,2109,1782,5145,12847
2022-09-09,1,2957,2022,2643,3316,2570,13508
2022-09-10,1,3175,2115,2810,1555,5863,15518
2022-09-11,1,1019,2181,3622,2007,3518,12347
2022-09-12,1,1541,1319,3102,4201,5962,16125
2022-09-13,1,2278,2725,2284,2448,3055,12790
2022-09-14,1,2785,1148,3511,3979,5377,16800
2022-09-15,1,3313,2889,1537,2704,2552,12995
2022-09-16,1,3482,2010,1699,3673,2562,13426
2022-09-17,1,4531,1942,3862,2171,3824,16330
2022-09-18,1,1633,1258,2481,3068,2544,10984
2022-09-19,1,3451,1113,2214,3056,5155,14989
2022-09-20,1,1370,1797,1713,3439,5051,13370
2022-09-21,1,2394,2574,2982,2276,5313,15539
2022-09-22,1,4352,1532,1938,2798,4491,15111
2022-09-23,1,4001,1070,3778,3018,5991,17858
2022-09-24,1,4146,1501,2369,4332,5102,17450
2022-09-25,1,2262,1240,1418,2366,5161,12447
2022-09-26,1,2710,2405,1713,3388,2889,13105
2022-09-27,1,4915,1469,1849,3161,2127,13521
2022-09-28,1,1109,2942,2289,2861,2205,11406
2022-09-29,1,4395,2108,3873,4243,4288,18907
2022-09-30,1,3648,1410,1500,2559,5745,14862
2022-10-01,1,3881,2653,1400,2759,5069,15762
2022-10-02,1,4122,2176,2657,4392,3842,17189
2022-10-03,1,4093,1456,3920,2845,4278,16592
2022-10-04,1,4418,1829,3128,4474,3494,17343
2022-10-05,1,2191,1707,3923,3511,3409,14741
2022-10-06,1,1637,2341,3947,3411,5086,16422
2022-10-07,1,2264,1817,2394,4121,4397,14993
2022-10-08,1,2071,1770,1302,3437,4250,12830
2022-10-09,1,4257,1516,2864,2876,3894,15407
2022-10-10,1,3233,1065,2115,1869,4705,12987
2022-10-11,1,2474,1243,1435,3653,5639,14444
2022-10-12,1,1534,1325,2147,1914,5863,12783
2022-10-13,1,4262,2623,2966,2166,5181,17198
2022-10-14,1,2248,2482,1830,4478,4996,16034
2022-10-15,1,4965,2067,2467,4138,2544,16181
2022-10-16,1,3509,1947,1850,2713,3473,13492
2022-10-17,1,3274,2277,3684,2498,2280,14013
2022-10-18,1,3329,2755,1340,1571,2862,11857
2022-10-19,1,2651,2777,1597,4087,4120,15232
2022-10-20,1,1791,1946,1991,1724,2393,9845
2022-10-21,1,2355,2955,1444,2318,5557,14629
2022-10-22,1,1763,2144,3045,4305,3832,15089
2022-10-23,1,3996,2567,1272,3092,3579,14506
2022-10-24,1,3144,1713,3146,2364,4173,14540
2022-10-25,1,4877,1955,3602,4029,2679,17142
2022-10-26,1,4844,1895,3359,2111,3642,15851
2022-10-27,1,3268,977,1301,3575,3679,12800
2022-10-28,1,4697,1735,1270,1627,3463,12792
2022-10-29,1,4267,1296,1280,4084,4946,15873
2022-10-30,1,4661,2330,1743,2862,2208,13804
2022-10-31,1,2631,1147,3392,3484,4971,15625
2022-11-01,1,3429,2372,2603,1604,5447,15455
2022-11-02,1,3900,1361,3425,3584,2028,14298
2022-11-03,1,1695,2261,1529,2848,3629,11962
2022-11-04,1,1448,1901,2805,2837,4481,13472
2022-11-05,1,1640,2460,1405,4279,5741,15525
2022-11-06,1,3011,1047,2842,3989,4659,15548
2022-11-07,1,3938,1983,1541,3949,4560,15971
2022-11-08,1,1885,1632,1527,2672,4796,12512
2022-11-09,1,1252,915,2036,4159,4560,12922
2022-11-10,1,4604,2760,3746,2466,4550,18126
2022-11-11,1,2087,2303,3523,3518,2683,14114
2022-11-12,1,4179,890,2672,1709,5751,15201
2022-11-13,1,2798,1513,1968,1890,2628,10797
2022-11-14,1,2242,2659,3501,2628,3468,14498
2022-11-15,1,1866,2800,3790,2176,5100,15732
2022-11-16,1,2833,2516,3545,3542,5092,17528
2022-11-17,1,4738,1874,3298,4275,2135,16320
2022-11-18,1,1918,2832,3030,2781,5675,16236
2022-11-19,1,2480,1778,2648,2556,4431,13893
2022-11-20,1,1094,1238,3964,2460,3780,12536
2022-11-21,1,2518,1888,3689,3026,3923,15044
2022-11-22,1,3592,1893,3780,2840,2797,14902
2022-11-23,1,2225,904,3652,2912,3372,13065
2022-11-24,1,1462,2271,3190,3691,4798,15412
2022-11-25,1,2812,1585,3961,4199,4114,16671
2022-11-26,1,2712,2671,1988,3839,2620,13830
2022-11-27,1,2203,1622,2463,2794,5683,14765
2022-11-28,1,1893,1618,2700,1519,3772,11502
2022-11-29,1,3028,1985,3861,2443,5219,16536
2022-11-30,1,3748,1701,1975,2119,2683,12226
2022-12-01,1,1027,2133,1210,2690,2829,9889
2022-12-02,1,4293,2685,2828,3841,2113,15760
2022-12-03,1,4493,2691,3549,1561,2869,15163
2022-12-04,1,3441,2685,1284,3381,5488,16279
2022-12-05,1,3030,1077,1643,2896,5234,13880
2022-12-06,1,1462,2829,2793,1866,4583,13533
2022-12-07,1,4470,2224,2683,3860,4913,18150
2022-12-08,1,3999,2253,1644,2686,5935,16517
2022-12-09,1,1695,2133,2533,1861,5951,14173
2022-12-10,1,3915,1533,2456,3143,3792,14839
2022-12-11,1,2299,1130,2807,2631,3867,12734
2022-12-12,1,1164,2942,3055,3704,4208,15073
2022-12-13,1,2791,2219,2861,4390,5252,17513
2022-12-14,1,4498,1972,1960,3969,2943,15342
2022-12-15,1,2361,2875,3344,4094,4267,16941
2022-12-16,1,1731,1743,2443,4093,2939,12949
2022-12-17,1,4243,1132,1300,2286,2387,11348
2022-12-18,1,2904,3000,3823,2284,2685,14696
2022-12-19,1,4767,948,2742,4466,2317,15240
2022-12-20,1,1831,2209,3642,2707,2524,12913
2022-12-21,1,4547,2772,2932,1535,5316,17102
2022-12-22,1,2451,1149,1216,2230,2717,9763
2022-12-23,1,1443,979,1612,4472,2955,11461
2022-12-24,1,3582,1805,2616,3645,3536,15184
2022-12-25,1,3721,1683,1424,2357,2401,11586
2022-12-26,1,3837,2617,1477,3694,5760,17385
2022-12-27,1,4715,2637,1500,1668,4579,15099
2022-12-28,1,3207,2747,3407,3548,2005,14914
2022-12-29,1,1114,1514,1901,4312,3683,12524
2022-12-30,1,1898,2389,2534,2330,4464,13615
2022-12-31,1,3163,1193,2150,4141,3392,14039
2023-01-01,1,3639,1914,2565,3487,2815,14420
2023-01-02,1,4207,1075,2959,2138,5995,16374
2023-01-03,1,3956,1558,1695,4499,5857,17565
2023-01-04,1,2581,1494,1517,3399,4494,13485
2023-01-05,1,3461,1594,2134,3140,4726,15055
2023-01-06,1,2873,1097,1638,2881,4922,13411
2023-01-07,1,3380,1716,3030,3438,4005,15569
2023-01-08,1,3554,2066,3188,2592,3239,14639
2023-01-09,1,2086,1350,3101,2007,4740,13284
2023-01-10,1,4433,2186,2445,1810,4582,15456
2023-01-11,1,1868,2916,2097,1670,2312,10863
2023-01-12,1,2521,989,3553,2973,5165,15201
2023-01-13,1,2816,936,1251,1836,5033,11872
2023-01-14,1,2578,1248,2854,2559,4987,14226
2023-01-15,1,1606,1111,2323,1672,2365,9077
2023-01-16,1,3570,1808,1380,3088,4693,14539
2023-01-17,1,1353,1110,2222,4474,3122,12281
2023-01-18,1,2567,1746,2355,3837,2260,12765
2023-01-19,1,1558,1020,3814,1849,5068,13309
2023-01-20,1,3818,2383,1815,2189,3223,13428
2023-01-21,1,1506,2159,1504,4132,5346,14647
2023-01-22,1,1611,1430,1393,4048,4908,13390
2023-01-23,1,4907,2544,1773,2264,2955,14443
2023-01-24,1,3155,2136,1634,3289,3150,13364
2023-01-25,1,2573,1627,1351,1958,4165,11674
2023-01-26,1,2391,2193,3193,2623,3763,14163
2023-01-27,1,3682,945,1546,4067,3359,13599
2023-01-28,1,2241,1593,3278,3188,2528,12828
2023-01-29,1,1189,1302,2224,3825,3072,11612
2023-01-30,1,3399,2663,3395,4027,5423,18907
2023-01-31,1,3330,2484,2350,1916,4628,14708
2023-02-01,1,1028,2075,3371,3112,5852,15438
2023-02-02,1,4583,1642,3780,4435,5629,20069
2023-02-03,1,3636,936,3226,2222,5044,15064
2023-02-04,1,1581,2229,2790,3572,5718,15890
2023-02-05,1,3183,2699,2857,1881,2595,13215
2023-02-06,1,3852,1439,1817,3889,5326,16323
2023-02-07,1,3384,1423,1257,3989,2398,12451
2023-02-08,1,1360,2839,1394,3707,2369,11669
2023-02-09,1,1472,1877,3709,1576,3018,11652
2023-02-10,1,2956,1210,1795,3115,5875,14951
2023-02-11,1,1198,2222,2944,2926,5362,14652
2023-02-12,1,1892,1307,3358,2888,4283,13728
2023-02-13,1,3105,1685,2115,2832,5143,14880
2023-02-14,1,4434,2343,1893,1829,3408,13907
2023-02-15,1,3390,995,3550,2018,4372,14325
2023-02-16,1,4478,2762,2630,3883,4044,17797
2023-02-17,1,2167,1259,2389,3342,3027,12184
2023-02-18,1,1028,1321,1974,3655,3369,11347
2023-02-19,1,3848,2329,2860,1985,4403,15425
2023-02-20,1,1544,2640,3133,2675,3807,13799
2023-02-21,1,4369,985,1808,2126,2997,12285
2023-02-22,1,2889,1555,1754,2151,4227,12576
2023-02-23,1,4648,1521,1321,4394,2216,14100
2023-02-24,1,3889,1238,1958,4100,5543,16728
2023-02-25,1,3757,1239,3443,4379,3557,16375
2023-02-26,1,4014,2296,2385,3228,3800,15723
2023-02-27,1,4851,1169,3495,4168,2318,16001
2023-02-28,1,3475,1204,1293,2686,4240,12898
2023-03-01,1,1785,1620,3466,1874,3101,11846
2023-03-02,1,1120,1753,3493,2512,4623,13501
2023-03-03,1,3828,2588,2568,4076,3241,16301
2023-03-04,1,2619,2599,3049,4192,3623,16082
2023-03-05,1,1796,1183,3850,3379,2271,12479
2023-03-06,1,2022,2044,3598,2135,5934,15733
2023-03-07,1,1969,1497,3758,2569,5549,15342
2023-03-08,1,4653,987,3861,2092,3977,15570
2023-03-09,1,3944,1888,3180,3116,3605,15733
2023-03-10,1,3875,2478,2441,3871,4111,16776
2023-03-11,1,1154,1788,2482,2648,3839,11911
2023-03-12,1,3171,893,1649,1728,3444,10885
2023-03-13,1,4503,1965,3503,4072,5069,19112
2023-03-14,1,1969,2673,3488,3159,2604,13893
2023-03-15,1,4378,1165,3196,1650,2412,12801
2023-03-16,1,2740,2748,1231,2497,5805,15021
2023-03-17,1,3314,2600,2583,1810,4823,15130
2023-03-18,1,1599,2910,2275,2512,2951,12247
2023-03-19,1,1319,2952,1635,2362,5297,13565
2023-03-20,1,4902,1663,1957,4318,4401,17241
2023-03-21,1,4254,2325,2791,3351,2586,15307
2023-03-22,1,3620,2907,1218,3677,4507,15929
2023-03-23,1,4502,2854,2670,2167,3411,15604
2023-03-24,1,4358,1363,1969,3953,4632,16275
2023-03-25,1,2833,1531,1770,1747,4956,12837
2023-03-26,1,2651,889,3051,4195,5089,15875
2023-03-27,1,4016,1916,2409,2321,2543,13205
2023-03-28,1,2471,2675,3091,2356,3046,13639
2023-03-29,1,2832,1189,3133,3812,3225,14191
2023-03-30,1,2057,1016,1392,4348,4877,13690
2023-03-31,1,3575,850,3403,1532,5811,15171
2023-04-01,1,1513,1847,2750,3790,2140,12040
2023-04-02,1,4662,1874,3792,3340,3022,16690
2023-04-03,1,2376,1094,3002,4316,3468,14256
2023-04-04,1,4061,2052,2402,3475,4335,16325
2023-04-05,1,3686,2531,3540,2486,4215,16458
2023-04-06,1,1132,857,1683,1726,3465,8863
2023-04-07,1,4021,1986,1839,1580,3163,12589
2023-04-08,1,4085,2709,3325,1937,3598,15654
2023-04-09,1,3701,2374,1727,4371,5114,17287
2023-04-10,1,4416,1639,2611,1571,4426,14663
2023-04-11,1,4176,2771,1587,1706,4912,15152
2023-04-12,1,3706,2296,3750,1597,4504,15853
2023-04-13,1,2984,1737,1341,2268,2114,10444
2023-04-14,1,2146,1094,2602,2606,4431,12879
2023-04-15,1,2570,1255,2091,4309,2543,12768
2023-04-16,1,3537,1800,2002,2742,4933,15014
2023-04-17,1,2378,1292,1874,1594,3906,11044
2023-04-18,1,4408,995,3172,4023,5237,17835
2023-04-19,1,1141,1436,3934,3148,5106,14765
2023-04-20,1,3535,2076,1270,1508,2110,10499
2023-04-21,1,3467,1953,3202,3865,2566,15053
2023-04-22,1,1163,2840,1649,4411,5977,16040
2023-04-23,1,1395,2919,1832,2846,4027,13019
2023-04-24,1,3246,1999,1945,2907,2028,12125
2023-04-25,1,2790,1494,2842,4238,2678,14042
2023-04-26,1,3371,2618,2237,4424,4734,17384
2023-04-27,1,2528,1584,3014,3250,2225,12601
2023-04-28,1,1756,1514,2714,3806,3850,13640
2023-04-29,1,1273,1400,1823,4143,4463,13102
2023-04-30,1,2715,2122,1841,3515,2825,13018
2023-05-01,1,4066,1029,2463,3671,2762,13991
2023-05-02,1,1939,2657,2341,3393,3023,13353
2023-05-03,1,2591,1679,1672,2669,5426,14037
2023-05-04,1,3225,1872,1922,2733,3920,13672
2023-05-05,1,3599,2048,2132,2535,4775,15089
2023-05-06,1,2238,1597,3488,2892,3895,14110
2023-05-07,1,1265,2795,1697,1527,2401,9685
2023-05-08,1,1132,2621,1689,4179,2503,12124
2023-05-09,1,3574,883,1982,3682,5185,15306
2023-05-10,1,1060,1023,3893,3443,2249,11668
2023-05-11,1,1759,2753,2648,3872,3443,14475
2023-05-12,1,3771,1158,2728,4297,4465,16419
2023-05-13,1,1046,801,1942,2558,5486,11833
2023-05-14,1,2555,2132,2559,4314,4544,16104
2023-05-15,1,3201,2385,3701,1784,4200,15271
2023-05-16,1,2363,1043,2640,2563,4748,13357
2023-05-17,1,2013,2116,2660,2231,2503,11523
2023-05-18,1,2737,1626,2983,4460,4223,16029
2023-05-19,1,3794,2775,3122,2858,3907,16456
2023-05-20,1,3166,1822,2908,4058,2769,14723
2023-05-21,1,1145,1272,3176,3661,3992,13246
2023-05-22,1,2741,1784,3363,3985,5376,17249
2023-05-23,1,4160,2455,3934,2853,5481,18883
2023-05-24,1,1927,971,1646,2309,3156,10009
2023-05-25,1,2428,2640,1764,4010,5008,15850
2023-05-26,1,2907,2322,3646,2533,4799,16207
2023-05-27,1,2885,2565,1546,3045,5062,15103
2023-05-28,1,4371,991,1234,3995,4247,14838
2023-05-29,1,2849,2616,3673,4179,5638,18955
2023-05-30,1,3348,2203,3754,3504,5317,18126
2023-05-31,1,3631,2920,3780,2487,5549,18367
2023-06-01,1,4084,2803,3391,3630,2152,16060
2023-06-02,1,1813,2520,3933,1851,4373,14490
2023-06-03,1,2021,1883,3673,2723,4872,15172
2023-06-04,1,2052,1107,3486,2241,2826,11712
2023-06-05,1,2150,1042,2543,3158,5013,13906
2023-06-06,1,1021,1954,3072,2435,4124,12606
2023-06-07,1,2150,2647,1319,2363,3711,12190
2023-06-08,1,1235,1358,2290,1800,4955,11638
2023-06-09,1,2703,2383,3648,4188,2261,15183
2023-06-10,1,1449,1650,2416,1582,4992,12089
2023-06-11,1,4924,1688,3539,2940,4161,17252
2023-06-12,1,3952,2541,3057,2286,5196,17032
2023-06-13,1,4732,959,3804,3509,3084,16088
2023-06-14,1,4641,2800,3021,3298,4074,17834
2023-06-15,1,1313,1025,2509,2528,4724,12099
2023-06-16,1,3335,1778,2798,2986,2531,13428
2023-06-17,1,1455,1420,1437,2095,5247,11654
2023-06-18,1,1151,2471,3394,2670,4348,14034
2023-06-19,1,4576,1965,3204,4154,2011,15910
2023-06-20,1,2427,2144,2056,3126,3194,12947
2023-06-21,1,3456,1887,3089,3671,3318,15421
2023-06-22,1,4791,2604,2156,1856,4702,16109
2023-06-23,1,2556,1136,3449,3457,2220,12818
2023-06-24,1,4683,1646,3022,2954,2352,14657
2023-06-25,1,3910,1150,1612,4082,5136,15890
2023-06-26,1,2608,1361,3365,1771,2251,11356
2023-06-27,1,3582,2657,2069,2128,5138,15574
2023-06-28,1,1670,2403,1769,2331,5992,14165
2023-06-29,1,3018,2145,3223,2942,4918,16246
2023-06-30,1,4990,1245,1319,1646,5600,14800
2023-07-01,1,1781,868,3090,4084,4367,14190
2023-07-02,1,3507,1959,3248,1927,2348,12989
2023-07-03,1,3819,1057,3934,3951,2759,15520
2023-07-04,1,4283,874,1708,1567,5642,14074
2023-07-05,1,2345,1070,2020,2744,2505,10684
2023-07-06,1,4984,2962,1737,1900,3883,15466
2023-07-07,1,2048,1492,2464,4288,4250,14542
2023-07-08,1,3744,2384,1681,2013,5997,15819
2023-07-09,1,2050,1370,2401,2385,5197,13403
2023-07-10,1,2585,2401,3144,3200,2426,13756
2023-07-11,1,2253,1295,2298,4166,2814,12826
2023-07-12,1,4968,1123,3694,3038,2306,15129
2023-07-13,1,3430,1257,3463,4263,3874,16287
2023-07-14,1,1157,2674,3917,3701,5465,16914
2023-07-15,1,4420,2258,2432,3633,3572,16315
2023-07-16,1,2960,1190,2434,2087,5568,14239
2023-07-17,1,3496,1088,2079,2981,4936,14580
2023-07-18,1,3413,1221,3372,2220,2867,13093
2023-07-19,1,4836,1578,3482,3490,4518,17904
2023-07-20,1,4966,999,1266,3972,2273,13476
2023-07-21,1,1021,2899,1895,1630,5019,12464
2023-07-22,1,4159,2196,2196,1670,2476,12697
2023-07-23,1,4391,1629,3462,3706,2097,15285
2023-07-24,1,2136,2284,2235,2518,5880,15053
2023-07-25,1,4236,2703,3297,2478,5003,17717
2023-07-26,1,1926,1523,3324,4008,5169,15950
2023-07-27,1,2705,2794,2153,2494,5978,16124
2023-07-28,1,3793,973,2767,3709,5364,16606
2023-07-29,1,3968,1217,3415,3234,3300,15134
2023-07-30,1,2985,1649,1646,2487,4792,13559
2023-07-31,1,1294,2048,1853,3788,2957,11940
2023-08-01,1,4129,1712,1893,3251,3604,14589
2023-08-02,1,3997,1735,3559,3324,5503,18118
2023-08-03,1,4704,1223,2557,4472,4547,17503
2023-08-04,1,1429,1591,3302,3083,5081,14486
2023-08-05,1,2003,1795,2894,2370,5158,14220
2023-08-06,1,4429,1494,1530,3779,2650,13882
2023-08-07,1,1014,2886,2489,2871,4599,13859
2023-08-08,1,2127,1807,2524,2434,5810,14702
2023-08-09,1,3257,980,3325,2899,3750,14211
2023-08-10,1,2200,2926,1679,2483,5379,14667
2023-08-11,1,4633,1840,3165,4276,2569,16483
2023-08-12,1,2770,816,1363,3436,5048,13433
2023-08-13,1,4613,2368,3124,1713,5935,17753
2023-08-14,1,3962,2651,3928,2739,4607,17887
2023-08-15,1,4605,2072,2905,3696,4133,17411
2023-08-16,1,2485,2245,2742,4056,4583,16111
2023-08-17,1,2764,2477,1792,2835,3777,13645
2023-08-18,1,4209,2646,1733,1507,5490,15585
2023-08-19,1,2129,964,1956,4295,5254,14598
2023-08-20,1,1088,1459,1938,1994,2785,9264
2023-08-21,1,3393,1598,3284,3391,4041,15707
2023-08-22,1,2861,917,1337,1511,2368,8994
2023-08-23,1,3779,2231,3249,2264,2168,13691
2023-08-24,1,3258,2303,3653,4350,2729,16293
2023-08-25,1,4969,875,2841,3939,3574,16198
2023-08-26,1,2407,1578,3353,3998,3990,15326
2023-08-27,1,2939,2636,3383,2774,4006,15738
2023-08-28,1,1611,2527,1612,3125,3786,12661
2023-08-29,1,2808,1824,2811,4339,4870,16652
2023-08-30,1,4776,1553,3697,3030,5156,18212
2023-08-31,1,3731,2107,1662,2322,3050,12872
2023-09-01,1,1036,1481,2346,1951,5841,12655
2023-09-02,1,2570,1224,2670,1594,2127,10185
2023-09-03,1,4605,1303,2237,2722,3922,14789
2023-09-04,1,1588,975,2118,4380,3100,12161
2023-09-05,1,3560,1538,3613,3848,4617,17176
2023-09-06,1,4966,964,3048,3494,4444,16916
2023-09-07,1,4870,1982,1995,4131,3228,16206
2023-09-08,1,4477,1308,3580,2087,2258,13710
2023-09-09,1,1093,2902,1581,2461,4728,12765
2023-09-10,1,1096,1921,2815,2255,5438,13525
2023-09-11,1,4654,2284,3965,1642,3481,16026
2023-09-12,1,3042,1735,3225,2543,2610,13155
2023-09-13,1,1219,845,1616,4344,5472,13496
2023-09-14,1,2424,2126,3902,4303,2817,15572
2023-09-15,1,4239,1248,2801,1590,4178,14056
2023-09-16,1,4405,2065,3761,3630,4068,17929
2023-09-17,1,2271,1237,3122,4178,4511,15319
2023-09-18,1,4276,2339,1659,1989,5990,16253
2023-09-19,1,1426,1030,1344,1919,5323,11042
2023-09-20,1,2966,2510,3666,2591,5524,17257
2023-09-21,1,1409,2913,3969,2514,4163,14968
2023-09-22,1,2590,985,3570,1692,2387,11224
2023-09-23,1,1269,819,1823,3889,4502,12302
2023-09-24,1,1039,1270,3658,1810,4792,12569
2023-09-25,1,4215,1521,1823,3958,5962,17479
2023-09-26,1,2418,1658,3799,4416,3491,15782
2023-09-27,1,3199,1655,3989,4114,5018,17975
2023-09-28,1,1757,2601,1671,3336,4185,13550
2023-09-29,1,3300,1562,3553,3057,5370,16842
2023-09-30,1,1546,1777,3265,3701,3146,13435
2023-10-01,1,3625,2831,2844,3016,5750,18066
2023-10-02,1,1480,2564,2397,3077,5076,14594
2023-10-03,1,4562,1673,1990,3937,2504,14666
2023-10-04,1,4263,1134,2906,3735,3120,15158
2023-10-05,1,1677,2606,3033,3905,4043,15264
2023-10-06,1,2821,2933,2596,2324,2550,13224
2023-10-07,1,3337,1948,1575,3633,5934,16427
2023-10-08,1,4195,2334,2004,3498,3439,15470
2023-10-09,1,1479,2248,1236,3917,5335,14215
2023-10-10,1,1345,2987,2394,2008,4337,13071
2023-10-11,1,2832,2373,2460,2801,3467,13933
2023-10-12,1,3468,925,2787,3191,3908,14279
2023-10-13,1,3371,1123,3885,1693,2380,12452
2023-10-14,1,2750,944,1673,4434,2948,12749
2023-10-15,1,2039,1910,2388,2288,4902,13527
2023-10-16,1,3280,1241,2784,3348,2422,13075
2023-10-17,1,2454,2046,3955,1967,4388,14810
2023-10-18,1,3072,1246,2954,2160,5445,14877
2023-10-19,1,3179,2651,3140,1555,5092,15617
2023-10-20,1,3031,1299,3944,3078,2497,13849
2023-10-21,1,4519,2054,1415,3687,4536,16211
2023-10-22,1,2404,2545,3970,3306,5017,17242
2023-10-23,1,3505,1965,3941,2490,3743,15644
2023-10-24,1,1672,1437,1851,2374,4031,11365
2023-10-25,1,4521,1181,2692,4257,3469,16120
2023-10-26,1,1011,2782,3906,1759,4609,14067
2023-10-27,1,2698,837,1717,2457,3602,11311
2023-10-28,1,1835,1765,2553,4078,3564,13795
2023-10-29,1,1503,1188,1616,2948,5974,13229
2023-10-30,1,1078,1495,3878,3112,5048,14611
2023-10-31,1,3764,2978,2191,4093,4861,17887
2023-11-01,1,2128,2998,3372,4176,5925,18599
2023-11-02,1,1822,1578,3222,3800,3271,13693
2023-11-03,1,4118,2973,1596,1848,2075,12610
2023-11-04,1,4558,1272,2772,3642,5837,18081
2023-11-05,1,1557,974,2628,3555,5517,14231
2023-11-06,1,2553,2001,2859,3783,5220,16416
2023-11-07,1,2623,1363,2689,4000,3335,14010
2023-11-08,1,4433,2346,3639,1936,3955,16309
2023-11-09,1,1970,2000,3034,1664,4638,13306
2023-11-10,1,4971,2939,2591,2434,4298,17233
2023-11-11,1,2293,1971,2406,1719,5979,14368
2023-11-12,1,3819,1198,1934,2831,4083,13865
2023-11-13,1,4451,2229,3199,2555,4382,16816
2023-11-14,1,4655,2417,3856,2644,2388,15960
2023-11-15,1,1625,2287,2868,2238,3896,12914
2023-11-16,1,3663,2547,3353,4161,3933,17657
2023-11-17,1,2321,1724,3028,3534,3696,14303
2023-11-18,1,1953,1455,2009,3585,3658,12660
2023-11-19,1,1050,2742,1571,3620,2579,11562
2023-11-20,1,3688,1474,2834,1503,3187,12686
2023-11-21,1,2334,904,3947,1576,3847,12608
2023-11-22,1,3063,1126,2221,3150,3994,13554
2023-11-23,1,3212,1949,2975,2101,2661,12898
2023-11-24,1,3183,1107,1954,3718,5090,15052
2023-11-25,1,3902,1596,1257,3585,4862,15202
2023-11-26,1,4761,1968,3992,4399,3430,18550
2023-11-27,1,3572,1089,3399,3537,3592,15189
2023-11-28,1,4388,2651,2446,1828,4748,16061
2023-11-29,1,1884,1504,1711,1686,2564,9349
2023-11-30,1,4404,1812,1939,1527,5304,14986
2023-12-01,1,3311,2875,1566,1744,4965,14461
2023-12-02,1,4078,1310,3840,3774,5320,18322
2023-12-03,1,4664,2220,2809,2469,5250,17412
2023-12-04,1,3448,2324,1966,2378,4411,14527
2023-12-05,1,2476,1581,2408,2421,3644,12530
2023-12-06,1,2859,1780,1912,4138,3959,14648
2023-12-07,1,2720,2024,2863,2992,5589,16188
2023-12-08,1,4035,932,3317,3020,2078,13382
2023-12-09,1,2744,2170,2216,3214,5304,15648
2023-12-10,1,3140,1331,2676,2228,5956,15331
2023-12-11,1,1848,1508,1592,2636,5918,13502
2023-12-12,1,1113,2352,2754,1763,5594,13576
2023-12-13,1,1316,2046,1769,3835,2823,11789
2023-12-14,1,1887,961,3909,2453,2068,11278
2023-12-15,1,4119,998,3583,2783,5212,16695
2023-12-16,1,4393,2967,3714,3182,2475,16731
2023-12-17,1,1180,1925,1976,2496,4624,12201
2023-12-18,1,3720,1980,3112,3709,5625,18146
2023-12-19,1,1172,1899,1775,3718,5494,14058
2023-12-20,1,4947,1984,3776,3424,4979,19110
2023-12-21,1,2317,2893,3004,3870,2382,14466
2023-12-22,1,3960,815,2846,3519,5365,16505
2023-12-23,1,2585,2124,1862,3852,3359,13782
2023-12-24,1,3393,2822,3356,3849,2444,15864
2023-12-25,1,2189,2694,2898,2163,2128,12072
2023-12-26,1,1137,2812,3695,3244,4601,15489
2023-12-27,1,3172,1282,3783,1634,2744,12615
2023-12-28,1,1956,2704,1253,2382,4843,13138
2023-12-29,1,2506,2528,2657,3033,4821,15545
2023-12-30,1,2926,2289,3562,4171,4228,17176
2023-12-31,1,2652,867,1653,1570,2560,9302
2022-01-01,2,1842,1367,3833,3322,2708,13072
2022-01-02,2,3320,1656,3786,2122,3029,13913
2022-01-03,2,3612,2034,3465,3272,2438,14821
2022-01-04,2,3646,2620,2820,3180,5603,17869
2022-01-05,2,3629,1559,3243,4325,2055,14811
2022-01-06,2,3661,1406,3070,4439,5636,18212
2022-01-07,2,3776,1455,1914,2955,5019,15119
2022-01-08,2,1434,1478,2708,4396,4128,14144
2022-01-09,2,2092,935,1200,4381,3024,11632
2022-01-10,2,1913,1206,3878,3153,5383,15533
2022-01-11,2,3305,1964,1588,3045,3794,13696
2022-01-12,2,4245,1818,1729,3536,3246,14574
2022-01-13,2,3452,2555,1286,4479,4887,16659
2022-01-14,2,1710,1599,2480,2708,2403,10900
2022-01-15,2,4204,1572,1293,3779,3458,14306
2022-01-16,2,4457,1446,3780,2318,5054,17055
2022-01-17,2,2686,2142,1754,2747,5879,15208
2022-01-18,2,3598,2902,2594,4025,4167,17286
2022-01-19,2,2181,1461,3790,4477,4589,16498
2022-01-20,2,4867,2414,2840,2851,3869,16841
2022-01-21,2,1596,2187,2949,3561,2303,12596
2022-01-22,2,1380,2609,3640,1543,2177,11349
2022-01-23,2,4182,2245,1567,4218,5806,18018
2022-01-24,2,1570,1148,3904,2982,3554,13158
2022-01-25,2,2255,2491,2949,1669,3692,13056
2022-01-26,2,1790,2639,3492,3250,2280,13451
2022-01-27,2,1850,2599,1285,2871,3410,12015
2022-01-28,2,2199,1063,3725,2820,2143,11950
2022-01-29,2,3985,1535,2514,4103,5294,17431
2022-01-30,2,2893,995,1467,1536,2208,9099
2022-01-31,2,1461,828,3367,3106,4384,13146
2022-02-01,2,3924,1767,1730,4215,5867,17503
2022-02-02,2,2857,2586,2045,2960,2959,13407
2022-02-03,2,1451,988,1763,2682,4440,11324
2022-02-04,2,1851,881,1753,2348,2695,9528
2022-02-05,2,3782,1630,3611,4301,5166,18490
2022-02-06,2,2665,2101,2682,4022,3598,15068
2022-02-07,2,2819,979,3539,3299,3081,13717
2022-02-08,2,2802,1898,3278,2619,5164,15761
2022-02-09,2,2097,2985,2908,1979,2150,12119
2022-02-10,2,3692,1058,3590,1713,3717,13770
2022-02-11,2,1666,1252,1433,4324,3816,12491
2022-02-12,2,1112,1983,2961,3162,3412,12630
2022-02-13,2,4811,1804,1663,3883,3715,15876
2022-02-14,2,2246,1795,2382,2027,3489,11939
2022-02-15,2,2059,1753,1519,1655,4107,11093
2022-02-16,2,1794,1825,2723,3236,5489,15067
2022-02-17,2,4051,1093,2244,3123,4302,14813
2022-02-18,2,2328,1773,2974,3205,5962,16242
2022-02-19,2,1968,1281,1225,3549,2027,10050
2022-02-20,2,4581,1375,1597,1696,3724,12973
2022-02-21,2,4709,2455,2182,2489,5148,16983
2022-02-22,2,4170,2000,3292,3630,4160,17252
2022-02-23,2,4656,1618,2243,1699,3377,13593
2022-02-24,2,3201,1320,3240,4452,3006,15219
2022-02-25,2,1738,2827,1850,2748,2273,11436
2022-02-26,2,1786,2753,2762,1957,5383,14641
2022-02-27,2,3325,2226,2495,2510,2515,13071
2022-02-28,2,2973,2989,2754,4483,3902,17101
2022-03-01,2,4870,1188,1297,3484,5413,16252
2022-03-02,2,3811,2991,2599,1806,3656,14863
2022-03-03,2,2925,1821,2191,3810,5945,16692
2022-03-04,2,3720,2973,1439,3448,5992,17572
2022-03-05,2,3636,1006,1293,3518,2238,11691
2022-03-06,2,4280,2607,3410,4161,4358,18816
2022-03-07,2,3448,1068,3844,2206,4883,15449
2022-03-08,2,3904,2505,2899,3649,4027,16984
2022-03-09,2,3388,898,2975,3046,5548,15855
2022-03-10,2,4853,873,3294,2222,4685,15927
2022-03-11,2,3897,2771,3389,3990,5077,19124
2022-03-12,2,4165,1740,2839,3503,3299,15546
2022-03-13,2,3619,1443,2148,1961,2177,11348
2022-03-14,2,4903,2119,1919,2414,4476,15831
2022-03-15,2,4458,1873,3952,3756,2049,16088
2022-03-16,2,1042,925,2747,3049,3303,11066
2022-03-17,2,3339,1533,3600,2306,5280,16058
2022-03-18,2,3403,1376,3335,3937,5252,17303
2022-03-19,2,1846,1846,1934,4176,4664,14466
2022-03-20,2,2593,2315,3335,4428,4023,16694
2022-03-21,2,2946,2135,3277,1859,2749,12966
2022-03-22,2,4724,2192,2235,3467,2515,15133
2022-03-23,2,1113,1100,3217,4232,5534,15196
2022-03-24,2,4512,2231,3770,2834,2756,16103
2022-03-25,2,4651,2230,2750,1531,5642,16804
2022-03-26,2,3101,2818,2199,3703,4390,16211
2022-03-27,2,4097,2148,2275,4349,3168,16037
2022-03-28,2,2108,1843,2654,3686,2809,13100
2022-03-29,2,2728,1476,3560,1935,5045,14744
2022-03-30,2,4975,2954,3520,4216,5814,21479
2022-03-31,2,1314,1581,1563,2143,2182,8783
2022-04-01,2,1579,1824,2691,4257,2910,13261
2022-04-02,2,1720,1721,3873,1703,3842,12859
2022-04-03,2,3116,2739,2324,2938,4152,15269
2022-04-04,2,4418,2944,3019,3493,5190,19064
2022-04-05,2,2219,1107,1703,4395,4702,14126
2022-04-06,2,3646,1216,2078,4462,5564,16966
2022-04-07,2,4975,2751,3381,3179,3135,17421
2022-04-08,2,3140,1261,1456,2706,5798,14361
2022-04-09,2,3491,2684,3510,1941,3226,14852
2022-04-10,2,2610,1986,1313,4292,2676,12877
2022-04-11,2,4338,2014,2300,1871,3054,13577
2022-04-12,2,3165,2983,2909,4295,4442,17794
2022-04-13,2,3069,1016,3361,4480,4130,16056
2022-04-14,2,4711,2368,1709,3412,5020,17220
2022-04-15,2,3407,887,1947,3689,5515,15445
2022-04-16,2,3915,2597,3877,3621,4170,18180
2022-04-17,2,1277,1475,2414,4075,4401,13642
2022-04-18,2,1166,2406,3544,3612,3937,14665
2022-04-19,2,2954,2212,3617,3681,5690,18154
2022-04-20,2,4463,1370,3006,1921,5088,15848
2022-04-21,2,2541,1128,1375,2525,4458,12027
2022-04-22,2,2629,2610,3222,4218,2850,15529
2022-04-23,2,4043,1877,2626,2335,4964,15845
2022-04-24,2,1361,1747,1841,1842,4642,11433
2022-04-25,2,3689,2219,3783,1951,3181,14823
2022-04-26,2,3697,2080,1719,3078,3533,14107
2022-04-27,2,3404,2941,2548,3446,4613,16952
2022-04-28,2,2579,2717,2066,3765,5581,16708
2022-04-29,2,1191,1498,2402,3694,5885,14670
2022-04-30,2,4829,2205,1262,1620,2399,12315
2022-05-01,2,2802,1894,3821,1775,2780,13072
2022-05-02,2,1013,2963,1995,2076,5808,13855
2022-05-03,2,3293,2884,2088,3044,5114,16423
2022-05-04,2,3059,2950,3384,3369,2064,14826
2022-05-05,2,4137,2246,2316,3895,3916,16510
2022-05-06,2,1511,2873,1532,1686,3516,11118
2022-05-07,2,1020,2681,2139,3987,4542,14369
2022-05-08,2,4882,1633,3534,3558,3631,17238
2022-05-09,2,3725,1571,3260,3435,5722,17713
2022-05-10,2,1334,1583,3413,2043,4509,12882
2022-05-11,2,1212,2129,3427,3594,4170,14532
2022-05-12,2,4315,1015,3060,3135,5238,16763
2022-05-13,2,2965,812,3871,3677,4313,15638
2022-05-14,2,4871,2999,3806,2241,4756,18673
2022-05-15,2,2096,2484,2074,3687,3068,13409
2022-05-16,2,1966,1961,2352,2311,5049,13639
2022-05-17,2,2231,2996,2621,1794,2511,12153
2022-05-18,2,2166,2599,3769,2763,3815,15112
2022-05-19,2,3797,2209,2382,1642,4366,14396
2022-05-20,2,4084,2023,2898,3215,5803,18023
2022-05-21,2,3782,1908,1864,4178,3423,15155
2022-05-22,2,2790,1648,3229,3271,2074,13012
2022-05-23,2,1070,1709,2358,4391,2296,11824
2022-05-24,2,1680,2286,2647,4316,5649,16578
2022-05-25,2,1288,1820,1708,1872,5469,12157
2022-05-26,2,2764,1852,2606,2242,5425,14889
2022-05-27,2,4740,1887,2629,2841,2943,15040
2022-05-28,2,1438,2039,3005,3778,4014,14274
2022-05-29,2,4752,2604,2838,1506,5353,17053
2022-05-30,2,2378,2995,2563,1937,2522,12395
2022-05-31,2,2434,2022,2873,4235,2234,13798
2022-06-01,2,3891,2914,1674,2324,4060,14863
2022-06-02,2,4856,1867,1853,2539,4343,15458
2022-06-03,2,4068,2819,1610,4025,4605,17127
2022-06-04,2,3843,1518,3602,3638,4875,17476
2022-06-05,2,1656,1592,1520,3992,2099,10859
2022-06-06,2,2113,1369,1868,4394,3724,13468
2022-06-07,2,1308,1282,1574,4180,5318,13662
2022-06-08,2,2364,1255,2868,3818,3819,14124
2022-06-09,2,2454,1173,1815,4422,4242,14106
2022-06-10,2,1538,871,3076,4100,2636,12221
2022-06-11,2,4843,1680,3435,3171,2841,15970
2022-06-12,2,4005,1309,2102,4017,3868,15301
2022-06-13,2,1375,2016,3211,3556,3805,13963
2022-06-14,2,1211,1485,3658,2898,2290,11542
2022-06-15,2,1595,1462,3026,4179,2798,13060
2022-06-16,2,2415,1150,3229,3955,3824,14573
2022-06-17,2,4867,1032,1800,3052,5592,16343
2022-06-18,2,4279,2955,2682,3453,5907,19276
2022-06-19,2,4745,1037,1745,2920,3062,13509
2022-06-20,2,1281,1398,2942,4322,2942,12885
2022-06-21,2,1927,853,3610,3720,5032,15142
2022-06-22,2,3798,1405,1545,2222,3392,12362
2022-06-23,2,3860,826,1436,2882,5539,14543
2022-06-24,2,3191,2553,3581,2427,4925,16677
2022-06-25,2,2620,1644,2924,3674,4460,15322
2022-06-26,2,3886,2587,2439,2546,3548,15006
2022-06-27,2,1149,1286,2834,3219,5596,14084
2022-06-28,2,3017,1214,3450,4390,3772,15843
2022-06-29,2,4130,2410,3288,3742,5436,19006
2022-06-30,2,2737,1132,1434,3691,3303,12297
2022-07-01,2,1002,812,1397,1746,5605,10562
2022-07-02,2,4462,1826,3310,3979,2997,16574
2022-07-03,2,1252,1614,2629,1799,2224,9518
2022-07-04,2,2474,1057,1718,2522,3763,11534
2022-07-05,2,1519,2141,3683,2040,4069,13452
2022-07-06,2,2668,2054,1882,3805,5941,16350
2022-07-07,2,1113,1770,1207,3381,5503,12974
2022-07-08,2,2434,953,1568,1995,2339,9289
2022-07-09,2,2911,1994,3493,1833,3206,13437
2022-07-10,2,2707,1612,1399,2374,4361,12453
2022-07-11,2,4575,1300,3989,3148,4563,17575
2022-07-12,2,1671,1831,3931,1979,4177,13589
2022-07-13,2,2371,2792,1602,1862,2189,10816
2022-07-14,2,2721,1117,3576,4203,4889,16506
2022-07-15,2,1715,1838,1599,3000,3428,11580
2022-07-16,2,1484,2667,2548,1826,3288,11813
2022-07-17,2,4897,2707,3307,2568,4518,17997
2022-07-18,2,3638,1905,3921,1724,4961,16149
2022-07-19,2,1678,1985,2385,2282,4039,12369
2022-07-20,2,1617,923,1661,2985,5028,12214
2022-07-21,2,4127,2112,1689,4488,3246,15662
2022-07-22,2,1420,1180,2393,4351,4139,13483
2022-07-23,2,3011,2802,3262,3925,5544,18544
2022-07-24,2,4485,1344,3426,2273,2591,14119
2022-07-25,2,2146,1284,3924,1848,4701,13903
2022-07-26,2,2243,1209,3353,4165,2691,13661
2022-07-27,2,4257,1372,3952,1528,5448,16557
2022-07-28,2,3710,1583,3896,3662,5978,18829
2022-07-29,2,4591,935,2290,1835,4161,13812
2022-07-30,2,3909,1711,3104,3639,4600,16963
2022-07-31,2,4875,1616,2406,3863,4715,17475
2022-08-01,2,1986,2126,1739,3165,3386,12402
2022-08-02,2,4406,2304,1457,2620,2313,13100
2022-08-03,2,1090,1656,2178,2086,4891,11901
2022-08-04,2,1705,1622,2673,2533,3183,11716
2022-08-05,2,4499,1350,2294,2445,2771,13359
2022-08-06,2,4580,2224,2523,3003,4043,16373
2022-08-07,2,4540,2275,2338,2882,2661,14696
2022-08-08,2,1355,2536,2746,4245,4079,14961
2022-08-09,2,3051,1192,1469,3133,2235,11080
2022-08-10,2,3211,2126,1812,3878,2723,13750
2022-08-11,2,1100,2333,3162,1810,4712,13117
2022-08-12,2,3655,2724,3906,4012,2144,16441
2022-08-13,2,4789,2700,1272,1795,2214,12770
2022-08-14,2,2132,1683,1274,2625,4436,12150
2022-08-15,2,1325,2019,3257,4223,5140,15964
2022-08-16,2,1041,1711,3131,3750,3968,13601
2022-08-17,2,2688,1868,3425,3359,3052,14392
2022-08-18,2,4396,1307,2817,3984,2055,14559
2022-08-19,2,3431,1902,2261,3784,3289,14667
2022-08-20,2,3964,1163,2676,2154,2260,12217
2022-08-21,2,3999,1640,3062,3960,5701,18362
2022-08-22,2,1675,2834,1426,3538,5185,14658
2022-08-23,2,1831,1930,1664,3804,2465,11694
2022-08-24,2,4835,1984,2760,2478,2261,14318
2022-08-25,2,3511,1935,3957,1825,2390,13618
2022-08-26,2,2305,1579,2960,2456,3394,12694
2022-08-27,2,1021,1263,3371,3670,3946,13271
2022-08-28,2,2780,1790,2008,4476,2181,13235
2022-08-29,2,2397,2265,3456,1878,2138,12134
2022-08-30,2,3800,1579,1391,1737,4851,13358
2022-08-31,2,4803,1810,2610,2391,3397,15011
2022-09-01,2,1369,1740,2284,3501,5842,14736
2022-09-02,2,3015,2540,3389,3291,4058,16293
2022-09-03,2,3012,2182,3872,2476,5236,16778
2022-09-04,2,3499,2084,3600,2243,4260,15686
2022-09-05,2,3550,1716,3863,3172,2798,15099
2022-09-06,2,2594,1425,3369,2256,5564,15208
2022-09-07,2,2138,1631,3824,2773,5786,16152
2022-09-08,2,1985,2153,3849,3272,3296,14555
2022-09-09,2,3516,1077,2945,3027,3153,13718
2022-09-10,2,4353,1489,2801,2643,2532,13818
2022-09-11,2,1120,2292,2501,2962,5184,14059
2022-09-12,2,4613,2884,1795,3520,4349,17161
2022-09-13,2,3434,1075,3020,4420,4565,16514
2022-09-14,2,1991,1816,3432,1934,2767,11940
2022-09-15,2,1772,2993,3266,4078,2969,15078
2022-09-16,2,1395,2276,2069,3475,4231,13446
2022-09-17,2,4030,993,3263,2864,5711,16861
2022-09-18,2,4919,2720,1951,3012,2990,15592
2022-09-19,2,2371,2763,3664,4037,3783,16618
2022-09-20,2,4457,1322,3739,4306,3061,16885
2022-09-21,2,4245,1535,2135,4350,2564,14829
2022-09-22,2,3955,2764,3840,3208,4914,18681
2022-09-23,2,1977,2099,3335,2402,4053,13866
2022-09-24,2,4705,2387,3105,2450,3235,15882
2022-09-25,2,4984,1336,1900,4333,5250,17803
2022-09-26,2,2402,2339,3676,2202,5238,15857
2022-09-27,2,1183,1260,1350,2454,3537,9784
2022-09-28,2,1047,1194,3110,3320,2377,11048
2022-09-29,2,4724,2452,1211,4494,2986,15867
2022-09-30,2,3546,2913,2470,4489,5203,18621
2022-10-01,2,2640,2325,1892,1653,3429,11939
2022-10-02,2,4566,2810,1912,1779,4077,15144
2022-10-03,2,3261,2800,2825,4341,4901,18128
2022-10-04,2,4041,1691,2555,3675,2267,14229
2022-10-05,2,4188,2266,3237,2242,5082,17015
2022-10-06,2,4463,1943,3197,3157,5098,17858
2022-10-07,2,3503,1200,1790,1677,4924,13094
2022-10-08,2,2151,2919,2511,3925,5978,17484
2022-10-09,2,2154,2450,1962,2925,4934,14425
2022-10-10,2,1230,2484,1246,4289,5949,15198
2022-10-11,2,4586,2938,1843,2047,3048,14462
2022-10-12,2,1497,2868,1421,4440,5606,15832
2022-10-13,2,1187,1884,3888,2044,2787,11790
2022-10-14,2,1210,1129,3063,3315,3036,11753
2022-10-15,2,1361,2458,1635,3256,2229,10939
2022-10-16,2,3053,1732,1321,3612,4146,13864
2022-10-17,2,4102,1851,3157,4054,3838,17002
2022-10-18,2,1058,2300,3972,3354,3890,14574
2022-10-19,2,3750,2977,1907,2250,3831,14715
2022-10-20,2,3283,1008,2342,2971,5040,14644
2022-10-21,2,4444,2674,3211,3648,3581,17558
2022-10-22,2,1388,1887,1853,3327,3329,11784
2022-10-23,2,3032,2526,3322,3037,3418,15335
2022-10-24,2,1569,1661,1599,1611,2048,8488
2022-10-25,2,2027,2992,2707,4109,2203,14038
2022-10-26,2,3526,1929,1684,1858,3073,12070
2022-10-27,2,2509,1839,3393,3296,2518,13555
2022-10-28,2,3861,1298,3415,2565,3835,14974
2022-10-29,2,2076,2458,1868,3123,2201,11726
2022-10-30,2,3486,1361,3766,4312,5779,18704
2022-10-31,2,3791,1651,2060,2658,5977,16137
2022-11-01,2,1380,2600,3538,2098,5811,15427
2022-11-02,2,1768,844,1906,3555,2108,10181
2022-11-03,2,3337,2741,2679,3203,5067,17027
2022-11-04,2,2551,1098,1664,3028,5280,13621
2022-11-05,2,1683,2229,3284,2530,3502,13228
2022-11-06,2,3791,1573,2830,3901,5211,17306
2022-11-07,2,1846,1548,3682,1776,3242,12094
2022-11-08,2,1899,2087,2113,1860,2673,10632
2022-11-09,2,1874,2633,2928,2746,4341,14522
2022-11-10,2,2330,1535,1204,2412,3937,11418
2022-11-11,2,4917,2981,2519,3797,4997,19211
2022-11-12,2,3377,2439,1712,4493,2764,14785
2022-11-13,2,4484,925,2903,3644,2508,14464
2022-11-14,2,2243,1496,2494,3872,3082,13187
2022-11-15,2,1597,2880,3684,2264,4956,15381
2022-11-16,2,3207,1125,2022,3464,4829,14647
2022-11-17,2,4545,2317,2827,4010,3619,17318
2022-11-18,2,1057,2967,3834,3362,5849,17069
2022-11-19,2,1249,994,3563,3887,2940,12633
2022-11-20,2,2838,2232,2440,1656,5238,14404
2022-11-21,2,2610,1898,1362,3226,4112,13208
2022-11-22,2,4638,965,1861,4444,3973,15881
2022-11-23,2,4507,1411,3223,2290,5173,16604
2022-11-24,2,3347,1090,3740,3182,2537,13896
2022-11-25,2,1979,2817,2348,3999,3222,14365
2022-11-26,2,4494,1271,3744,2959,2780,15248
2022-11-27,2,3699,1495,3892,1668,3508,14262
2022-11-28,2,2583,2087,3727,4336,5650,18383
2022-11-29,2,2490,2901,2174,2505,4834,14904
2022-11-30,2,3574,2954,1453,1925,4982,14888
2022-12-01,2,3435,1501,3951,2670,2597,14154
2022-12-02,2,4532,1268,1602,4027,5460,16889
2022-12-03,2,1425,2201,1460,2382,2188,9656
2022-12-04,2,3403,2963,1569,1507,2624,12066
2022-12-05,2,1403,1557,1415,3633,3880,11888
2022-12-06,2,3643,801,2120,3910,2237,12711
2022-12-07,2,1628,1678,3404,3911,4472,15093
2022-12-08,2,4875,2774,2611,3750,4006,18016
2022-12-09,2,3806,2000,2532,1695,3335,13368
2022-12-10,2,4033,1358,3709,4259,3798,17157
2022-12-11,2,3106,1019,3764,1780,4322,13991
2022-12-12,2,4144,2568,2614,1951,3707,14984
2022-12-13,2,4475,2632,3218,3732,5484,19541
2022-12-14,2,3144,2184,2083,3151,2279,12841
2022-12-15,2,2599,1364,2619,3846,2089,12517
2022-12-16,2,1759,853,3234,3306,5512,14664
2022-12-17,2,4960,1735,3061,2235,3482,15473
2022-12-18,2,4445,2921,3228,2678,2182,15454
2022-12-19,2,4242,865,2746,2571,2651,13075
2022-12-20,2,3965,1290,2329,1620,5619,14823
2022-12-21,2,1486,2056,3111,3928,5716,16297
2022-12-22,2,3805,976,2828,3460,4079,15148
2022-12-23,2,1669,2363,2889,1641,3589,12151
2022-12-24,2,1801,1501,1843,1672,4399,11216
2022-12-25,2,4530,1672,1271,4190,4289,15952
2022-12-26,2,2984,908,1778,2430,3497,11597
2022-12-27,2,4134,1414,3107,2879,2537,14071
2022-12-28,2,2790,2806,3414,2751,2251,14012
2022-12-29,2,4135,2212,2186,3306,5385,17224
2022-12-30,2,1373,1784,3559,2032,5470,14218
2022-12-31,2,1223,2145,3914,1950,4114,13346
2023-01-01,2,3349,2747,3800,2253,2436,14585
2023-01-02,2,4549,1201,2451,1788,4239,14228
2023-01-03,2,1313,2724,1743,4352,5926,16058
2023-01-04,2,3129,1085,3949,3293,3626,15082
2023-01-05,2,4882,1807,1698,2982,4899,16268
2023-01-06,2,4626,2100,2716,4379,3542,17363
2023-01-07,2,4729,1924,1905,2015,3095,13668
2023-01-08,2,2522,2482,3558,1931,2050,12543
2023-01-09,2,2639,2671,3397,2530,4670,15907
2023-01-10,2,3622,945,2904,4106,5671,17248
2023-01-11,2,2031,2297,3411,4045,3681,15465
2023-01-12,2,4263,2591,2810,4134,4557,18355
2023-01-13,2,4381,1656,2008,3943,5092,17080
2023-01-14,2,3898,2865,2737,3942,5674,19116
2023-01-15,2,4172,1998,3314,2777,5821,18082
2023-01-16,2,4891,2398,3352,3727,2052,16420
2023-01-17,2,1622,2654,2030,4044,3952,14302
2023-01-18,2,1667,2823,2190,3800,5381,15861
2023-01-19,2,2238,1997,2804,1547,4815,13401
2023-01-20,2,3609,804,1726,1711,3769,11619
2023-01-21,2,1606,1129,3466,3168,4881,14250
2023-01-22,2,4295,968,1951,2836,5836,15886
2023-01-23,2,3948,1060,3257,4323,5962,18550
2023-01-24,2,2191,1009,3858,1506,2245,10809
2023-01-25,2,4159,2864,1421,2242,3919,14605
2023-01-26,2,2160,2910,3337,2094,3358,13859
2023-01-27,2,3211,1693,1607,2283,2323,11117
2023-01-28,2,1983,1932,3564,2170,4071,13720
2023-01-29,2,3436,1956,3629,1663,3864,14548
2023-01-30,2,4662,2711,1406,4269,2345,15393
2023-01-31,2,3898,2281,2724,3488,2600,14991
2023-02-01,2,3817,2057,1785,2478,3163,13300
2023-02-02,2,1022,1542,3626,2302,3718,12210
2023-02-03,2,3138,2721,2357,4279,3369,15864
2023-02-04,2,1285,1764,1652,1568,4595,10864
2023-02-05,2,2407,2078,2517,3708,2009,12719
2023-02-06,2,2715,2173,2181,4191,3566,14826
2023-02-07,2,1941,1253,2976,4435,2370,12975
2023-02-08,2,1812,1545,2319,2150,4563,12389
2023-02-09,2,1058,2747,1206,2778,3419,11208
2023-02-10,2,2638,2522,3908,2661,2756,14485
2023-02-11,2,2525,1379,2291,3084,3547,12826
2023-02-12,2,3265,1623,1744,2733,5147,14512
2023-02-13,2,4107,1964,1685,2743,5681,16180
2023-02-14,2,2971,2205,2484,3026,2045,12731
2023-02-15,2,2578,1400,1258,1543,2794,9573
2023-02-16,2,4390,1298,2475,2661,4496,15320
2023-02-17,2,4070,1801,3651,1584,4145,15251
2023-02-18,2,4427,1981,2578,2114,4734,15834
2023-02-19,2,3513,2160,3055,2060,4679,15467
2023-02-20,2,1356,2993,2982,4406,2624,14361
2023-02-21,2,2300,2733,1583,2876,2787,12279
2023-02-22,2,3785,893,2870,4161,4910,16619
2023-02-23,2,3459,2629,3012,2999,5006,17105
2023-02-24,2,4159,1751,1538,3776,5957,17181
2023-02-25,2,4567,2221,1780,4207,4194,16969
2023-02-26,2,4949,1322,3169,1937,5199,16576
2023-02-27,2,4842,940,3313,3991,3320,16406
2023-02-28,2,3684,2616,3354,4373,4317,18344
2023-03-01,2,3718,1311,3108,2339,5950,16426
2023-03-02,2,4310,1811,2768,4260,4773,17922
2023-03-03,2,4215,2585,2722,3484,4232,17238
2023-03-04,2,3234,1339,3448,3453,3008,14482
2023-03-05,2,1993,1800,1641,3743,2739,11916
2023-03-06,2,1487,1547,2019,1992,5395,12440
2023-03-07,2,2208,1623,3155,3681,4682,15349
2023-03-08,2,3306,1247,2297,4311,3168,14329
2023-03-09,2,2045,2144,3650,2878,2642,13359
2023-03-10,2,2574,971,3928,3870,4326,15669
2023-03-11,2,3897,1722,2860,1705,2195,12379
2023-03-12,2,1677,2213,2138,3839,3799,13666
2023-03-13,2,1821,1434,2013,1526,5021,11815
2023-03-14,2,2137,2248,2851,2403,5772,15411
2023-03-15,2,2411,2696,1333,4155,4625,15220
2023-03-16,2,3159,2455,3606,3652,2862,15734
2023-03-17,2,4292,2493,1669,2595,4695,15744
2023-03-18,2,1731,1360,3705,2237,4598,13631
2023-03-19,2,2591,2575,3254,2322,3189,13931
2023-03-20,2,1300,2360,2979,3818,4323,14780
2023-03-21,2,1837,2171,1907,4244,3353,13512
2023-03-22,2,2061,1399,2592,2874,2596,11522
2023-03-23,2,3213,2868,1259,3612,5480,16432
2023-03-24,2,3102,2434,2042,3548,2808,13934
2023-03-25,2,4172,1782,2928,1605,5825,16312
2023-03-26,2,3420,2555,3444,3442,2606,15467
2023-03-27,2,2964,2233,1693,4008,5556,16454
2023-03-28,2,2279,1623,2059,4400,3908,14269
2023-03-29,2,4772,2181,1867,3018,3876,15714
2023-03-30,2,1336,1458,2751,1674,4010,11229
2023-03-31,2,3504,1615,1648,2931,3084,12782
2023-04-01,2,1586,2023,1578,4055,3259,12501
2023-04-02,2,1132,1483,2499,3948,4618,13680
2023-04-03,2,4109,1425,3669,2536,2451,14190
2023-04-04,2,1321,1526,1684,2775,5893,13199
2023-04-05,2,4782,1302,2846,2585,3913,15428
2023-04-06,2,1206,2868,2099,2351,4579,13103
2023-04-07,2,1072,2037,2856,2245,5509,13719
2023-04-08,2,1369,1390,1524,2908,3277,10468
2023-04-09,2,4002,2945,3972,3339,2235,16493
2023-04-10,2,2951,1558,1961,1773,5725,13968
2023-04-11,2,1418,2143,2004,2934,2331,10830
2023-04-12,2,2943,2200,1838,2410,3271,12662
2023-04-13,2,1604,2320,1975,2660,3074,11633
2023-04-14,2,1160,1289,3168,4186,2105,11908
2023-04-15,2,1708,1262,3414,3604,4424,14412
2023-04-16,2,4756,1466,1520,2333,3660,13735
2023-04-17,2,1558,1888,3946,2015,3764,13171
2023-04-18,2,3329,2415,2023,2679,2205,12651
2023-04-19,2,2219,862,1782,2930,5496,13289
2023-04-20,2,2384,1099,2330,4205,2954,12972
2023-04-21,2,2822,2992,2966,2767,3335,14882
2023-04-22,2,3222,1250,1348,1870,3469,11159
2023-04-23,2,1889,1966,1287,4259,5139,14540
2023-04-24,2,1989,1444,2623,1579,3972,11607
2023-04-25,2,4006,1165,1534,2627,3645,12977
2023-04-26,2,3806,932,3397,2677,3470,14282
2023-04-27,2,2915,2393,2132,2895,5598,15933
2023-04-28,2,1865,1432,1747,3910,4576,13530
2023-04-29,2,4760,864,2935,3409,5890,17858
2023-04-30,2,2483,931,3953,2603,3183,13153
2023-05-01,2,1901,1592,2351,1770,5744,13358
2023-05-02,2,1867,2233,2177,4453,4267,14997
2023-05-03,2,1113,2273,1750,2333,4745,12214
2023-05-04,2,4888,1877,2422,3345,5351,17883
2023-05-05,2,3788,2482,3000,3559,2399,15228
2023-05-06,2,3011,1132,1990,1914,4371,12418
2023-05-07,2,3158,1556,3464,2720,5288,16186
2023-05-08,2,2462,2105,1716,3732,3932,13947
2023-05-09,2,4421,1577,2741,1525,4783,15047
2023-05-10,2,2674,2689,2840,2798,5151,16152
2023-05-11,2,2960,2940,1266,3748,4519,15433
2023-05-12,2,2004,806,3422,1629,3347,11208
2023-05-13,2,2178,1163,2976,1765,4456,12538
2023-05-14,2,3128,2897,2396,1831,5818,16070
2023-05-15,2,4509,1483,2780,4322,4863,17957
2023-05-16,2,4267,2120,2484,3094,4200,16165
2023-05-17,2,2514,2958,3967,2950,4927,17316
2023-05-18,2,2780,2517,2980,3599,4804,16680
2023-05-19,2,3561,2974,2466,2237,5403,16641
2023-05-20,2,2594,2041,2672,3662,4708,15677
2023-05-21,2,2605,2895,3007,2405,2990,13902
2023-05-22,2,3879,1265,1667,4409,5152,16372
2023-05-23,2,3526,1683,3454,2053,4783,15499
2023-05-24,2,2672,849,1233,3917,3328,11999
2023-05-25,2,1155,2779,2208,3816,5647,15605
2023-05-26,2,2941,1437,3903,1741,4165,14187
2023-05-27,2,4362,2635,1883,3399,5616,17895
2023-05-28,2,1862,1404,2415,2354,2422,10457
2023-05-29,2,4939,2257,2734,3994,4840,18764
2023-05-30,2,3665,1317,3569,4267,3001,15819
2023-05-31,2,1282,2373,3456,3810,2430,13351
2023-06-01,2,2613,1701,3413,3554,2400,13681
2023-06-02,2,1203,2555,3829,2104,5082,14773
2023-06-03,2,3442,853,2867,3281,3436,13879
2023-06-04,2,1232,2960,1913,3574,3339,13018
2023-06-05,2,1181,1276,2884,4419,3203,12963
2023-06-06,2,4080,2975,1354,3265,2292,13966
2023-06-07,2,2086,2090,2206,2019,5755,14156
2023-06-08,2,3875,2606,3048,2760,2040,14329
2023-06-09,2,4733,2129,1765,3183,3357,15167
2023-06-10,2,2607,1380,1948,4203,2243,12381
2023-06-11,2,1900,2594,3624,2317,5726,16161
2023-06-12,2,3445,1293,2189,3623,5821,16371
2023-06-13,2,4324,1481,3101,3530,5140,17576
2023-06-14,2,3489,1139,1586,3809,3429,13452
2023-06-15,2,3452,2586,1715,4325,3809,15887
2023-06-16,2,4980,1195,2014,1582,4028,13799
2023-06-17,2,4934,1925,3510,2976,3158,16503
2023-06-18,2,4171,2946,3498,3296,5311,19222
2023-06-19,2,2803,2297,2091,2642,2715,12548
2023-06-20,2,4678,1520,2534,1853,2129,12714
2023-06-21,2,3496,2382,2275,3643,3851,15647
2023-06-22,2,4576,1874,2720,1660,4314,15144
2023-06-23,2,2319,2783,2202,2666,4042,14012
2023-06-24,2,4104,2037,2915,3566,4233,16855
2023-06-25,2,1239,2845,3617,3436,2920,14057
2023-06-26,2,3070,1047,2279,2421,4988,13805
2023-06-27,2,2473,2994,1258,3820,5886,16431
2023-06-28,2,2269,2464,1794,2662,4192,13381
2023-06-29,2,1955,2396,2788,3094,4964,15197
2023-06-30,2,3064,1052,1385,3101,5504,14106
2023-07-01,2,4178,1947,3648,3063,5390,18226
2023-07-02,2,2195,2940,3508,1719,3209,13571
2023-07-03,2,1136,1611,3131,1530,5201,12609
2023-07-04,2,4808,1342,3769,3148,5639,18706
2023-07-05,2,1921,2641,1300,3726,2725,12313
2023-07-06,2,2182,2964,2155,1897,3350,12548
2023-07-07,2,1269,1824,2770,1500,3510,10873
2023-07-08,2,1077,1092,3104,2632,2349,10254
2023-07-09,2,2601,1360,2711,3336,2618,12626
2023-07-10,2,2050,2877,1524,2395,5501,14347
2023-07-11,2,3308,1179,2204,2607,4665,13963
2023-07-12,2,4339,1526,3213,3316,2755,15149
2023-07-13,2,1206,2346,3479,1544,2498,11073
2023-07-14,2,1331,2461,1242,1994,5206,12234
2023-07-15,2,3546,2523,2800,3568,5055,17492
2023-07-16,2,1753,1558,1682,3892,4907,13792
2023-07-17,2,1463,2253,2778,3767,5946,16207
2023-07-18,2,1101,2973,3843,1810,4187,13914
2023-07-19,2,4898,2909,2222,2547,4265,16841
2023-07-20,2,4868,1837,2233,3632,4313,16883
2023-07-21,2,1213,1724,3911,4415,2816,14079
2023-07-22,2,2730,1786,3383,2254,5655,15808
2023-07-23,2,2249,1044,2113,2064,5260,12730
2023-07-24,2,1239,1938,3600,2273,3626,12676
2023-07-25,2,3863,2921,3628,2809,5424,18645
2023-07-26,2,3647,1032,2273,3970,4354,15276
2023-07-27,2,1343,2441,1364,1601,3420,10169
2023-07-28,2,3256,2759,3657,3806,3027,16505
2023-07-29,2,3204,1191,1777,3139,2002,11313
2023-07-30,2,3860,2313,1908,2302,4572,14955
2023-07-31,2,2209,2281,3030,4126,3091,14737
2023-08-01,2,3295,1795,3187,2405,2044,12726
2023-08-02,2,1903,1253,3390,1967,2069,10582
2023-08-03,2,4479,2685,2460,3983,2333,15940
2023-08-04,2,4419,1290,3506,2318,4889,16422
2023-08-05,2,3755,1213,2692,4062,4084,15806
2023-08-06,2,3100,1126,2938,4385,4136,15685
2023-08-07,2,3630,2057,3950,2837,2963,15437
2023-08-08,2,3396,2482,3436,2832,4515,16661
2023-08-09,2,4440,1627,2651,4414,3572,16704
2023-08-10,2,4239,2833,2380,4157,2981,16590
2023-08-11,2,3771,1443,1914,2216,2955,12299
2023-08-12,2,1750,1620,3790,3063,2600,12823
2023-08-13,2,1589,2085,2811,3850,3772,14107
2023-08-14,2,4277,1876,2205,4053,2399,14810
2023-08-15,2,2119,2632,2767,3747,3735,15000
2023-08-16,2,4781,2331,1942,1551,2006,12611
2023-08-17,2,2401,867,2758,2545,3597,12168
2023-08-18,2,3020,2303,1694,3086,5069,15172
2023-08-19,2,1207,2908,3547,2030,2024,11716
2023-08-20,2,1334,1089,2476,2319,3971,11189
2023-08-21,2,3893,1832,2661,1876,4149,14411
2023-08-22,2,3312,1757,2764,4363,3461,15657
2023-08-23,2,2346,1665,3176,4239,5130,16556
2023-08-24,2,3875,2704,3666,3909,3612,17766
2023-08-25,2,2587,2311,3052,2365,4316,14631
2023-08-26,2,4298,2257,2015,4415,4909,17894
2023-08-27,2,4538,2517,1975,2423,4186,15639
2023-08-28,2,1106,1931,1394,3672,3312,11415
2023-08-29,2,4667,1193,2824,2471,3253,14408
2023-08-30,2,4567,1235,2666,1513,5209,15190
2023-08-31,2,3580,2292,2524,2653,4753,15802
2023-09-01,2,2519,2557,1376,2305,2557,11314
2023-09-02,2,2757,1688,1216,3641,3356,12658
2023-09-03,2,4801,1639,3934,2827,2487,15688
2023-09-04,2,1492,839,1737,2440,5355,11863
2023-09-05,2,2195,2299,1286,3687,3681,13148
2023-09-06,2,1765,1965,1621,3906,4783,14040
2023-09-07,2,4446,1087,1955,4086,4481,16055
2023-09-08,2,3453,976,2491,2530,4647,14097
2023-09-09,2,1188,994,3746,2226,5481,13635
2023-09-10,2,3812,1345,3199,1930,2774,13060
2023-09-11,2,3223,2281,3974,3970,5273,18721
2023-09-12,2,1699,2895,2566,3706,3750,14616
2023-09-13,2,4586,1109,1573,2417,2192,11877
2023-09-14,2,4601,2766,2912,2439,5089,17807
2023-09-15,2,1413,2596,3025,1832,4981,13847
2023-09-16,2,4745,1820,3850,4115,2583,17113
2023-09-17,2,1830,2090,1920,3733,2106,11679
2023-09-18,2,1858,866,2297,1652,2753,9426
2023-09-19,2,2178,1523,1250,3724,2373,11048
2023-09-20,2,3129,2407,1654,2524,5095,14809
2023-09-21,2,1863,2310,2026,3223,5873,15295
2023-09-22,2,2546,1679,2005,3747,3122,13099
2023-09-23,2,2608,2519,3390,4387,3162,16066
2023-09-24,2,1369,1405,1933,3985,5480,14172
2023-09-25,2,3925,2957,2290,3237,5418,17827
2023-09-26,2,3490,2974,2518,2860,3789,15631
2023-09-27,2,4571,2626,2516,2244,3021,14978
2023-09-28,2,2217,1385,1609,2398,4208,11817
2023-09-29,2,3635,1781,3639,3908,5610,18573
2023-09-30,2,2771,1975,1575,3964,3620,13905
2023-10-01,2,2383,1537,2962,3989,4659,15530
2023-10-02,2,2673,1747,3423,2351,4778,14972
2023-10-03,2,2465,2051,3043,4329,2387,14275
2023-10-04,2,4932,2789,1233,1883,5824,16661
2023-10-05,2,1824,962,3453,2816,3030,12085
2023-10-06,2,4354,2471,2190,2535,4827,16377
2023-10-07,2,3419,2040,1710,1573,2331,11073
2023-10-08,2,2005,2886,1469,2194,5729,14283
2023-10-09,2,2098,2023,2938,2154,2431,11644
2023-10-10,2,2891,1059,1967,3110,2124,11151
2023-10-11,2,4868,2937,3414,2321,4957,18497
2023-10-12,2,1136,869,3521,1590,5279,12395
2023-10-13,2,4600,1705,2899,2053,5709,16966
2023-10-14,2,1735,2526,3241,2756,3678,13936
2023-10-15,2,1270,2526,2531,2286,5893,14506
2023-10-16,2,1593,970,2061,3905,3453,11982
2023-10-17,2,2029,919,3145,2320,5679,14092
2023-10-18,2,3818,1939,1466,2339,2880,12442
2023-10-19,2,1674,2288,2495,4236,4236,14929
2023-10-20,2,2403,2247,1744,4301,2300,12995
2023-10-21,2,1753,1478,3764,3308,3072,13375
2023-10-22,2,4329,2594,3940,1939,4440,17242
2023-10-23,2,1565,1795,3549,1655,3193,11757
2023-10-24,2,4164,1932,1871,4402,5793,18162
2023-10-25,2,3732,1449,3793,4450,5628,19052
2023-10-26,2,4574,2303,1686,1786,5584,15933
2023-10-27,2,3983,1578,2202,4153,2856,14772
2023-10-28,2,4292,2600,2801,2130,2752,14575
2023-10-29,2,1253,1125,3195,3271,5151,13995
2023-10-30,2,2667,1530,2124,4358,2744,13423
2023-10-31,2,2693,2266,1555,4380,2019,12913
2023-11-01,2,4589,2851,2761,3263,5669,19133
2023-11-02,2,2614,1813,2238,3694,5449,15808
2023-11-03,2,2972,1517,1483,2162,5782,13916
2023-11-04,2,1630,2476,1385,4309,2703,12503
2023-11-05,2,4966,1828,3761,4340,3538,18433
2023-11-06,2,4391,1105,1262,1731,5870,14359
2023-11-07,2,1979,2524,3234,1782,2401,11920
2023-11-08,2,3190,2488,2912,4391,4889,17870
2023-11-09,2,1371,927,1532,2659,4440,10929
2023-11-10,2,3742,1007,1286,3062,2457,11554
2023-11-11,2,3930,2874,1522,4480,2820,15626
2023-11-12,2,1097,958,2654,1657,2902,9268
2023-11-13,2,1472,2431,3529,1999,5986,15417
2023-11-14,2,2169,2325,2903,2334,2537,12268
2023-11-15,2,4766,2232,3282,2080,3099,15459
2023-11-16,2,3613,2781,1899,2889,2996,14178
2023-11-17,2,2605,1533,1619,2684,5808,14249
2023-11-18,2,1265,2862,3449,1896,5855,15327
2023-11-19,2,2427,2704,3398,2615,2405,13549
2023-11-20,2,1717,2508,3202,1906,5885,15218
2023-11-21,2,3882,895,1205,1900,4081,11963
2023-11-22,2,2034,2471,2863,3116,5850,16334
2023-11-23,2,4862,2442,1809,3934,4298,17345
2023-11-24,2,3651,2591,2836,3782,2737,15597
2023-11-25,2,1020,1694,2424,2703,2476,10317
2023-11-26,2,3765,1934,1798,2604,5875,15976
2023-11-27,2,1564,1177,3397,2491,3157,11786
2023-11-28,2,1712,2193,1727,3904,3259,12795
2023-11-29,2,3111,2487,1929,3887,5654,17068
2023-11-30,2,2237,1104,1446,2466,4866,12119
2023-12-01,2,1018,1066,1788,3417,5998,13287
2023-12-02,2,2483,2399,3414,2104,4270,14670
2023-12-03,2,2153,2571,2302,3788,4611,15425
2023-12-04,2,2051,2292,3013,3423,5260,16039
2023-12-05,2,2433,845,2110,2272,3704,11364
2023-12-06,2,4858,2518,2504,3216,2800,15896
2023-12-07,2,2340,1662,1690,1721,5210,12623
2023-12-08,2,2737,1538,3655,2357,2559,12846
2023-12-09,2,3904,1610,3153,3012,5299,16978
2023-12-10,2,2933,1128,2874,4119,3134,14188
2023-12-11,2,4171,1194,2851,1805,5315,15336
2023-12-12,2,2972,1952,1748,3729,3536,13937
2023-12-13,2,4310,2406,2621,4045,5225,18607
2023-12-14,2,4312,2710,1888,1743,5772,16425
2023-12-15,2,3009,2980,1580,3495,2137,13201
2023-12-16,2,2833,1557,2161,2414,4842,13807
2023-12-17,2,2698,2336,3722,2362,3545,14663
2023-12-18,2,1064,849,3870,2545,4285,12613
2023-12-19,2,2154,2085,2436,2379,3330,12384
2023-12-20,2,3055,1684,3015,4372,3890,16016
2023-12-21,2,4738,2813,2241,4258,2059,16109
2023-12-22,2,3293,1652,2292,2028,5367,14632
2023-12-23,2,4976,2401,3666,1868,4582,17493
2023-12-24,2,4770,1503,3915,4086,5198,19472
2023-12-25,2,2434,1527,1702,4381,4273,14317
2023-12-26,2,4428,1888,2843,3069,5031,17259
2023-12-27,2,2188,1033,3897,2098,4260,13476
2023-12-28,2,4082,2075,3714,1594,3753,15218
2023-12-29,2,1766,1235,2898,2221,2919,11039
2023-12-30,2,2296,912,2651,3244,2412,11515
2023-12-31,2,3214,2480,2523,3992,3828,16037
2022-01-01,3,3483,1726,2486,2036,4743,14474
2022-01-02,3,3411,2333,2485,1712,3802,13743
2022-01-03,3,4755,1300,1353,1691,2947,12046
2022-01-04,3,2974,1951,1818,3584,2444,12771
2022-01-05,3,2138,2646,3921,3991,2179,14875
2022-01-06,3,4277,2326,3398,1525,5720,17246
2022-01-07,3,4782,2798,2741,2575,3088,15984
2022-01-08,3,4476,1100,3826,2933,5103,17438
2022-01-09,3,1878,1660,3551,3573,5079,15741
2022-01-10,3,1319,2806,1435,3803,5243,14606
2022-01-11,3,3854,1274,1215,1533,3473,11349
2022-01-12,3,1346,1741,1643,2318,5071,12119
2022-01-13,3,4219,2152,2149,2767,3965,15252
2022-01-14,3,2099,1688,3643,3487,5218,16135
2022-01-15,3,3311,2877,2408,2595,3035,14226
2022-01-16,3,4777,1006,2455,2118,5264,15620
2022-01-17,3,3296,1791,3839,4284,4679,17889
2022-01-18,3,1929,2922,1684,3213,3948,13696
2022-01-19,3,4901,2207,1986,3766,3168,16028
2022-01-20,3,1566,1446,3827,4063,5481,16383
2022-01-21,3,3664,2703,3037,1944,2456,13804
2022-01-22,3,3532,1139,2027,1595,4272,12565
2022-01-23,3,2094,918,2798,3695,3959,13464
2022-01-24,3,1209,2531,1855,3112,5953,14660
2022-01-25,3,3696,2477,2869,2946,2941,14929
2022-01-26,3,4287,2431,1296,1906,4661,14581
2022-01-27,3,4253,2891,3263,4352,4101,18860
2022-01-28,3,2494,2540,1289,2069,5067,13459
2022-01-29,3,1074,996,2349,1610,5571,11600
2022-01-30,3,4409,1248,2084,3213,3969,14923
2022-01-31,3,1547,2145,2090,2994,3543,12319
2022-02-01,3,1227,2382,3771,4287,5686,17353
2022-02-02,3,3431,2414,1343,3616,2658,13462
2022-02-03,3,1098,2188,1360,2194,2307,9147
2022-02-04,3,4373,1223,3008,4128,3310,16042
2022-02-05,3,4468,870,2474,4476,3945,16233
2022-02-06,3,3392,1353,1788,1611,3077,11221
2022-02-07,3,1064,1450,2635,1565,5620,12334
2022-02-08,3,3266,966,3231,1933,2356,11752
2022-02-09,3,2326,2019,1912,3425,2989,12671
2022-02-10,3,4082,1145,3737,2813,4338,16115
2022-02-11,3,4637,2124,3705,2660,5190,18316
2022-02-12,3,4241,2897,2198,2948,4757,17041
2022-02-13,3,1456,1923,1532,2039,3355,10305
2022-02-14,3,1182,1249,2126,3514,4065,12136
2022-02-15,3,1864,2749,2994,3758,3395,14760
2022-02-16,3,4462,2993,1679,2687,2014,13835
2022-02-17,3,3011,1449,2076,4433,4038,15007
2022-02-18,3,4221,1015,3610,2391,5448,16685
2022-02-19,3,4849,867,2189,1868,3673,13446
2022-02-20,3,1773,1119,1449,2167,4341,10849
2022-02-21,3,2738,845,3025,1600,3175,11383
2022-02-22,3,2476,2862,1490,4259,4288,15375
2022-02-23,3,4944,1776,2002,2861,2579,14162
2022-02-24,3,2828,1018,1564,2437,4322,12169
2022-02-25,3,2834,2641,3388,3255,3304,15422
2022-02-26,3,1499,1554,1716,3551,4193,12513
2022-02-27,3,1574,2815,2255,3658,2147,12449
2022-02-28,3,2744,2988,2669,2920,2395,13716
2022-03-01,3,2801,2158,1420,4374,3860,14613
2022-03-02,3,3884,1191,1687,2607,3383,12752
2022-03-03,3,4206,1804,2810,4464,4059,17343
2022-03-04,3,2494,937,2387,3210,5173,14201
2022-03-05,3,3113,2194,3293,1897,3988,14485
2022-03-06,3,1909,1272,2557,3523,5364,14625
2022-03-07,3,2628,2592,2695,2500,5083,15498
2022-03-08,3,3038,1807,1279,1758,5704,13586
2022-03-09,3,3883,2744,1386,1659,4494,14166
2022-03-10,3,1942,918,2497,2720,4126,12203
2022-03-11,3,2019,1270,2987,1873,2166,10315
2022-03-12,3,2821,2422,1439,3333,3085,13100
2022-03-13,3,1380,1851,2180,3716,4054,13181
2022-03-14,3,1693,1760,2736,2119,2670,10978
2022-03-15,3,4760,2683,2868,2403,3546,16260
2022-03-16,3,2107,1224,2529,3364,3672,12896
2022-03-17,3,4443,1856,2422,3704,5237,17662
2022-03-18,3,1757,1282,2198,2866,4546,12649
2022-03-19,3,2944,2760,1398,4019,5311,16432
2022-03-20,3,3451,2997,3618,4167,3843,18076
2022-03-21,3,1272,1704,2375,2642,3074,11067
2022-03-22,3,2260,1267,2473,1989,5761,13750
2022-03-23,3,1898,1486,2805,4140,5100,15429
2022-03-24,3,1951,1163,3621,3224,3207,13166
2022-03-25,3,1166,2215,1977,1667,2080,9105
2022-03-26,3,2521,1565,3715,3353,3221,14375
2022-03-27,3,3420,1410,2239,3199,5667,15935
2022-03-28,3,4807,2953,2920,3806,5317,19803
2022-03-29,3,2114,1305,3757,3483,4462,15121
2022-03-30,3,1573,2388,1581,4417,2410,12369
2022-03-31,3,3723,2840,3491,1856,5563,17473
2022-04-01,3,4723,1147,2936,2149,5713,16668
2022-04-02,3,3303,2253,2668,1682,3769,13675
2022-04-03,3,1511,1901,3374,3264,3391,13441
2022-04-04,3,1916,2343,3014,4407,4050,15730
2022-04-05,3,4172,2321,2000,3910,4419,16822
2022-04-06,3,3983,2532,1452,1512,2537,12016
2022-04-07,3,1632,2944,2124,3782,4993,15475
2022-04-08,3,4674,1769,2910,2194,2718,14265
2022-04-09,3,1965,1140,1676,4029,5106,13916
2022-04-10,3,4956,1970,3348,4194,3671,18139
2022-04-11,3,4673,2212,1801,2628,3254,14568
2022-04-12,3,3902,2169,2840,2431,3675,15017
2022-04-13,3,3444,1937,2071,4137,5425,17014
2022-04-14,3,1985,1343,3792,3288,3677,14085
2022-04-15,3,1794,859,1598,4393,3049,11693
2022-04-16,3,1588,1563,2608,3781,2510,12050
2022-04-17,3,1398,1726,2815,2225,2929,11093
2022-04-18,3,2479,1708,2970,2832,2512,12501
2022-04-19,3,4224,1454,1564,4043,2488,13773
2022-04-20,3,4526,1272,3339,3694,2296,15127
2022-04-21,3,1363,1446,2893,2178,3593,11473
2022-04-22,3,4941,2598,3102,4149,3405,18195
2022-04-23,3,4393,1575,3213,2623,3244,15048
2022-04-24,3,4759,1979,2042,3142,4178,16100
2022-04-25,3,4847,2483,2104,2068,2122,13624
2022-04-26,3,3433,1712,1729,4113,2255,13242
2022-04-27,3,1576,2995,2965,2077,2672,12285
2022-04-28,3,3404,2190,1632,1941,4224,13391
2022-04-29,3,1332,1637,3607,1554,2968,11098
2022-04-30,3,3779,2091,1786,3588,5167,16411
2022-05-01,3,4846,1486,2708,3704,5041,17785
2022-05-02,3,1884,2539,1579,2394,5127,13523
2022-05-03,3,1298,2446,3629,4443,3162,14978
2022-05-04,3,2503,1186,2634,2605,2028,10956
2022-05-05,3,2942,1223,1715,3527,4281,13688
2022-05-06,3,3551,901,1572,1705,5310,13039
2022-05-07,3,4637,1390,2815,2903,2912,14657
2022-05-08,3,3063,2610,2117,1679,2526,11995
2022-05-09,3,2648,2760,2113,4200,5938,17659
2022-05-10,3,4961,1478,3286,4369,3586,17680
2022-05-11,3,2933,1154,1661,3768,4706,14222
2022-05-12,3,4468,995,2562,2986,4531,15542
2022-05-13,3,3156,1612,2146,2135,3948,12997
2022-05-14,3,2361,2328,2732,4067,2240,13728
2022-05-15,3,2646,1092,2466,3463,2595,12262
2022-05-16,3,1664,2806,2755,2827,4229,14281
2022-05-17,3,3838,1159,2035,2803,2187,12022
2022-05-18,3,1931,1906,1207,3285,3043,11372
2022-05-19,3,2440,1275,2458,4471,3420,14064
2022-05-20,3,1487,1433,1853,1581,2327,8681
2022-05-21,3,3301,2151,3514,3068,4356,16390
2022-05-22,3,2422,2330,1519,4203,3908,14382
2022-05-23,3,4558,1175,1624,3313,4920,15590
2022-05-24,3,4215,942,3895,4199,5339,18590
2022-05-25,3,3789,2926,1809,3424,4515,16463
2022-05-26,3,3382,2205,2402,3587,5920,17496
2022-05-27,3,2379,2400,2860,4353,2730,14722
2022-05-28,3,1110,2888,3456,2398,4798,14650
2022-05-29,3,4417,1216,2449,1698,5847,15627
2022-05-30,3,3595,1258,1495,3984,3646,13978
2022-05-31,3,1427,2800,3941,4418,5706,18292
2022-06-01,3,1182,2087,2562,3370,2308,11509
2022-06-02,3,3882,2890,3617,2139,2213,14741
2022-06-03,3,1735,2442,2005,2650,2319,11151
2022-06-04,3,4030,1273,2770,3034,3889,14996
2022-06-05,3,2933,2380,2074,1764,4915,14066
2022-06-06,3,1017,2977,2554,2936,3234,12718
2022-06-07,3,2826,2062,2535,3943,5300,16666
2022-06-08,3,2237,2329,3019,3872,3744,15201
2022-06-09,3,1780,2017,1925,1727,3294,10743
2022-06-10,3,1355,2485,3308,1584,3274,12006
2022-06-11,3,3050,1097,3934,3100,3644,14825
2022-06-12,3,4727,1412,2601,2404,2301,13445
2022-06-13,3,2018,1320,2188,1944,2831,10301
2022-06-14,3,4698,1597,1753,4340,2363,14751
2022-06-15,3,3549,1426,3003,2082,5038,15098
2022-06-16,3,2634,2096,1393,1738,3718,11579
2022-06-17,3,3711,2178,3051,2576,2334,13850
2022-06-18,3,4245,2544,3992,3341,3945,18067
2022-06-19,3,2633,917,3935,2229,3640,13354
2022-06-20,3,2916,2661,3766,2661,4142,16146
2022-06-21,3,2588,2584,1516,2694,5500,14882
2022-06-22,3,1043,1179,1560,1627,2802,8211
2022-06-23,3,3339,2152,1601,2029,5757,14878
2022-06-24,3,1023,1725,3394,2327,5886,14355
2022-06-25,3,3359,1826,2915,4001,2408,14509
2022-06-26,3,3385,2019,3650,3096,2470,14620
2022-06-27,3,2770,892,3374,2544,4524,14104
2022-06-28,3,3933,2243,1814,4332,3923,16245
2022-06-29,3,3499,2777,3681,3938,4785,18680
2022-06-30,3,2691,2742,1482,2031,5245,14191
2022-07-01,3,2942,2812,1201,3295,4369,14619
2022-07-02,3,4475,2348,2808,3098,5784,18513
2022-07-03,3,1912,2402,3125,3757,2172,13368
2022-07-04,3,2799,1937,3110,2612,3196,13654
2022-07-05,3,1847,1556,1692,4279,5201,14575
2022-07-06,3,1137,2204,1289,2775,5415,12820
2022-07-07,3,4801,885,2218,1511,3759,13174
2022-07-08,3,2602,2758,3676,3502,5510,18048
2022-07-09,3,4116,1647,2370,3638,3041,14812
2022-07-10,3,4578,1676,3462,3861,2789,16366
2022-07-11,3,3807,1219,2203,4404,5784,17417
2022-07-12,3,4505,1895,1331,4066,5140,16937
2022-07-13,3,3687,1490,2815,4411,2952,15355
2022-07-14,3,3361,1676,1741,3875,2175,12828
2022-07-15,3,2162,977,1763,2441,5256,12599
2022-07-16,3,4385,2224,2115,3567,3568,15859
2022-07-17,3,3733,1496,2711,2135,3512,13587
2022-07-18,3,3703,1291,1913,2489,4805,14201
2022-07-19,3,4286,2914,1800,4415,4522,17937
2022-07-20,3,1635,1560,2240,1682,5191,12308
2022-07-21,3,4252,869,2373,2712,4262,14468
2022-07-22,3,4290,1887,1343,3296,4660,15476
2022-07-23,3,1939,1230,2210,4332,4211,13922
2022-07-24,3,4231,2947,1237,3636,4167,16218
2022-07-25,3,1627,2492,2609,2585,3574,12887
2022-07-26,3,4700,1116,3392,2496,5667,17371
2022-07-27,3,4065,2457,3561,3434,5773,19290
2022-07-28,3,4144,1967,1399,3627,2673,13810
2022-07-29,3,2972,2377,1449,2236,5167,14201
2022-07-30,3,2014,2019,2678,2920,3998,13629
2022-07-31,3,2178,1980,3841,1641,4232,13872
2022-08-01,3,3598,865,3652,4155,4993,17263
2022-08-02,3,4849,2729,3398,4057,3634,18667
2022-08-03,3,1302,1309,3660,1748,4175,12194
2022-08-04,3,4935,2751,1493,3404,3330,15913
2022-08-05,3,1094,1315,1719,2014,5558,11700
2022-08-06,3,1337,2369,2025,3874,3013,12618
2022-08-07,3,3623,1261,1547,1743,3801,11975
2022-08-08,3,2855,1885,1664,2318,5645,14367
2022-08-09,3,2946,2706,3571,4334,4369,17926
2022-08-10,3,1605,2605,1245,2593,4072,12120
2022-08-11,3,1416,864,1325,3880,3985,11470
2022-08-12,3,2336,1105,3194,4151,5197,15983
2022-08-13,3,2548,2035,3743,2057,2991,13374
2022-08-14,3,4255,800,1675,1817,2432,10979
2022-08-15,3,1005,1702,3719,4308,4246,14980
2022-08-16,3,1657,1711,3081,2593,3849,12891
2022-08-17,3,2104,1033,2273,2800,5080,13290
2022-08-18,3,3893,2665,3925,3209,3958,17650
2022-08-19,3,3716,1466,2465,4151,2291,14089
2022-08-20,3,4268,1626,2769,1972,2545,13180
2022-08-21,3,3161,1376,3520,3919,4099,16075
2022-08-22,3,3057,2917,2734,1515,4801,15024
2022-08-23,3,4403,1435,1937,3289,4349,15413
2022-08-24,3,3968,1085,1916,3592,3093,13654
2022-08-25,3,1659,1413,1438,3948,4241,12699
2022-08-26,3,4596,946,1760,2717,2584,12603
2022-08-27,3,3653,1990,1794,4328,2903,14668
2022-08-28,3,3528,2585,2338,4406,2542,15399
2022-08-29,3,4431,2626,1871,2316,5493,16737
2022-08-30,3,3483,2298,2013,3275,2795,13864
2022-08-31,3,3656,2367,1284,1992,4322,13621
2022-09-01,3,3439,1315,1620,4455,3644,14473
2022-09-02,3,1836,2879,1543,1689,5923,13870
2022-09-03,3,3080,2688,3327,3063,5097,17255
2022-09-04,3,1220,2602,3596,2479,4890,14787
2022-09-05,3,3676,902,1830,1773,5300,13481
2022-09-06,3,3366,2294,2449,3197,4058,15364
2022-09-07,3,2093,1087,1315,2778,2554,9827
2022-09-08,3,3651,1794,3832,2097,4885,16259
2022-09-09,3,4334,2092,2703,3842,4441,17412
2022-09-10,3,2729,2550,1612,1847,5793,14531
2022-09-11,3,2998,1910,1915,2231,2295,11349
2022-09-12,3,4891,2507,2252,3265,4718,17633
2022-09-13,3,1425,2153,3198,2658,5693,15127
2022-09-14,3,1398,1056,3061,2399,2165,10079
2022-09-15,3,1212,2059,2815,3830,4491,14407
2022-09-16,3,2926,1065,1706,1633,4420,11750
2022-09-17,3,2761,2586,2432,2942,2067,12788
2022-09-18,3,1782,873,2178,2270,3682,10785
2022-09-19,3,1985,2211,2518,3309,3516,13539
2022-09-20,3,2986,1496,1512,4141,3927,14062
2022-09-21,3,1105,1205,2643,3482,3608,12043
2022-09-22,3,1854,1049,2426,3829,2003,11161
2022-09-23,3,3344,2026,2325,2130,4828,14653
2022-09-24,3,1141,1429,3276,2099,5760,13705
2022-09-25,3,4291,2820,1421,2360,4576,15468
2022-09-26,3,1537,1279,1669,4174,3170,11829
2022-09-27,3,2427,2424,1269,2503,5197,13820
2022-09-28,3,3849,1563,3251,4378,5175,18216
2022-09-29,3,4390,1394,2836,2910,5355,16885
2022-09-30,3,4091,991,1853,2622,2406,11963
2022-10-01,3,3917,2593,3400,4454,3031,17395
2022-10-02,3,1672,2636,1278,3547,2034,11167
2022-10-03,3,2809,2597,2636,2709,2808,13559
2022-10-04,3,4418,2906,1509,2561,3988,15382
2022-10-05,3,2908,987,1983,1966,5771,13615
2022-10-06,3,1842,936,1541,3585,4877,12781
2022-10-07,3,4826,823,3418,4442,3651,17160
2022-10-08,3,2292,2611,3436,2341,5772,16452
2022-10-09,3,3336,1862,3630,3249,3274,15351
2022-10-10,3,3550,870,3972,2598,3586,14576
2022-10-11,3,1150,1256,2428,2623,2045,9502
2022-10-12,3,2198,1901,3129,3487,4828,15543
2022-10-13,3,2487,2348,2163,2046,2302,11346
2022-10-14,3,3035,2339,2010,2313,5850,15547
2022-10-15,3,1332,2738,2858,3782,3892,14602
2022-10-16,3,1740,1240,2497,4340,4839,14656
2022-10-17,3,1166,1782,2775,1602,3719,11044
2022-10-18,3,1595,1764,2658,2849,5203,14069
2022-10-19,3,2581,1702,1891,2771,2381,11326
2022-10-20,3,3128,1084,3727,3464,4500,15903
2022-10-21,3,1495,1126,2892,3923,2198,11634
2022-10-22,3,3175,1715,1677,1823,4683,13073
2022-10-23,3,3610,840,2486,2832,4113,13881
2022-10-24,3,1642,2047,3981,3322,4914,15906
2022-10-25,3,4785,1750,2192,3507,3199,15433
2022-10-26,3,1679,2751,1907,2247,5496,14080
2022-10-27,3,2891,2142,3014,4130,5046,17223
2022-10-28,3,2119,2536,3612,3878,4470,16615
2022-10-29,3,4447,2392,1280,2034,5617,15770
2022-10-30,3,3276,2755,1267,3701,5006,16005
2022-10-31,3,1028,1957,1640,2423,3462,10510
2022-11-01,3,4356,1396,2721,2280,3411,14164
2022-11-02,3,3451,2062,2207,2191,5733,15644
2022-11-03,3,3970,1407,2107,3007,5786,16277
2022-11-04,3,2480,1509,3279,3347,2769,13384
2022-11-05,3,1841,1576,2094,3560,2477,11548
2022-11-06,3,4412,1734,2261,2834,3737,14978
2022-11-07,3,2105,1251,1200,3177,4814,12547
2022-11-08,3,3299,1378,2349,1803,5155,13984
2022-11-09,3,4614,2728,2761,3564,5939,19606
2022-11-10,3,3396,2723,1290,3215,2867,13491
2022-11-11,3,3806,2954,2795,1604,2126,13285
2022-11-12,3,4380,2312,3877,2601,3111,16281
2022-11-13,3,4733,2982,3063,3765,2926,17469
2022-11-14,3,3145,2564,2315,3985,5305,17314
2022-11-15,3,1219,2667,3445,1970,4885,14186
2022-11-16,3,2929,2778,1323,2386,4904,14320
2022-11-17,3,3799,1745,3854,1988,3275,14661
2022-11-18,3,1742,933,3346,3986,4032,14039
2022-11-19,3,4028,2105,3669,3853,5776,19431
2022-11-20,3,2669,931,2775,2284,2842,11501
2022-11-21,3,1239,844,3458,2643,2328,10512
2022-11-22,3,2777,903,3070,3385,3016,13151
2022-11-23,3,1298,2042,2644,3755,3621,13360
2022-11-24,3,3084,1551,3268,3130,3182,14215
2022-11-25,3,2659,1140,1463,2954,2269,10485
2022-11-26,3,4679,2360,3190,2267,2325,14821
2022-11-27,3,3290,2475,2337,2073,4535,14710
2022-11-28,3,1278,2731,3677,2419,3833,13938
2022-11-29,3,4991,2914,3412,1877,4785,17979
2022-11-30,3,3823,2220,2547,4125,4385,17100
2022-12-01,3,3022,1206,1917,4409,4105,14659
2022-12-02,3,2349,2628,2407,3591,3596,14571
2022-12-03,3,1309,2427,2089,2081,5535,13441
2022-12-04,3,4121,1397,2302,2085,3845,13750
2022-12-05,3,3180,1127,3257,2281,3870,13715
2022-12-06,3,4452,851,3055,3579,4648,16585
2022-12-07,3,4365,1399,1859,2667,4155,14445
2022-12-08,3,4114,2280,1936,2136,2853,13319
2022-12-09,3,4507,2269,2817,3209,5447,18249
2022-12-10,3,4615,2116,2079,4450,5158,18418
2022-12-11,3,3022,1052,3261,3916,5007,16258
2022-12-12,3,4274,2035,1428,3005,4483,15225
2022-12-13,3,3581,1252,3510,1763,3033,13139
2022-12-14,3,1314,2739,2645,1639,2366,10703
2022-12-15,3,3408,1303,1316,2171,5198,13396
2022-12-16,3,4114,2679,1511,3070,5992,17366
2022-12-17,3,2655,2984,3873,3664,3452,16628
2022-12-18,3,3693,2632,2984,3335,4683,17327
2022-12-19,3,4577,875,1951,3312,4518,15233
2022-12-20,3,2988,1341,2668,4087,4769,15853
2022-12-21,3,4126,1823,2699,2159,2519,13326
2022-12-22,3,3662,2156,2022,3872,5182,16894
2022-12-23,3,1186,1093,1237,2048,5773,11337
2022-12-24,3,1143,1159,3992,4435,4658,15387
2022-12-25,3,3919,952,2942,3524,2966,14303
2022-12-26,3,2720,1149,1348,4428,4607,14252
2022-12-27,3,1788,1408,3513,4025,5582,16316
2022-12-28,3,2264,2165,3711,3149,4498,15787
2022-12-29,3,3910,1218,3084,2149,4932,15293
2022-12-30,3,3768,1186,2669,2664,3893,14180
2022-12-31,3,3808,1621,1555,1716,5250,13950
2023-01-01,3,3231,2436,3449,3234,3097,15447
2023-01-02,3,1439,2696,1710,4042,2452,12339
2023-01-03,3,3720,2935,3694,2745,3770,16864
2023-01-04,3,3545,2489,3453,2063,3845,15395
2023-01-05,3,1016,1489,2731,4129,3119,12484
2023-01-06,3,4875,1673,2437,1804,3225,14014
2023-01-07,3,3202,2847,1503,2334,5046,14932
2023-01-08,3,1224,1551,3555,3945,4186,14461
2023-01-09,3,4797,1662,3630,2515,2898,15502
2023-01-10,3,2766,2350,1785,2575,4392,13868
2023-01-11,3,2309,995,1358,3852,4318,12832
2023-01-12,3,4313,1553,1800,3746,3648,15060
2023-01-13,3,4593,2306,1840,2674,4211,15624
2023-01-14,3,1416,1455,1747,3186,4886,12690
2023-01-15,3,3566,1207,3247,1799,5961,15780
2023-01-16,3,3219,2097,3864,3360,3770,16310
2023-01-17,3,2369,1844,2125,3727,2794,12859
2023-01-18,3,1835,2385,3847,3164,2435,13666
2023-01-19,3,3037,1525,3990,3643,4712,16907
2023-01-20,3,1804,1963,2658,3429,2783,12637
2023-01-21,3,1568,2866,2975,4167,3072,14648
2023-01-22,3,2479,1802,2145,2748,5416,14590
2023-01-23,3,1933,2844,3261,1703,5726,15467
2023-01-24,3,3378,1314,2215,4071,4701,15679
2023-01-25,3,1523,1923,3624,3510,2371,12951
2023-01-26,3,2992,1814,1524,2226,4837,13393
2023-01-27,3,2333,1817,2179,2057,5431,13817
2023-01-28,3,4222,893,1438,1686,4494,12733
2023-01-29,3,3638,1879,3751,2184,4404,15856
2023-01-30,3,1816,2959,1584,3999,5176,15534
2023-01-31,3,3031,1304,2310,2445,5920,15010
2023-02-01,3,2008,920,2935,1941,5246,13050
2023-02-02,3,4290,2345,2588,1643,2900,13766
2023-02-03,3,1055,2564,3749,2281,5374,15023
2023-02-04,3,4903,2521,3157,1540,4753,16874
2023-02-05,3,3497,1539,1383,3337,4587,14343
2023-02-06,3,2934,1357,2865,1551,5115,13822
2023-02-07,3,1174,2235,1457,3507,3725,12098
2023-02-08,3,2045,1134,2977,2116,5459,13731
2023-02-09,3,1139,1385,3355,3418,4858,14155
2023-02-10,3,1713,2196,2576,3887,5731,16103
2023-02-11,3,4677,1441,3832,3897,2570,16417
2023-02-12,3,3170,1054,1592,2407,3447,11670
2023-02-13,3,2096,1942,2242,4239,4810,15329
2023-02-14,3,1366,2468,1610,4344,3100,12888
2023-02-15,3,3427,976,3774,4119,4278,16574
2023-02-16,3,1546,1248,1443,2308,4881,11426
2023-02-17,3,1421,1024,3429,3297,3768,12939
2023-02-18,3,4271,2039,3130,2941,5697,18078
2023-02-19,3,3774,2190,3429,1606,5472,16471
2023-02-20,3,2103,2513,3124,4422,4202,16364
2023-02-21,3,1409,1252,1542,1668,4957,10828
2023-02-22,3,3192,1475,3129,1535,4313,13644
2023-02-23,3,4725,2672,2694,3202,2411,15704
2023-02-24,3,3086,1586,1408,4396,4634,15110
2023-02-25,3,4205,1429,1441,2990,4933,14998
2023-02-26,3,4245,2859,3010,4249,4328,18691
2023-02-27,3,1830,1963,1820,3630,3071,12314
2023-02-28,3,2834,2498,3013,4465,5807,18617
2023-03-01,3,1136,2155,3762,3071,2486,12610
2023-03-02,3,3418,825,3718,3808,2165,13934
2023-03-03,3,3281,1057,2113,4251,3671,14373
2023-03-04,3,1956,2446,1223,3514,2555,11694
2023-03-05,3,4428,2654,2722,4132,2730,16666
2023-03-06,3,2150,2436,1996,4479,2242,13303
2023-03-07,3,2257,2319,3598,4292,4731,17197
2023-03-08,3,4074,951,2809,3052,3096,13982
2023-03-09,3,2773,2040,2345,1929,5465,14552
2023-03-10,3,4365,1189,2612,4031,3931,16128
2023-03-11,3,2727,908,1610,2914,3985,12144
2023-03-12,3,1705,923,3822,3533,5886,15869
2023-03-13,3,3048,1345,2928,4002,2100,13423
2023-03-14,3,1625,1964,3117,3804,5977,16487
2023-03-15,3,4673,2059,3787,4153,3049,17721
2023-03-16,3,3039,1030,2687,4183,4749,15688
2023-03-17,3,4734,2750,2245,3635,4085,17449
2023-03-18,3,1782,1626,1244,3842,3467,11961
2023-03-19,3,1781,2297,3454,3972,5713,17217
2023-03-20,3,2086,1255,2999,1922,3204,11466
2023-03-21,3,1457,935,1269,3232,3662,10555
2023-03-22,3,4514,2562,3099,3721,2415,16311
2023-03-23,3,4699,1244,1712,2756,2218,12629
2023-03-24,3,1904,1055,3765,2839,3857,13420
2023-03-25,3,3532,1763,3664,3612,2589,15160
2023-03-26,3,1976,908,2589,1870,5456,12799
2023-03-27,3,2946,2636,1654,4033,2807,14076
2023-03-28,3,4588,2801,1856,2789,2323,14357
2023-03-29,3,1037,2008,3039,1604,4289,11977
2023-03-30,3,4945,1200,1219,2419,5019,14802
2023-03-31,3,2361,2163,3512,1915,3394,13345
2023-04-01,3,1399,2590,3035,1668,4222,12914
2023-04-02,3,2282,2074,1313,1997,4086,11752
2023-04-03,3,3155,2094,2290,3128,4289,14956
2023-04-04,3,4040,2529,2547,3456,5128,17700
2023-04-05,3,3754,2909,2236,4143,4641,17683
2023-04-06,3,1894,2003,2918,3535,2365,12715
2023-04-07,3,4650,1606,3072,4189,5765,19282
2023-04-08,3,1204,1997,3725,1642,3398,11966
2023-04-09,3,1989,947,2508,3430,2739,11613
2023-04-10,3,4659,2166,3701,3354,5885,19765
2023-04-11,3,1400,1433,3008,2189,5755,13785
2023-04-12,3,2563,2556,3809,3047,2507,14482
2023-04-13,3,4503,2134,2338,2528,2163,13666
2023-04-14,3,2000,815,3020,4002,3974,13811
2023-04-15,3,1663,2480,3265,3000,2190,12598
2023-04-16,3,4337,2522,2964,2435,4390,16648
2023-04-17,3,4647,2890,3627,3429,5463,20056
2023-04-18,3,3651,1697,2283,3273,5029,15933
2023-04-19,3,4196,2328,1203,1738,4612,14077
2023-04-20,3,3642,2435,1400,2022,2162,11661
2023-04-21,3,2180,2045,2719,3445,5342,15731
2023-04-22,3,3792,1925,2518,3902,3820,15957
2023-04-23,3,2894,854,1308,4471,4897,14424
2023-04-24,3,1484,920,3353,1559,5161,12477
2023-04-25,3,3611,1966,3706,2436,5224,16943
2023-04-26,3,3806,2235,2185,2327,2715,13268
2023-04-27,3,2962,1468,2119,4094,5690,16333
2023-04-28,3,4838,1804,2885,4222,2202,15951
2023-04-29,3,2937,2087,2255,3548,2017,12844
2023-04-30,3,4523,1992,2599,3502,4911,17527
2023-05-01,3,3198,2246,2045,2757,4969,15215
2023-05-02,3,3224,1527,3267,2801,2566,13385
2023-05-03,3,2292,2646,3557,2105,5619,16219
2023-05-04,3,4591,1388,2398,3289,3927,15593
2023-05-05,3,1843,1379,2148,2367,2854,10591
2023-05-06,3,2324,2689,2090,3178,2834,13115
2023-05-07,3,2164,2105,2819,3371,5205,15664
2023-05-08,3,3626,1470,3269,3126,5735,17226
2023-05-09,3,1851,2322,2172,4362,4739,15446
2023-05-10,3,1087,1439,3054,2320,5831,13731
2023-05-11,3,2595,2839,3743,2090,5881,17148
2023-05-12,3,2496,1949,3994,2671,4842,15952
2023-05-13,3,2736,1595,3332,3227,3415,14305
2023-05-14,3,4720,808,1951,2480,3010,12969
2023-05-15,3,2304,1302,1421,4378,4807,14212
2023-05-16,3,4318,2810,1950,2811,5053,16942
2023-05-17,3,1899,2645,3669,4411,4483,17107
2023-05-18,3,3319,2493,1322,2104,5946,15184
2023-05-19,3,2833,1666,2668,1548,4643,13358
2023-05-20,3,4023,815,3921,2510,4574,15843
2023-05-21,3,2607,2080,1267,4213,3135,13302
2023-05-22,3,3006,2728,3742,2513,3018,15007
2023-05-23,3,4660,2002,3069,2892,3101,15724
2023-05-24,3,1176,1817,2025,4077,4892,13987
2023-05-25,3,3896,1857,2656,2044,5103,15556
2023-05-26,3,2794,2976,3511,3093,3916,16290
2023-05-27,3,1783,1529,3614,2313,3462,12701
2023-05-28,3,4900,2816,1479,4447,5289,18931
2023-05-29,3,1546,2348,3911,3185,3795,14785
2023-05-30,3,2377,2134,2850,2141,4917,14419
2023-05-31,3,2576,1852,2646,4153,5895,17122
2023-06-01,3,4199,2339,2161,2144,3111,13954
2023-06-02,3,4157,2107,3620,2550,5707,18141
2023-06-03,3,2897,1437,1696,3894,2756,12680
2023-06-04,3,4246,2356,3791,4014,2700,17107
2023-06-05,3,1580,1530,3931,3366,4937,15344
2023-06-06,3,4984,1845,3819,2924,5856,19428
2023-06-07,3,2588,1088,3743,2524,4330,14273
2023-06-08,3,1672,1360,2082,3673,5349,14136
2023-06-09,3,3067,2679,1440,4138,3329,14653
2023-06-10,3,2794,1172,1718,3049,2265,10998
2023-06-11,3,2670,848,3684,3528,5203,15933
2023-06-12,3,4554,2723,1549,3049,4172,16047
2023-06-13,3,4564,2721,3375,3062,5249,18971
2023-06-14,3,1308,2790,3981,1664,5967,15710
2023-06-15,3,1292,1034,3657,2449,3486,11918
2023-06-16,3,3743,1491,2111,2938,4714,14997
2023-06-17,3,2757,2794,1482,4068,4778,15879
2023-06-18,3,3717,1413,2394,1651,2695,11870
2023-06-19,3,4260,2401,2615,4445,4686,18407
2023-06-20,3,2196,945,1824,1658,3454,10077
2023-06-21,3,4628,1121,3196,1961,3650,14556
2023-06-22,3,4767,976,3336,4038,2226,15343
2023-06-23,3,1151,1647,2285,3821,3809,12713
2023-06-24,3,2566,2935,3203,3469,3434,15607
2023-06-25,3,3248,2476,2386,3245,5820,17175
2023-06-26,3,1612,2204,3338,3593,5588,16335
2023-06-27,3,2398,2214,2616,3719,2337,13284
2023-06-28,3,1134,1415,3899,2477,2205,11130
2023-06-29,3,1825,992,2028,2935,2901,10681
2023-06-30,3,2541,1825,1681,4214,3184,13445
2023-07-01,3,1808,2802,1710,3102,4551,13973
2023-07-02,3,2589,971,2306,2233,4560,12659
2023-07-03,3,4003,2963,3498,3344,4412,18220
2023-07-04,3,4925,2432,3418,1577,2002,14354
2023-07-05,3,3723,887,3179,2217,3133,13139
2023-07-06,3,2667,1560,3318,3804,3642,14991
2023-07-07,3,1051,1162,1945,4199,5059,13416
2023-07-08,3,3057,1668,1757,3309,5713,15504
2023-07-09,3,2857,1713,3651,3848,4774,16843
2023-07-10,3,1456,2630,3994,3076,5681,16837
2023-07-11,3,4431,1411,2979,3889,3586,16296
2023-07-12,3,3941,1874,1354,2570,2115,11854
2023-07-13,3,3325,1704,3656,2427,2557,13669
2023-07-14,3,2548,1967,2844,3006,5659,16024
2023-07-15,3,1532,2432,3918,3103,3400,14385
2023-07-16,3,2524,1125,2466,2100,5810,14025
2023-07-17,3,1689,2350,1967,1501,5266,12773
2023-07-18,3,1805,2728,1515,2876,2961,11885
2023-07-19,3,2401,2895,1911,3914,4919,16040
2023-07-20,3,2702,858,2744,2921,5495,14720
2023-07-21,3,3134,924,2425,4069,5396,15948
2023-07-22,3,3598,1337,2185,1972,2002,11094
2023-07-23,3,2544,2676,3780,2138,5975,17113
2023-07-24,3,4181,1391,2580,1903,3575,13630
2023-07-25,3,2125,2327,2318,2035,5796,14601
2023-07-26,3,4948,2649,1341,1889,4534,15361
2023-07-27,3,2414,1159,1464,2505,3629,11171
2023-07-28,3,3367,1423,3086,4056,5193,17125
2023-07-29,3,1355,2267,2014,2966,4357,12959
2023-07-30,3,2135,1003,3572,2584,2395,11689
2023-07-31,3,1757,2929,1231,3770,2381,12068
2023-08-01,3,4645,1808,2277,2586,2774,14090
2023-08-02,3,2766,2194,1690,1849,4901,13400
2023-08-03,3,2899,2337,2718,2628,5016,15598
2023-08-04,3,4760,1769,2686,2871,2215,14301
2023-08-05,3,2102,1301,3196,4392,4498,15489
2023-08-06,3,2795,2643,3510,2246,3477,14671
2023-08-07,3,3055,2527,2438,3192,5320,16532
2023-08-08,3,3999,1238,2289,3035,5283,15844
2023-08-09,3,4889,943,2635,3115,4792,16374
2023-08-10,3,4094,2385,1478,1954,4552,14463
2023-08-11,3,1190,2291,1759,3138,3998,12376
2023-08-12,3,4531,2526,1694,3269,5368,17388
2023-08-13,3,3296,1458,1367,3752,2948,12821
2023-08-14,3,2966,2295,1940,4186,3266,14653
2023-08-15,3,3018,1555,3119,1992,5491,15175
2023-08-16,3,1625,1138,1254,2930,3910,10857
2023-08-17,3,1290,2606,3326,2061,2680,11963
2023-08-18,3,4264,2109,1387,3932,4473,16165
2023-08-19,3,3637,1200,1978,2226,4752,13793
2023-08-20,3,2167,1464,2780,3739,2545,12695
2023-08-21,3,4643,2284,1388,2052,4541,14908
2023-08-22,3,1676,1486,1613,3716,4505,12996
2023-08-23,3,4359,847,3531,2979,2700,14416
2023-08-24,3,1711,1016,1366,4057,4913,13063
2023-08-25,3,1698,1339,3814,2757,3434,13042
2023-08-26,3,4796,2516,3095,4239,2823,17469
2023-08-27,3,1205,1099,2144,2187,5474,12109
2023-08-28,3,4268,1173,2427,3109,2275,13252
2023-08-29,3,1846,2274,2863,1704,2664,11351
2023-08-30,3,3335,2026,1993,2679,3408,13441
2023-08-31,3,3268,2401,2721,2913,3446,14749
2023-09-01,3,3652,1640,1419,3460,3458,13629
2023-09-02,3,2589,1276,2968,4414,5279,16526
2023-09-03,3,4509,1497,2595,1532,3708,13841
2023-09-04,3,4852,1310,1380,1943,3599,13084
2023-09-05,3,2250,2936,1394,4177,4690,15447
2023-09-06,3,3940,2437,3849,1827,5684,17737
2023-09-07,3,4859,970,2771,2580,4759,15939
2023-09-08,3,1728,2080,1573,1699,3210,10290
2023-09-09,3,2863,2024,1967,1838,5233,13925
2023-09-10,3,2640,1973,3843,2513,4381,15350
2023-09-11,3,4509,1493,3592,3873,3689,17156
2023-09-12,3,2582,1669,1882,3176,3404,12713
2023-09-13,3,2552,2447,2801,2887,5097,15784
2023-09-14,3,1427,1392,2137,3618,2580,11154
2023-09-15,3,2244,2256,1816,4097,5218,15631
2023-09-16,3,2733,2901,2735,3499,4077,15945
2023-09-17,3,3415,2850,1562,4412,5560,17799
2023-09-18,3,3958,881,2630,1954,2486,11909
2023-09-19,3,4873,1887,1532,3097,3757,15146
2023-09-20,3,4496,2115,1352,4011,5225,17199
2023-09-21,3,1575,2183,1803,3540,3761,12862
2023-09-22,3,4605,1563,3482,1889,3774,15313
2023-09-23,3,4204,2395,2936,2838,3360,15733
2023-09-24,3,2143,1190,3413,4281,5649,16676
2023-09-25,3,3316,2900,3885,2355,3291,15747
2023-09-26,3,1995,1757,2731,3831,4067,14381
2023-09-27,3,1599,2652,2894,2402,5171,14718
2023-09-28,3,4546,1652,3587,1823,3832,15440
2023-09-29,3,4148,2739,1516,3607,2495,14505
2023-09-30,3,4638,2206,2711,4248,3001,16804
2023-10-01,3,4146,1108,3808,2148,2705,13915
2023-10-02,3,2307,2814,2514,3354,5230,16219
2023-10-03,3,1396,832,2907,1718,2652,9505
2023-10-04,3,4700,1552,3278,4474,4935,18939
2023-10-05,3,1599,1537,1206,4006,2900,11248
2023-10-06,3,4074,1792,3825,2826,3893,16410
2023-10-07,3,3154,960,1211,3084,2356,10765
2023-10-08,3,1419,1002,2058,3700,4739,12918
2023-10-09,3,3077,2372,3003,2914,4337,15703
2023-10-10,3,1640,2581,2204,3087,3031,12543
2023-10-11,3,3566,1607,2349,2191,4493,14206
2023-10-12,3,3160,2371,1398,2735,2960,12624
2023-10-13,3,4617,1216,2893,2993,3700,15419
2023-10-14,3,1208,2031,3262,3281,4681,14463
2023-10-15,3,1014,2913,2154,2749,3052,11882
2023-10-16,3,1091,2931,1810,2493,3535,11860
2023-10-17,3,3092,2410,1381,2824,3714,13421
2023-10-18,3,4125,2818,3304,1803,5808,17858
2023-10-19,3,1204,2288,2179,2184,4422,12277
2023-10-20,3,3879,1346,2166,3526,5242,16159
2023-10-21,3,3760,1324,2880,1710,4496,14170
2023-10-22,3,3782,2393,3567,3245,5938,18925
2023-10-23,3,4205,2149,1269,2335,3695,13653
2023-10-24,3,4045,2012,2689,2582,3245,14573
2023-10-25,3,1376,2183,1876,2180,5340,12955
2023-10-26,3,1809,1643,1211,1602,3949,10214
2023-10-27,3,2244,2462,1273,4033,4422,14434
2023-10-28,3,2211,1574,3283,2625,2598,12291
2023-10-29,3,4036,1780,2438,3499,3355,15108
2023-10-30,3,4569,1320,1444,1735,3353,12421
2023-10-31,3,1481,2893,3378,3572,2550,13874
2023-11-01,3,3919,1713,1963,3674,3433,14702
2023-11-02,3,2999,1873,3809,3578,2766,15025
2023-11-03,3,1597,2521,1289,3474,4504,13385
2023-11-04,3,1938,2440,2052,3555,2708,12693
2023-11-05,3,1884,1149,1575,3694,5716,14018
2023-11-06,3,3872,2947,2356,2138,2693,14006
2023-11-07,3,3067,1546,2010,3037,4078,13738
2023-11-08,3,2253,1896,3569,4480,5801,17999
2023-11-09,3,1822,2564,2981,2842,4919,15128
2023-11-10,3,3025,1619,1454,3493,2197,11788
2023-11-11,3,2189,1202,2727,1564,5199,12881
2023-11-12,3,2320,2068,2435,1735,4248,12806
2023-11-13,3,1566,1669,3529,4444,3735,14943
2023-11-14,3,2542,1409,2654,3421,3602,13628
2023-11-15,3,4587,1009,1801,2434,3489,13320
2023-11-16,3,3910,1494,2086,2603,5913,16006
2023-11-17,3,3886,2986,1663,1813,5718,16066
2023-11-18,3,2961,2520,1370,3266,5907,16024
2023-11-19,3,1378,1986,3699,4038,4866,15967
2023-11-20,3,1024,2711,1745,2768,2743,10991
2023-11-21,3,3393,889,3508,2720,4564,15074
2023-11-22,3,3672,2277,3141,4004,2566,15660
2023-11-23,3,2220,1943,3231,2435,4918,14747
2023-11-24,3,3845,2833,1279,4281,3118,15356
2023-11-25,3,3866,960,1507,3638,5420,15391
2023-11-26,3,3934,2357,3114,3257,3482,16144
2023-11-27,3,3006,2414,3077,3430,2037,13964
2023-11-28,3,4975,2882,1813,3562,5483,18715
2023-11-29,3,4143,2952,1458,3781,3473,15807
2023-11-30,3,2078,2500,2277,1704,3955,12514
2023-12-01,3,3270,1176,1455,2578,2360,10839
2023-12-02,3,1297,2972,1824,2027,5638,13758
2023-12-03,3,2638,2628,2162,3571,3700,14699
2023-12-04,3,2522,821,3949,2054,2225,11571
2023-12-05,3,1835,2029,3457,2839,4968,15128
2023-12-06,3,1714,1426,1299,4280,2241,10960
2023-12-07,3,2356,1379,2800,4051,5828,16414
2023-12-08,3,1864,2496,2958,2583,4148,14049
2023-12-09,3,2910,1437,2647,1957,3832,12783
2023-12-10,3,3808,1123,2847,1554,2991,12323
2023-12-11,3,3337,2745,2354,2230,2115,12781
2023-12-12,3,1496,2939,2866,1603,5263,14167
2023-12-13,3,4101,1791,2639,3401,3924,15856
2023-12-14,3,3779,1426,3194,4117,3036,15552
2023-12-15,3,4211,1739,1279,2839,2865,12933
2023-12-16,3,3529,2022,2025,3104,4888,15568
2023-12-17,3,2406,1672,3127,3764,5731,16700
2023-12-18,3,1045,2597,2063,2506,4736,12947
2023-12-19,3,3462,1303,1691,2013,2256,10725
2023-12-20,3,2086,826,2759,2609,4363,12643
2023-12-21,3,1103,1973,1521,4384,5650,14631
2023-12-22,3,3785,1029,2801,4437,3274,15326
2023-12-23,3,1606,2364,2155,2208,5842,14175
2023-12-24,3,2944,1029,2429,1928,3114,11444
2023-12-25,3,1815,2950,1227,2155,3860,12007
2023-12-26,3,2083,2991,1729,3728,5808,16339
2023-12-27,3,3462,2284,2599,3203,5104,16652
2023-12-28,3,2852,2030,1212,1783,4810,12687
2023-12-29,3,2041,862,2923,3561,3761,13148
2023-12-30,3,4834,2391,2978,1971,5974,18148
2023-12-31,3,2650,1284,2507,2241,4401,13083
2022-01-01,4,4410,1442,2223,3379,5093,16547
2022-01-02,4,2189,2002,3740,3659,2211,13801
2022-01-03,4,1971,972,1208,3507,5353,13011
2022-01-04,4,1217,1859,3361,3881,3961,14279
2022-01-05,4,3793,2874,2643,3554,2586,15450
2022-01-06,4,3388,2600,3439,3641,2492,15560
2022-01-07,4,4520,2316,2281,3494,4506,17117
2022-01-08,4,2471,831,2080,1568,2412,9362
2022-01-09,4,4619,2183,2744,2622,2343,14511
2022-01-10,4,2481,1398,2637,3952,3108,13576
2022-01-11,4,4757,1988,1406,2897,5057,16105
2022-01-12,4,3979,1818,2400,3311,4100,15608
2022-01-13,4,4846,2672,2891,1602,4401,16412
2022-01-14,4,2378,2309,3345,3344,2284,13660
2022-01-15,4,4839,1563,1363,3081,3645,14491
2022-01-16,4,4707,2501,2692,4432,3307,17639
2022-01-17,4,2963,809,2064,4381,5491,15708
2022-01-18,4,2893,1470,2393,2306,4241,13303
2022-01-19,4,1648,2327,1215,2848,3845,11883
2022-01-20,4,4797,2088,3304,3577,4013,17779
2022-01-21,4,2421,1126,2060,3797,3422,12826
2022-01-22,4,1562,1727,3699,2222,5547,14757
2022-01-23,4,2409,1952,3934,2639,5547,16481
2022-01-24,4,1079,1099,3622,1805,3960,11565
2022-01-25,4,4940,1933,1941,4165,2382,15361
2022-01-26,4,3309,1685,2324,3270,5444,16032
2022-01-27,4,4783,2723,1455,3296,2751,15008
2022-01-28,4,2007,1253,1213,1929,2508,8910
2022-01-29,4,4769,915,1967,3487,4778,15916
2022-01-30,4,2890,2781,2001,2860,5891,16423
2022-01-31,4,4515,2484,3216,3770,3914,17899
2022-02-01,4,1276,2527,2690,1781,3119,11393
2022-02-02,4,1390,2189,2085,3134,2045,10843
2022-02-03,4,2715,1088,3803,2843,4013,14462
2022-02-04,4,1488,2784,3014,2402,3545,13233
2022-02-05,4,2772,1580,1995,3218,5670,15235
2022-02-06,4,3931,1801,1861,2493,5597,15683
2022-02-07,4,4638,899,3201,4488,3588,16814
2022-02-08,4,2945,2766,3810,2398,5214,17133
2022-02-09,4,1772,1850,2696,3418,4594,14330
2022-02-10,4,1847,2951,2790,3574,4959,16121
2022-02-11,4,1230,1722,2242,2163,3582,10939
2022-02-12,4,3280,1875,1200,2458,2721,11534
2022-02-13,4,1774,1586,3337,2682,4977,14356
2022-02-14,4,3630,2249,1281,2144,3528,12832
2022-02-15,4,2839,2571,3118,3979,5114,17621
2022-02-16,4,1416,816,3260,4093,5853,15438
2022-02-17,4,3982,1206,3385,2594,2194,13361
2022-02-18,4,3842,2282,3148,4001,5982,19255
2022-02-19,4,2408,1064,3294,1740,3361,11867
2022-02-20,4,3033,870,3770,4225,3059,14957
2022-02-21,4,1483,2996,3173,3826,2022,13500
2022-02-22,4,4322,915,2056,3852,4407,15552
2022-02-23,4,3493,1182,2838,3068,4727,15308
2022-02-24,4,4596,1621,3135,2924,2700,14976
2022-02-25,4,4176,2183,3444,1661,2573,14037
2022-02-26,4,3052,2100,2652,2517,2617,12938
2022-02-27,4,1440,2331,1720,3897,4263,13651
2022-02-28,4,1499,2666,2861,3448,5936,16410
2022-03-01,4,4641,2242,1897,2469,2742,13991
2022-03-02,4,3227,998,3103,2986,4593,14907
2022-03-03,4,2337,2771,3880,3797,3761,16546
2022-03-04,4,1449,1072,2134,3281,2574,10510
2022-03-05,4,1102,1251,3402,3484,5985,15224
2022-03-06,4,4799,2955,3595,1529,2592,15470
2022-03-07,4,1107,859,1624,2019,5642,11251
2022-03-08,4,4562,1992,3043,3043,5514,18154
2022-03-09,4,1236,1401,3258,2680,3575,12150
2022-03-10,4,3671,2445,2920,4108,2794,15938
2022-03-11,4,4819,2566,2970,2749,5521,18625
2022-03-12,4,1693,2589,1276,4331,5490,15379
2022-03-13,4,2185,1517,2081,1535,3781,11099
2022-03-14,4,1744,1989,2852,4387,3032,14004
2022-03-15,4,1295,1669,1523,3124,4791,12402
2022-03-16,4,3541,936,2111,4398,5107,16093
2022-03-17,4,1197,1782,3937,3871,3676,14463
2022-03-18,4,1985,2071,1665,1537,4098,11356
2022-03-19,4,3790,1839,2496,2084,3645,13854
2022-03-20,4,1589,1352,2839,2033,5235,13048
2022-03-21,4,4734,2753,3824,3630,4365,19306
2022-03-22,4,2781,2971,3823,2374,3261,15210
2022-03-23,4,1638,2057,1252,2421,2068,9436
2022-03-24,4,2591,2464,2219,1880,5655,14809
2022-03-25,4,4859,2477,2367,2656,4554,16913
2022-03-26,4,4861,1359,3759,1516,3123,14618
2022-03-27,4,1793,2185,1478,2754,3281,11491
2022-03-28,4,2278,885,1224,2106,3399,9892
2022-03-29,4,2106,2433,2870,1662,2929,12000
2022-03-30,4,3224,1172,3562,4142,3873,15973
2022-03-31,4,3424,1459,3145,2489,4292,14809
2022-04-01,4,2906,2862,3842,3191,2868,15669
2022-04-02,4,2436,1699,3135,3915,5597,16782
2022-04-03,4,3900,2242,1696,1664,5554,15056
2022-04-04,4,2136,2204,2842,4342,5934,17458
2022-04-05,4,1629,2557,1259,4277,4209,13931
2022-04-06,4,2649,2729,2096,4409,5544,17427
2022-04-07,4,4697,1444,2692,3089,2984,14906
2022-04-08,4,3981,1754,1605,4311,4904,16555
2022-04-09,4,4459,1614,1285,3139,3907,14404
2022-04-10,4,4344,1817,1316,3112,5807,16396
2022-04-11,4,1524,2258,3712,2153,4978,14625
2022-04-12,4,2582,2999,1978,3328,4244,15131
2022-04-13,4,3712,2662,2813,3550,4324,17061
2022-04-14,4,2970,1401,3282,1500,4970,14123
2022-04-15,4,2744,1697,1472,4222,3558,13693
2022-04-16,4,1527,1852,2510,4000,5157,15046
2022-04-17,4,4271,1473,3960,3312,4604,17620
2022-04-18,4,4370,2257,1341,1761,3518,13247
2022-04-19,4,3799,2191,3877,4401,2003,16271
2022-04-20,4,4783,1375,1660,2964,2398,13180
2022-04-21,4,3305,1787,1807,4123,2749,13771
2022-04-22,4,2732,2162,2732,1995,2933,12554
2022-04-23,4,2347,1767,2623,1620,4248,12605
2022-04-24,4,4105,2676,3957,1701,5469,17908
2022-04-25,4,1752,2534,2873,2799,5331,15289
2022-04-26,4,4531,1072,2971,1568,3727,13869
2022-04-27,4,1676,1689,3682,4412,4565,16024
2022-04-28,4,3113,943,3201,3011,3075,13343
2022-04-29,4,3129,2781,3185,3320,3172,15587
2022-04-30,4,2557,1664,2361,1942,5715,14239
2022-05-01,4,1171,2879,2942,3288,5483,15763
2022-05-02,4,4553,1186,1335,3358,2945,13377
2022-05-03,4,2629,2981,2528,1945,5854,15937
2022-05-04,4,3681,1617,1218,3683,4272,14471
2022-05-05,4,3871,1687,3349,4220,2363,15490
2022-05-06,4,2999,2791,2902,2624,5108,16424
2022-05-07,4,4304,919,2801,2776,3294,14094
2022-05-08,4,3657,1229,3692,4388,3187,16153
2022-05-09,4,1097,924,3580,2268,2250,10119
2022-05-10,4,3083,1769,3534,4152,5625,18163
2022-05-11,4,2086,1897,1951,2569,3803,12306
2022-05-12,4,1180,2726,1962,1636,2598,10102
2022-05-13,4,3682,2991,2550,2212,3897,15332
2022-05-14,4,2051,1014,1857,1884,5062,11868
2022-05-15,4,3848,1407,2145,3884,5307,16591
2022-05-16,4,2632,1422,2392,2562,5491,14499
2022-05-17,4,2309,1125,2536,1554,2219,9743
2022-05-18,4,1777,1675,3404,1519,4956,13331
2022-05-19,4,2864,2726,2797,4384,4618,17389
2022-05-20,4,1063,2308,2172,1922,3464,10929
2022-05-21,4,3875,1260,3443,2654,3170,14402
2022-05-22,4,2702,2870,3654,2428,2288,13942
2022-05-23,4,1991,1440,1928,2490,3500,11349
2022-05-24,4,4528,1924,3286,2086,2475,14299
2022-05-25,4,2502,2887,1590,3448,2544,12971
2022-05-26,4,3120,1582,1244,1895,4494,12335
2022-05-27,4,3485,2265,3929,1960,4344,15983
2022-05-28,4,4361,2746,2731,2559,4298,16695
2022-05-29,4,4783,2513,3874,2279,2703,16152
2022-05-30,4,1442,2667,1329,3988,3715,13141
2022-05-31,4,1146,2240,1823,2146,4516,11871
2022-06-01,4,1737,1785,3333,2906,2561,12322
2022-06-02,4,2044,2580,3257,4404,5239,17524
2022-06-03,4,4236,2644,1467,2841,4476,15664
2022-06-04,4,1174,2216,1487,3513,5905,14295
2022-06-05,4,2697,2892,3586,1753,4958,15886
2022-06-06,4,4874,1188,3453,1935,5214,16664
2022-06-07,4,3978,2423,3669,3509,3757,17336
2022-06-08,4,2826,1142,1872,3061,3539,12440
2022-06-09,4,1326,2919,3674,3048,4407,15374
2022-06-10,4,1653,2991,3562,2758,4910,15874
2022-06-11,4,3953,1305,3486,1674,4396,14814
2022-06-12,4,3436,1229,3591,3974,4470,16700
2022-06-13,4,1404,2141,2157,3001,2849,11552
2022-06-14,4,4023,1907,1906,3562,3740,15138
2022-06-15,4,1694,2588,2526,3733,2945,13486
2022-06-16,4,4656,1429,2304,1868,2389,12646
2022-06-17,4,1026,2001,3071,1963,2331,10392
2022-06-18,4,2028,1975,2132,1802,4728,12665
2022-06-19,4,3596,1744,1748,2363,2832,12283
2022-06-20,4,2453,2399,3129,3384,2057,13422
2022-06-21,4,2334,2362,1550,3353,3066,12665
2022-06-22,4,4716,1117,3133,1924,3938,14828
2022-06-23,4,3359,1987,3719,4441,4346,17852
2022-06-24,4,3951,2266,1976,2627,4025,14845
2022-06-25,4,2700,2673,3130,3380,2837,14720
2022-06-26,4,4589,1171,3766,2034,5217,16777
2022-06-27,4,4104,1544,2321,3061,5902,16932
2022-06-28,4,2831,1504,1763,2960,2111,11169
2022-06-29,4,4167,2951,2724,3980,4240,18062
2022-06-30,4,1785,1625,2265,2581,5526,13782
2022-07-01,4,3100,2338,1858,2036,3674,13006
2022-07-02,4,1444,1512,3285,1686,5888,13815
2022-07-03,4,3820,2151,1771,4258,5438,17438
2022-07-04,4,4540,2729,2434,4026,4422,18151
2022-07-05,4,1493,2607,3416,3486,3344,14346
2022-07-06,4,2724,2825,2864,2096,3636,14145
2022-07-07,4,1130,1405,3027,3889,4923,14374
2022-07-08,4,2328,1904,2548,4080,2562,13422
2022-07-09,4,3985,2831,1938,2854,5469,17077
2022-07-10,4,2885,1675,2688,2324,4430,14002
2022-07-11,4,3609,1726,3041,2767,2120,13263
2022-07-12,4,1256,2212,1328,2220,3640,10656
2022-07-13,4,2937,830,1564,3680,2840,11851
2022-07-14,4,4441,1357,1397,3720,4381,15296
2022-07-15,4,3166,2445,1679,1600,2284,11174
2022-07-16,4,1686,2765,3622,3995,3225,15293
2022-07-17,4,4399,2593,1924,4288,3542,16746
2022-07-18,4,2241,2636,3490,2088,5506,15961
2022-07-19,4,4156,1528,3284,1544,2064,12576
2022-07-20,4,2344,1051,1814,3170,2560,10939
2022-07-21,4,1605,2885,3142,1708,2961,12301
2022-07-22,4,1472,1610,2100,2278,5756,13216
2022-07-23,4,3111,1879,2348,4404,2406,14148
2022-07-24,4,1102,2776,2165,2487,4541,13071
2022-07-25,4,3761,2546,3807,2688,4200,17002
2022-07-26,4,3159,2219,3805,2136,4648,15967
2022-07-27,4,3265,1083,1834,4307,4910,15399
2022-07-28,4,1625,1146,1519,3877,4056,12223
2022-07-29,4,1170,1540,3269,1772,5657,13408
2022-07-30,4,1371,824,1376,2206,2525,8302
2022-07-31,4,4606,2009,3080,4435,3679,17809
2022-08-01,4,4304,2501,3465,2268,2348,14886
2022-08-02,4,3779,2678,1907,4428,5453,18245
2022-08-03,4,3654,1576,1302,1903,5317,13752
2022-08-04,4,4507,1040,1283,3033,3102,12965
2022-08-05,4,2682,1573,1360,3886,2371,11872
2022-08-06,4,1420,1250,3685,4114,2147,12616
2022-08-07,4,1687,1280,1943,1983,4630,11523
2022-08-08,4,1462,1690,2624,2459,2381,10616
2022-08-09,4,4148,2985,2789,3348,3893,17163
2022-08-10,4,3705,847,1429,3774,4321,14076
2022-08-11,4,2282,2790,3364,3638,4030,16104
2022-08-12,4,4941,1646,1881,3477,4952,16897
2022-08-13,4,1858,848,1586,4109,5095,13496
2022-08-14,4,4932,2027,2847,2475,5101,17382
2022-08-15,4,1566,2553,3424,3668,2939,14150
2022-08-16,4,2453,878,1805,1832,4357,11325
2022-08-17,4,3191,1323,1365,4110,5931,15920
2022-08-18,4,3065,1925,1354,2739,4887,13970
2022-08-19,4,4116,2232,3269,2542,2133,14292
2022-08-20,4,4818,1415,3464,2066,4343,16106
2022-08-21,4,3453,945,1522,4033,2773,12726
2022-08-22,4,4930,1380,3506,2415,5731,17962
2022-08-23,4,4090,1768,1425,2192,3727,13202
2022-08-24,4,1964,1664,2828,1581,3098,11135
2022-08-25,4,2278,1386,2013,3068,4029,12774
2022-08-26,4,1739,2533,1722,4467,3502,13963
2022-08-27,4,4669,1951,2213,1871,3262,13966
2022-08-28,4,1672,2947,3728,3603,4521,16471
2022-08-29,4,2035,1523,3606,2409,5413,14986
2022-08-30,4,1930,1097,3556,1566,2586,10735
2022-08-31,4,3741,2691,1804,3145,3469,14850
2022-09-01,4,3197,2243,1854,2766,5971,16031
2022-09-02,4,4432,2586,3178,2952,3537,16685
2022-09-03,4,3806,2370,2544,2297,4850,15867
2022-09-04,4,3021,2687,1427,2624,3746,13505
2022-09-05,4,2218,1005,1774,4264,5046,14307
2022-09-06,4,2347,2316,3881,2743,5723,17010
2022-09-07,4,2080,1763,3838,2485,3313,13479
2022-09-08,4,1729,1273,3148,1794,5770,13714
2022-09-09,4,4907,1813,2095,3910,2707,15432
2022-09-10,4,1019,2305,3903,3912,4483,15622
2022-09-11,4,4630,2776,2758,3170,4725,18059
2022-09-12,4,4534,1808,3650,3471,2171,15634
2022-09-13,4,1700,1672,1469,2056,5639,12536
2022-09-14,4,3762,2497,3477,3003,3802,16541
2022-09-15,4,3466,2973,1477,2146,3724,13786
2022-09-16,4,2741,2393,1221,1588,2897,10840
2022-09-17,4,1772,1984,3419,3683,5876,16734
2022-09-18,4,1985,1566,2231,3115,3324,12221
2022-09-19,4,1221,2588,2843,2642,5029,14323
2022-09-20,4,1490,2000,2257,4051,3569,13367
2022-09-21,4,4682,1103,2272,2043,2598,12698
2022-09-22,4,4481,1741,2230,1811,3329,13592
2022-09-23,4,1106,2350,1660,3382,3164,11662
2022-09-24,4,1411,2220,2678,3512,5339,15160
2022-09-25,4,4487,2106,3992,4232,4215,19032
2022-09-26,4,3876,2964,3354,2708,3456,16358
2022-09-27,4,2622,2251,2460,2087,5713,15133
2022-09-28,4,3844,2616,3761,3753,5308,19282
2022-09-29,4,4671,1977,1431,4158,2164,14401
2022-09-30,4,2025,1497,1647,3691,4166,13026
2022-10-01,4,1704,824,3216,4345,2931,13020
2022-10-02,4,1399,1653,2585,3200,3707,12544
2022-10-03,4,4644,887,1819,3797,3595,14742
2022-10-04,4,3736,1250,2362,4203,5889,17440
2022-10-05,4,1381,2240,1806,3666,4217,13310
2022-10-06,4,2693,2541,2601,4335,3070,15240
2022-10-07,4,3675,2644,3782,3438,2288,15827
2022-10-08,4,1386,2491,1734,3811,4777,14199
2022-10-09,4,4129,1501,3359,1693,2728,13410
2022-10-10,4,2866,1093,1332,2671,2867,10829
2022-10-11,4,3293,1597,1730,3052,4773,14445
2022-10-12,4,1431,1445,1723,3390,2274,10263
2022-10-13,4,2289,2136,2897,3130,2260,12712
2022-10-14,4,2314,2389,3545,1693,2143,12084
2022-10-15,4,2467,2007,2955,3579,3386,14394
2022-10-16,4,3771,2166,1555,1894,5471,14857
2022-10-17,4,3762,1226,3219,3291,3610,15108
2022-10-18,4,3320,2127,2960,1863,5302,15572
2022-10-19,4,4132,2869,2858,3307,3928,17094
2022-10-20,4,2071,1937,1492,4120,4582,14202
2022-10-21,4,4804,1801,2777,2290,3150,14822
2022-10-22,4,1878,2146,2828,4363,3044,14259
2022-10-23,4,3918,1020,2214,2484,3217,12853
2022-10-24,4,3873,1683,1236,4405,4021,15218
2022-10-25,4,1450,1498,3028,2312,4779,13067
2022-10-26,4,3652,2687,2762,1779,2882,13762
2022-10-27,4,2955,1557,2505,4161,5754,16932
2022-10-28,4,4901,1986,3739,4172,3376,18174
2022-10-29,4,4928,1667,2390,2710,2138,13833
2022-10-30,4,1723,2155,2234,3505,4417,14034
2022-10-31,4,1102,1498,2468,4113,5476,14657
2022-11-01,4,3007,2698,3179,2374,4795,16053
2022-11-02,4,2190,2721,2037,3494,3132,13574
2022-11-03,4,1378,1467,2676,2487,5016,13024
2022-11-04,4,3879,2884,1572,4465,4327,17127
2022-11-05,4,1339,1935,2193,3215,2516,11198
2022-11-06,4,2355,2242,2603,2833,2534,12567
2022-11-07,4,3901,1328,2012,4135,3261,14637
2022-11-08,4,3976,2360,2774,1554,5578,16242
2022-11-09,4,1770,2960,1480,3430,2144,11784
2022-11-10,4,4225,1083,3902,3174,2943,15327
2022-11-11,4,3592,2905,1566,4087,2558,14708
2022-11-12,4,1035,1279,2851,1880,5095,12140
2022-11-13,4,2892,2831,2125,2828,2036,12712
2022-11-14,4,4161,1521,2982,3035,2924,14623
2022-11-15,4,3201,2827,3813,2336,2985,15162
2022-11-16,4,4278,1913,2598,1528,4202,14519
2022-11-17,4,2277,2728,1481,4166,2040,12692
2022-11-18,4,4800,1500,2078,4181,2447,15006
2022-11-19,4,4619,2709,2944,3676,5510,19458
2022-11-20,4,4003,2277,1218,4241,4534,16273
2022-11-21,4,3341,1075,3675,4102,2751,14944
2022-11-22,4,1908,1803,2991,3481,4684,14867
2022-11-23,4,4016,2727,1923,4081,5219,17966
2022-11-24,4,4050,2612,2115,3977,3937,16691
2022-11-25,4,3871,2059,3646,3481,3745,16802
2022-11-26,4,3324,881,3294,4167,3760,15426
2022-11-27,4,4770,1536,3988,3133,3123,16550
2022-11-28,4,3380,1839,2363,3911,3674,15167
2022-11-29,4,4725,2344,3060,1886,3080,15095
2022-11-30,4,2684,885,2556,4435,2934,13494
2022-12-01,4,3464,1332,2596,1728,4978,14098
2022-12-02,4,1272,2456,3984,3634,5847,17193
2022-12-03,4,4632,939,2625,3270,4811,16277
2022-12-04,4,3374,978,1277,4295,2565,12489
2022-12-05,4,4675,1875,3672,3523,3093,16838
2022-12-06,4,1590,2760,3055,3024,2896,13325
2022-12-07,4,4358,1361,2674,2478,3479,14350
2022-12-08,4,2728,2550,3172,2631,4654,15735
2022-12-09,4,2721,1289,3019,1768,2237,11034
2022-12-10,4,3437,2601,1480,3488,2033,13039
2022-12-11,4,3570,2357,1816,1692,2735,12170
2022-12-12,4,3749,2967,3406,4008,5291,19421
2022-12-13,4,1291,1096,3082,1730,3683,10882
2022-12-14,4,4883,1986,1681,1540,4193,14283
2022-12-15,4,1242,2112,2155,3308,5138,13955
2022-12-16,4,1180,2415,3256,2648,2311,11810
2022-12-17,4,2484,2021,3249,2516,2226,12496
2022-12-18,4,3602,2611,3871,4147,5170,19401
2022-12-19,4,2995,2118,3476,3968,3228,15785
2022-12-20,4,3784,1292,1833,2992,2480,12381
2022-12-21,4,2726,2659,1451,2459,3068,12363
2022-12-22,4,1727,1099,2351,3132,5050,13359
2022-12-23,4,4752,1730,1848,4088,4523,16941
2022-12-24,4,4232,2316,1264,1527,5002,14341
2022-12-25,4,4835,1181,2644,2734,3436,14830
2022-12-26,4,1288,2902,1859,4015,5321,15385
2022-12-27,4,1075,2150,2458,2531,5194,13408
2022-12-28,4,4959,1260,2494,2117,4090,14920
2022-12-29,4,4507,1580,2503,4146,3967,16703
2022-12-30,4,4867,2045,2986,3806,3085,16789
2022-12-31,4,2789,1518,2098,2762,5873,15040
2023-01-01,4,1849,2570,3728,1730,4656,14533
2023-01-02,4,2257,2680,3928,2995,2365,14225
2023-01-03,4,4256,1312,1677,3056,2587,12888
2023-01-04,4,1968,1509,2810,1545,2496,10328
2023-01-05,4,1181,2549,2825,2349,5160,14064
2023-01-06,4,2675,2476,2869,4065,4778,16863
2023-01-07,4,1346,1013,1208,2564,3258,9389
2023-01-08,4,4552,2460,1925,4220,4380,17537
2023-01-09,4,3408,2176,2156,2118,2999,12857
2023-01-10,4,2902,1692,1973,2223,4750,13540
2023-01-11,4,3744,1319,3473,3003,2502,14041
2023-01-12,4,4050,1947,2900,2213,3869,14979
2023-01-13,4,4533,2907,2289,1712,4778,16219
2023-01-14,4,2617,2208,2775,3684,4090,15374
2023-01-15,4,3441,2285,3625,1597,3256,14204
2023-01-16,4,4909,2961,3786,2165,2643,16464
2023-01-17,4,4864,2373,1982,3195,3230,15644
2023-01-18,4,1365,1976,3668,2878,3531,13418
2023-01-19,4,1987,2837,3116,4202,5076,17218
2023-01-20,4,4789,2771,3710,2032,4279,17581
2023-01-21,4,4400,1018,2017,3033,5912,16380
2023-01-22,4,3650,1667,2523,3861,5604,17305
2023-01-23,4,3738,2813,2410,3880,5932,18773
2023-01-24,4,1307,2437,1613,3026,5597,13980
2023-01-25,4,4610,1597,3868,2155,5247,17477
2023-01-26,4,3462,1964,1642,3928,2027,13023
2023-01-27,4,1331,1447,3207,2967,3616,12568
2023-01-28,4,1627,1499,2684,4331,3469,13610
2023-01-29,4,2966,2095,1506,3456,3865,13888
2023-01-30,4,3008,2908,3616,2525,4240,16297
2023-01-31,4,2257,1884,1982,3650,2138,11911
2023-02-01,4,4218,2389,2262,2640,4136,15645
2023-02-02,4,3542,1913,1697,4313,2573,14038
2023-02-03,4,1381,2027,3644,3984,2195,13231
2023-02-04,4,2701,2467,1847,3870,2049,12934
2023-02-05,4,1516,1218,2096,2112,4534,11476
2023-02-06,4,1996,2651,3518,1909,2556,12630
2023-02-07,4,4451,2034,1555,3965,5142,17147
2023-02-08,4,2088,2103,3448,2421,5410,15470
2023-02-09,4,1571,2787,1618,1631,5999,13606
2023-02-10,4,1035,2272,3432,1957,4988,13684
2023-02-11,4,3666,1196,3226,1563,3949,13600
2023-02-12,4,3120,2786,2132,1862,2075,11975
2023-02-13,4,4332,2798,2855,4161,3218,17364
2023-02-14,4,2668,1148,1909,1864,2237,9826
2023-02-15,4,2261,2517,1433,3202,2315,11728
2023-02-16,4,1039,2399,2063,4405,4702,14608
2023-02-17,4,4612,2081,2647,2690,4715,16745
2023-02-18,4,2382,2202,1807,1936,4423,12750
2023-02-19,4,4798,2597,2945,2786,4730,17856
2023-02-20,4,3997,1251,3599,2714,5854,17415
2023-02-21,4,4454,2956,1200,2832,4680,16122
2023-02-22,4,3965,2521,2748,3820,4977,18031
2023-02-23,4,2261,1324,2857,3806,2627,12875
2023-02-24,4,1042,2154,1844,2143,3291,10474
2023-02-25,4,2352,2322,3999,2030,3985,14688
2023-02-26,4,3139,2263,2953,1877,4466,14698
2023-02-27,4,3960,1304,2148,3185,3548,14145
2023-02-28,4,2132,1693,3047,2412,5896,15180
2023-03-01,4,3348,1511,2064,1965,3768,12656
2023-03-02,4,1117,1056,1575,3429,2114,9291
2023-03-03,4,2045,825,3064,2932,4849,13715
2023-03-04,4,2103,1791,2252,2435,3088,11669
2023-03-05,4,1824,2649,3299,4329,5556,17657
2023-03-06,4,1298,1844,2620,3943,2311,12016
2023-03-07,4,4135,1044,2275,3039,2794,13287
2023-03-08,4,1810,1960,1742,4082,3334,12928
2023-03-09,4,3067,2567,3395,3414,5210,17653
2023-03-10,4,2988,1530,2153,2529,4715,13915
2023-03-11,4,1367,930,3442,2949,2116,10804
2023-03-12,4,3129,2724,1373,2575,3399,13200
2023-03-13,4,3198,1501,2922,2065,5832,15518
2023-03-14,4,3294,2685,2752,2730,3689,15150
2023-03-15,4,1755,1026,2691,4462,5038,14972
2023-03-16,4,4184,1006,2381,2200,5602,15373
2023-03-17,4,4317,2647,1288,2253,4155,14660
2023-03-18,4,2032,2586,1783,3196,4948,14545
2023-03-19,4,2349,2644,3043,3607,5512,17155
2023-03-20,4,1877,2127,1630,2530,4603,12767
2023-03-21,4,1174,2154,1673,3339,3807,12147
2023-03-22,4,4371,1373,3327,3154,5880,18105
2023-03-23,4,4003,2045,2637,2971,4759,16415
2023-03-24,4,3570,2920,2113,1937,5851,16391
2023-03-25,4,3960,824,1360,2832,2329,11305
2023-03-26,4,3505,1908,1838,2404,4948,14603
2023-03-27,4,4805,800,2435,1702,5747,15489
2023-03-28,4,2306,2215,2722,1827,2570,11640
2023-03-29,4,2758,1851,3587,1760,3644,13600
2023-03-30,4,2493,1550,2429,3495,3608,13575
2023-03-31,4,2555,2928,3000,4059,4954,17496
2023-04-01,4,2933,2930,2366,1717,5219,15165
2023-04-02,4,3368,1672,2005,1655,2200,10900
2023-04-03,4,1696,1559,2677,4232,4715,14879
2023-04-04,4,2436,1960,2611,1803,3116,11926
2023-04-05,4,1354,957,2335,1537,2109,8292
2023-04-06,4,1303,984,3229,1872,4217,11605
2023-04-07,4,2135,2400,1357,1631,2748,10271
2023-04-08,4,2169,1449,3110,3881,3919,14528
2023-04-09,4,2441,2877,2758,3559,5947,17582
2023-04-10,4,4474,1088,3986,4399,3514,17461
2023-04-11,4,1864,1983,3098,1799,2403,11147
2023-04-12,4,1557,2849,1696,2807,3514,12423
2023-04-13,4,4833,1602,2267,1599,3342,13643
2023-04-14,4,3378,949,1342,4473,3665,13807
2023-04-15,4,2536,2532,2828,2320,2809,13025
2023-04-16,4,4968,2961,3046,3437,2657,17069
2023-04-17,4,1945,2085,3920,3338,4042,15330
2023-04-18,4,3112,1426,1290,2959,5018,13805
2023-04-19,4,1592,2086,1397,2251,2962,10288
2023-04-20,4,1236,1087,1929,2549,3353,10154
2023-04-21,4,3925,1519,1709,1551,3977,12681
2023-04-22,4,3973,2834,3233,1874,3114,15028
2023-04-23,4,2261,2157,2125,4007,3055,13605
2023-04-24,4,1125,808,3464,3127,2681,11205
2023-04-25,4,3254,1170,2584,3135,2274,12417
2023-04-26,4,2544,2512,2852,2890,3406,14204
2023-04-27,4,1743,2848,3633,3308,5395,16927
2023-04-28,4,2551,1032,1289,2924,3713,11509
2023-04-29,4,1696,2115,1820,1902,5630,13163
2023-04-30,4,1755,2627,2334,1775,2032,10523
2023-05-01,4,4380,2838,3140,2007,3257,15622
2023-05-02,4,1066,2344,1444,1830,4125,10809
2023-05-03,4,4878,2810,1381,3341,2072,14482
2023-05-04,4,2225,2767,3519,3707,3436,15654
2023-05-05,4,4763,2298,2870,3779,3172,16882
2023-05-06,4,2206,1987,2373,1591,4737,12894
2023-05-07,4,2053,2245,3493,3061,5650,16502
2023-05-08,4,2000,2250,1537,4239,2736,12762
2023-05-09,4,1205,1580,3969,2236,5577,14567
2023-05-10,4,4644,1470,3387,2449,5757,17707
2023-05-11,4,3777,1520,3761,2509,4868,16435
2023-05-12,4,2712,995,2884,4066,5980,16637
2023-05-13,4,4849,2393,1474,3818,3094,15628
2023-05-14,4,2139,1087,2905,2829,3866,12826
2023-05-15,4,4270,1507,2441,1598,4851,14667
2023-05-16,4,3230,1382,1636,4149,2093,12490
2023-05-17,4,2486,1052,3645,1998,3538,12719
2023-05-18,4,2344,2343,3887,4239,5204,18017
2023-05-19,4,2528,1418,1941,4113,5405,15405
2023-05-20,4,4406,887,3153,4285,5020,17751
2023-05-21,4,3713,2602,3528,3262,4578,17683
2023-05-22,4,2603,2663,3194,2225,4917,15602
2023-05-23,4,3776,2235,1213,4461,5189,16874
2023-05-24,4,1212,1727,2748,2059,3731,11477
2023-05-25,4,1618,2259,2708,1977,3475,12037
2023-05-26,4,3390,2220,2198,4145,2078,14031
2023-05-27,4,4656,970,1529,3838,2715,13708
2023-05-28,4,1947,2934,1742,1610,4401,12634
2023-05-29,4,2318,2386,1328,3230,2458,11720
2023-05-30,4,3769,2091,2194,2431,5840,16325
2023-05-31,4,4878,1471,2148,4446,4551,17494
2023-06-01,4,1719,1724,2367,2863,4030,12703
2023-06-02,4,4854,1767,3967,2044,5135,17767
2023-06-03,4,2814,2477,3723,1641,3253,13908
2023-06-04,4,4140,2988,1815,3261,3376,15580
2023-06-05,4,1113,1917,1262,3149,4532,11973
2023-06-06,4,2996,1724,1417,3931,5308,15376
2023-06-07,4,2416,1502,1309,1974,3335,10536
2023-06-08,4,4101,2895,1635,2535,4807,15973
2023-06-09,4,2293,1950,2112,3497,4751,14603
2023-06-10,4,2033,1213,2846,4392,3636,14120
2023-06-11,4,4628,2241,3691,3218,2488,16266
2023-06-12,4,4632,1327,2961,4500,4142,17562
2023-06-13,4,2891,2384,2262,1934,5566,15037
2023-06-14,4,1554,933,2409,4433,5919,15248
2023-06-15,4,2430,2015,3030,3582,4262,15319
2023-06-16,4,4860,1914,3369,2661,4066,16870
2023-06-17,4,1529,1473,1414,2780,3851,11047
2023-06-18,4,2339,1970,3466,2302,3600,13677
2023-06-19,4,4792,2516,1420,2620,3613,14961
2023-06-20,4,4269,1513,1974,3238,2306,13300
2023-06-21,4,2505,1124,2092,2871,5906,14498
2023-06-22,4,1079,2596,3478,2002,4111,13266
2023-06-23,4,4532,2292,2724,2570,4924,17042
2023-06-24,4,1826,2873,1557,2612,3851,12719
2023-06-25,4,1093,2065,3275,4254,5030,15717
2023-06-26,4,3181,1943,1908,3456,3175,13663
2023-06-27,4,1574,2241,1771,3656,4804,14046
2023-06-28,4,1029,1401,2616,4333,5067,14446
2023-06-29,4,4614,985,2065,2716,2797,13177
2023-06-30,4,1372,934,3509,3786,5094,14695
2023-07-01,4,1786,2944,3208,2682,3501,14121
2023-07-02,4,4735,1531,1561,4188,4614,16629
2023-07-03,4,3026,2621,3266,3161,3557,15631
2023-07-04,4,3436,2727,3645,2604,5766,18178
2023-07-05,4,2633,909,1896,2116,5373,12927
2023-07-06,4,2261,1870,2793,3519,5902,16345
2023-07-07,4,2000,1472,2140,2834,5860,14306
2023-07-08,4,2638,1170,3588,4145,2273,13814
2023-07-09,4,1361,1596,2855,2158,2618,10588
2023-07-10,4,4864,879,2904,3291,2727,14665
2023-07-11,4,1928,1263,3545,3215,3622,13573
2023-07-12,4,1387,1064,3650,1894,4084,12079
2023-07-13,4,4679,1638,2043,4054,2790,15204
2023-07-14,4,3097,2377,3793,4248,4609,18124
2023-07-15,4,3923,2508,3470,4011,4830,18742
2023-07-16,4,4694,1098,3558,4129,4693,18172
2023-07-17,4,4229,1205,3998,2184,2728,14344
2023-07-18,4,2566,1094,3175,4239,2843,13917
2023-07-19,4,3809,1175,3491,1584,4077,14136
2023-07-20,4,2174,2263,2215,3051,3715,13418
2023-07-21,4,2224,2396,2629,1525,4162,12936
2023-07-22,4,1920,922,2668,1986,5466,12962
2023-07-23,4,3965,1935,2972,2947,2703,14522
2023-07-24,4,2083,1552,1570,3341,4350,12896
2023-07-25,4,4908,2727,1422,3973,4304,17334
2023-07-26,4,1991,1531,2518,2740,5538,14318
2023-07-27,4,1130,1847,1943,3449,2825,11194
2023-07-28,4,1569,1483,1458,3389,5993,13892
2023-07-29,4,3617,2749,2371,1535,2231,12503
2023-07-30,4,2444,1862,3715,1688,5403,15112
2023-07-31,4,4942,1546,1553,2997,5549,16587
2023-08-01,4,4402,2735,1225,4033,2185,14580
2023-08-02,4,4320,2564,1361,4030,5999,18274
2023-08-03,4,1751,2718,1761,1829,4738,12797
2023-08-04,4,1358,1907,2059,1785,2219,9328
2023-08-05,4,2599,2845,3118,1929,4950,15441
2023-08-06,4,2138,1113,1656,2023,4547,11477
2023-08-07,4,1326,1722,3827,3698,4722,15295
2023-08-08,4,1614,1102,1332,3878,3474,11400
2023-08-09,4,2417,1933,1741,4130,3184,13405
2023-08-10,4,2378,2503,1401,3603,4342,14227
2023-08-11,4,4972,2808,1868,2919,2105,14672
2023-08-12,4,1628,2036,3143,3064,3391,13262
2023-08-13,4,3729,2953,2589,2570,2902,14743
2023-08-14,4,2033,1815,2118,3997,2084,12047
2023-08-15,4,4535,2488,2570,2089,3031,14713
2023-08-16,4,1980,2417,1416,4373,4813,14999
2023-08-17,4,2083,2076,1267,2853,2086,10365
2023-08-18,4,1645,1369,2307,2971,4791,13083
2023-08-19,4,1517,1349,3574,4386,4877,15703
2023-08-20,4,3398,1790,3154,2616,3905,14863
2023-08-21,4,1360,2096,3065,3080,3858,13459
2023-08-22,4,2463,1338,2252,2468,3526,12047
2023-08-23,4,3704,2285,1566,3895,3279,14729
2023-08-24,4,1613,1684,3461,4325,3021,14104
2023-08-25,4,4958,2828,2012,2412,5971,18181
2023-08-26,4,1488,1377,3893,3255,3768,13781
2023-08-27,4,3068,2056,2578,2086,2753,12541
2023-08-28,4,3607,2686,3147,2185,2118,13743
2023-08-29,4,2374,833,2689,2968,2019,10883
2023-08-30,4,3236,2620,3292,3663,4445,17256
2023-08-31,4,3165,1653,3205,4283,2633,14939
2023-09-01,4,3578,2310,3981,1520,5907,17296
2023-09-02,4,2472,2948,1511,2960,4065,13956
2023-09-03,4,1767,804,3225,3749,2941,12486
2023-09-04,4,3769,1386,3499,4385,3584,16623
2023-09-05,4,2836,1857,1304,3357,3161,12515
2023-09-06,4,3035,956,3664,4142,3348,15145
2023-09-07,4,2087,2046,1276,4063,4738,14210
2023-09-08,4,4201,2248,3470,4093,2387,16399
2023-09-09,4,3792,1051,3199,4231,5558,17831
2023-09-10,4,3727,2807,1896,1802,3003,13235
2023-09-11,4,1703,2689,2082,3244,5147,14865
2023-09-12,4,3447,2654,2605,2398,4935,16039
2023-09-13,4,2945,817,2652,2238,4826,13478
2023-09-14,4,4699,2539,3313,2084,4934,17569
2023-09-15,4,1761,2158,1613,2605,4651,12788
2023-09-16,4,2689,1748,3638,3342,2400,13817
2023-09-17,4,2490,1639,1545,3706,5260,14640
2023-09-18,4,2680,1292,3639,3865,4439,15915
2023-09-19,4,3153,1462,1951,3157,3818,13541
2023-09-20,4,1521,1651,3843,3377,5160,15552
2023-09-21,4,1328,1633,1436,3637,3029,11063
2023-09-22,4,1487,902,3358,4330,5229,15306
2023-09-23,4,4177,1411,2436,4197,3915,16136
2023-09-24,4,4270,2600,3036,1966,5183,17055
2023-09-25,4,3496,1604,3131,2325,5233,15789
2023-09-26,4,2041,1228,3683,2086,5778,14816
2023-09-27,4,4434,1215,3553,3536,5315,18053
2023-09-28,4,3907,2289,1434,4050,5888,17568
2023-09-29,4,1258,2993,1841,2032,3013,11137
2023-09-30,4,1902,1611,1726,3870,3362,12471
2023-10-01,4,1821,2125,3127,2746,3634,13453
2023-10-02,4,3045,2908,2593,2878,2570,13994
2023-10-03,4,1135,1762,2896,3592,5240,14625
2023-10-04,4,3407,2835,3774,3800,5517,19333
2023-10-05,4,3541,1836,1264,1586,4312,12539
2023-10-06,4,3567,1331,2041,4246,5136,16321
2023-10-07,4,2869,1102,2507,3372,5908,15758
2023-10-08,4,4175,2459,3852,2582,2175,15243
2023-10-09,4,4636,2943,3949,3037,5122,19687
2023-10-10,4,4501,1662,2242,3126,3572,15103
2023-10-11,4,1287,2274,1340,2575,3014,10490
2023-10-12,4,1364,2083,1335,1981,2676,9439
2023-10-13,4,1831,2560,2040,1953,2050,10434
2023-10-14,4,1156,2438,2245,3921,4106,13866
2023-10-15,4,4319,1791,1790,1793,5658,15351
2023-10-16,4,3373,1532,2606,2850,4598,14959
2023-10-17,4,2346,1571,3453,2089,5766,15225
2023-10-18,4,3346,1809,2725,3431,4431,15742
2023-10-19,4,1520,2553,3658,2492,3478,13701
2023-10-20,4,4740,1382,1510,3489,3342,14463
2023-10-21,4,1341,1059,2237,4271,3010,11918
2023-10-22,4,3288,1271,2890,2204,2135,11788
2023-10-23,4,1536,1439,2385,4162,5280,14802
2023-10-24,4,4943,1708,3996,2192,4063,16902
2023-10-25,4,1247,1293,3201,3895,2205,11841
2023-10-26,4,3138,1720,3109,1737,3700,13404
2023-10-27,4,2911,1398,3183,3661,5559,16712
2023-10-28,4,4310,1833,3943,3702,5614,19402
2023-10-29,4,3240,2041,2745,4430,5154,17610
2023-10-30,4,4178,1419,3597,2963,3391,15548
2023-10-31,4,4097,2217,2778,4042,5000,18134
2023-11-01,4,1218,990,3532,1877,3914,11531
2023-11-02,4,1294,2313,2330,4161,2638,12736
2023-11-03,4,3006,1179,1910,1606,4845,12546
2023-11-04,4,4180,2499,3562,1585,2623,14449
2023-11-05,4,3687,1535,1582,2089,4244,13137
2023-11-06,4,1906,1993,1814,1911,5093,12717
2023-11-07,4,3697,1695,2929,3328,5905,17554
2023-11-08,4,2215,1073,1270,3136,4732,12426
2023-11-09,4,2413,2806,1679,3174,3543,13615
2023-11-10,4,4600,2479,3906,2537,3125,16647
2023-11-11,4,4431,2376,2755,3441,3298,16301
2023-11-12,4,2155,2995,1304,3573,4320,14347
2023-11-13,4,3613,1107,1578,2910,3844,13052
2023-11-14,4,4202,1076,3695,2258,4912,16143
2023-11-15,4,3886,1738,3456,3279,4348,16707
2023-11-16,4,3469,1415,3803,1795,2023,12505
2023-11-17,4,2866,810,1480,3323,2552,11031
2023-11-18,4,4814,2310,3176,4457,4005,18762
2023-11-19,4,3235,2409,1210,4176,2070,13100
2023-11-20,4,1741,2883,3318,4210,5656,17808
2023-11-21,4,3537,831,2238,3923,3892,14421
2023-11-22,4,3784,2875,1972,2147,4126,14904
2023-11-23,4,2966,2338,2146,3258,5944,16652
2023-11-24,4,4780,1360,2111,1548,3873,13672
2023-11-25,4,2124,2916,3994,4382,4400,17816
2023-11-26,4,3649,1840,3485,3771,3634,16379
2023-11-27,4,2460,1659,2333,3002,2173,11627
2023-11-28,4,3409,1300,3134,2629,4809,15281
2023-11-29,4,3329,2201,2096,2125,3789,13540
2023-11-30,4,4238,805,3382,2278,5720,16423
2023-12-01,4,1968,2404,3927,3917,2743,14959
2023-12-02,4,3206,2896,2671,4380,2191,15344
2023-12-03,4,3755,1903,2921,2877,3841,15297
2023-12-04,4,1494,2066,2904,2819,5964,15247
2023-12-05,4,2236,1816,3576,3340,5163,16131
2023-12-06,4,4967,966,1907,4152,3696,15688
2023-12-07,4,4238,2485,1797,3572,3278,15370
2023-12-08,4,3383,2106,2016,3598,2728,13831
2023-12-09,4,4475,2873,3383,1900,3554,16185
2023-12-10,4,4130,1678,2408,2757,5537,16510
2023-12-11,4,3661,2486,3112,3854,4775,17888
2023-12-12,4,1395,870,1633,2680,2488,9066
2023-12-13,4,1156,2128,1937,4333,2238,11792
2023-12-14,4,2773,1177,1212,2690,3186,11038
2023-12-15,4,4282,2446,3599,3530,3820,17677
2023-12-16,4,1974,2154,1973,4147,2481,12729
2023-12-17,4,3357,1350,2313,3099,5229,15348
2023-12-18,4,3218,1996,3282,3776,4463,16735
2023-12-19,4,4964,1790,2267,3585,3501,16107
2023-12-20,4,1584,2727,1489,4342,4677,14819
2023-12-21,4,1179,2564,2230,1670,4655,12298
2023-12-22,4,2943,2505,2351,2104,3330,13233
2023-12-23,4,4684,2522,2116,4481,2321,16124
2023-12-24,4,3239,1692,1355,2174,3390,11850
2023-12-25,4,4607,2002,3304,3367,4435,17715
2023-12-26,4,4340,2207,1412,2556,4825,15340
2023-12-27,4,2345,2255,3945,2824,2043,13412
2023-12-28,4,3721,833,1742,3801,3933,14030
2023-12-29,4,4206,2596,3375,2024,4540,16741
2023-12-30,4,4180,2553,2369,2284,5844,17230
2023-12-31,4,4500,2012,1220,2693,3083,13508
2022-01-01,5,4446,1850,2913,2705,2138,14052
2022-01-02,5,2680,2173,2199,3053,5712,15817
2022-01-03,5,1201,2235,2621,4306,5362,15725
2022-01-04,5,2176,2392,3492,3708,3745,15513
2022-01-05,5,4690,1351,2160,2402,2027,12630
2022-01-06,5,4555,2154,2555,3649,5412,18325
2022-01-07,5,2815,2528,3170,3180,3498,15191
2022-01-08,5,4089,2211,3342,2827,2491,14960
2022-01-09,5,1922,2872,2633,4332,4865,16624
2022-01-10,5,1227,2569,1870,3787,2424,11877
2022-01-11,5,2689,2344,1813,4329,5278,16453
2022-01-12,5,3023,1439,3107,1657,2598,11824
2022-01-13,5,2089,2588,1481,3013,3591,12762
2022-01-14,5,2611,1608,2185,3803,2613,12820
2022-01-15,5,3407,1707,2054,4163,3972,15303
2022-01-16,5,2554,1527,3253,4394,4594,16322
2022-01-17,5,2041,1533,2976,1959,5630,14139
2022-01-18,5,2015,2593,2114,3071,2059,11852
2022-01-19,5,4301,2128,2069,2427,2696,13621
2022-01-20,5,4436,1620,3046,1876,5849,16827
2022-01-21,5,2339,2246,1486,3574,4056,13701
2022-01-22,5,3502,917,3339,2832,5264,15854
2022-01-23,5,4534,2958,3333,4487,4336,19648
2022-01-24,5,4174,1863,2780,1684,3610,14111
2022-01-25,5,1697,2682,2719,2881,2798,12777
2022-01-26,5,1103,2662,2843,2719,2488,11815
2022-01-27,5,4210,1655,3877,2540,2905,15187
2022-01-28,5,1606,1964,2203,2594,2318,10685
2022-01-29,5,1464,983,3250,2264,2637,10598
2022-01-30,5,3136,872,2013,3042,3035,12098
2022-01-31,5,4101,2566,3321,3175,4606,17769
2022-02-01,5,1589,2156,2646,3145,2997,12533
2022-02-02,5,3747,2366,2703,2767,5590,17173
2022-02-03,5,4710,1768,1335,2612,5294,15719
2022-02-04,5,3117,902,3180,1904,5979,15082
2022-02-05,5,2226,1526,1915,3311,3255,12233
2022-02-06,5,3220,1197,1362,2081,3386,11246
2022-02-07,5,1950,2265,1618,2734,5509,14076
2022-02-08,5,1003,2276,1714,3693,2209,10895
2022-02-09,5,4241,1518,2246,1996,2813,12814
2022-02-10,5,3463,2923,2654,2639,2348,14027
2022-02-11,5,4855,1657,3653,2875,5799,18839
2022-02-12,5,3724,904,1324,4384,4916,15252
2022-02-13,5,2019,1747,2256,4326,2440,12788
2022-02-14,5,3825,2691,1465,1925,5795,15701
2022-02-15,5,2075,2171,3585,3325,3100,14256
2022-02-16,5,3327,1882,3240,1963,4177,14589
2022-02-17,5,3453,2467,2465,2037,4793,15215
2022-02-18,5,2225,2612,2197,3248,3032,13314
2022-02-19,5,3460,2225,2814,2456,2814,13769
2022-02-20,5,1156,1090,2644,2673,3044,10607
2022-02-21,5,2544,2402,3538,1722,2078,12284
2022-02-22,5,1110,2816,2742,4426,5213,16307
2022-02-23,5,4937,2902,2657,2875,3688,17059
2022-02-24,5,4282,2408,2766,2131,2273,13860
2022-02-25,5,1928,1440,3472,2020,4414,13274
2022-02-26,5,1958,2762,2000,1745,4438,12903
2022-02-27,5,2649,1101,3256,2776,4028,13810
2022-02-28,5,4258,1427,1266,2814,3697,13462
2022-03-01,5,1150,2175,3079,4408,4729,15541
2022-03-02,5,1872,1511,1574,2504,2791,10252
2022-03-03,5,3878,1656,2750,3930,5590,17804
2022-03-04,5,3803,984,2051,4302,2576,13716
2022-03-05,5,3051,1985,3774,4115,4132,17057
2022-03-06,5,1054,2336,3946,4451,2422,14209
2022-03-07,5,2845,1674,2818,3738,4101,15176
2022-03-08,5,2057,1166,1856,2307,5903,13289
2022-03-09,5,4801,2086,3033,3083,5044,18047
2022-03-10,5,3479,1831,2947,3454,3143,14854
2022-03-11,5,2830,2413,3870,2360,5014,16487
2022-03-12,5,2773,2006,3033,3543,2982,14337
2022-03-13,5,1592,2575,3826,1767,2581,12341
2022-03-14,5,2494,1851,2322,3447,5800,15914
2022-03-15,5,4622,1205,3785,2175,5435,17222
2022-03-16,5,3916,2369,3749,3665,3796,17495
2022-03-17,5,3020,1594,1429,3921,4361,14325
2022-03-18,5,4146,2122,3476,2748,3894,16386
2022-03-19,5,1157,2924,2171,1865,4797,12914
2022-03-20,5,4687,1851,2602,2542,5770,17452
2022-03-21,5,1043,1352,2359,3304,4230,12288
2022-03-22,5,2012,947,2080,4100,5694,14833
2022-03-23,5,3705,1334,3231,1902,5447,15619
2022-03-24,5,1755,1277,2776,2307,3656,11771
2022-03-25,5,3082,2263,2183,2195,4166,13889
2022-03-26,5,3874,2442,2590,2583,2640,14129
2022-03-27,5,2134,2385,1450,1538,4452,11959
2022-03-28,5,2032,1185,2568,1953,3431,11169
2022-03-29,5,4433,2129,2945,3944,5349,18800
2022-03-30,5,4577,900,1994,3719,4092,15282
2022-03-31,5,3057,2686,1318,3778,3321,14160
2022-04-01,5,3286,2211,2402,4313,3402,15614
2022-04-02,5,4854,967,3654,2343,3388,15206
2022-04-03,5,1202,2912,2581,2036,2354,11085
2022-04-04,5,4944,1423,1391,2555,2524,12837
2022-04-05,5,1525,805,2871,2400,4293,11894
2022-04-06,5,1780,1737,3501,3855,4181,15054
2022-04-07,5,2891,2029,2445,3154,2038,12557
2022-04-08,5,4641,1003,2272,2957,3723,14596
2022-04-09,5,1888,1671,1988,2053,4833,12433
2022-04-10,5,1194,2913,2527,2766,5602,15002
2022-04-11,5,2870,1701,1915,4457,4368,15311
2022-04-12,5,4536,962,2020,1596,4896,14010
2022-04-13,5,1653,2362,3003,4262,3162,14442
2022-04-14,5,3370,2163,3890,2400,5551,17374
2022-04-15,5,3851,1368,3724,1628,2100,12671
2022-04-16,5,2228,2012,2090,4246,2920,13496
2022-04-17,5,1466,2925,1494,3624,2473,11982
2022-04-18,5,3463,1636,1878,4345,5957,17279
2022-04-19,5,1704,2441,3974,2627,4593,15339
2022-04-20,5,2349,2486,2827,4193,2943,14798
2022-04-21,5,3457,1770,3643,2513,2194,13577
2022-04-22,5,3865,1677,3673,1915,5357,16487
2022-04-23,5,1747,1711,3188,4164,3986,14796
2022-04-24,5,4321,1285,3976,4492,4509,18583
2022-04-25,5,4585,1959,1754,3607,2464,14369
2022-04-26,5,2561,2251,3348,3474,3397,15031
2022-04-27,5,3514,1936,1576,2824,3726,13576
2022-04-28,5,4982,1603,3274,2760,3492,16111
2022-04-29,5,4007,1466,3867,4082,2317,15739
2022-04-30,5,1168,1312,3891,2979,3880,13230
2022-05-01,5,2004,2574,1446,2288,2868,11180
2022-05-02,5,4148,1770,3391,2204,3602,15115
2022-05-03,5,1166,2456,2301,3430,3780,13133
2022-05-04,5,3308,1832,2036,2555,2880,12611
2022-05-05,5,4484,1132,3958,3048,4621,17243
2022-05-06,5,4535,2326,3408,4200,4232,18701
2022-05-07,5,3625,865,2786,3080,3841,14197
2022-05-08,5,2206,2142,3332,3946,4645,16271
2022-05-09,5,4870,1001,1536,2540,4852,14799
2022-05-10,5,3958,2029,1655,4308,3190,15140
2022-05-11,5,3840,2612,2252,3116,2915,14735
2022-05-12,5,3345,1408,2079,1793,2406,11031
2022-05-13,5,2171,1543,3036,1826,4997,13573
2022-05-14,5,1008,2167,3565,2359,3795,12894
2022-05-15,5,1331,2677,2261,2036,4985,13290
2022-05-16,5,1757,2831,2010,1889,4954,13441
2022-05-17,5,3132,1964,3432,2218,2235,12981
2022-05-18,5,4675,1101,1543,4203,3685,15207
2022-05-19,5,4360,1423,1842,3897,4476,15998
2022-05-20,5,1042,2160,1392,3599,4262,12455
2022-05-21,5,3348,2665,3580,4218,3970,17781
2022-05-22,5,3097,908,3040,3233,4667,14945
2022-05-23,5,3442,1003,1424,4147,2345,12361
2022-05-24,5,3706,2585,3754,2302,2129,14476
2022-05-25,5,2057,2022,3925,1536,3344,12884
2022-05-26,5,3550,1359,2595,3534,3048,14086
2022-05-27,5,2374,2874,2724,3441,4461,15874
2022-05-28,5,2982,2190,2733,4467,5173,17545
2022-05-29,5,2344,2647,3713,3407,2341,14452
2022-05-30,5,3846,1702,3357,4385,3834,17124
2022-05-31,5,4923,1699,2937,3959,5327,18845
2022-06-01,5,1879,964,1628,4046,5851,14368
2022-06-02,5,3255,2662,1285,2186,5992,15380
2022-06-03,5,3318,1240,1290,3341,4459,13648
2022-06-04,5,1719,2033,3232,3061,2906,12951
2022-06-05,5,2196,1617,2167,2713,4901,13594
2022-06-06,5,2650,1636,2994,3735,3889,14904
2022-06-07,5,1929,1789,3050,2146,3828,12742
2022-06-08,5,2620,2986,3651,2358,4919,16534
2022-06-09,5,2248,1684,3448,4141,2718,14239
2022-06-10,5,1075,1772,1748,2833,4311,11739
2022-06-11,5,2001,1934,1838,3691,2975,12439
2022-06-12,5,3174,1132,3950,2921,5361,16538
2022-06-13,5,4394,1795,3003,1851,2899,13942
2022-06-14,5,1754,2984,2171,1799,2478,11186
2022-06-15,5,1816,2565,3086,3807,2176,13450
2022-06-16,5,4055,1270,2129,2832,5189,15475
2022-06-17,5,1377,1082,3318,1988,4002,11767
2022-06-18,5,4915,1427,2208,2195,4992,15737
2022-06-19,5,2574,1904,3511,2433,4328,14750
2022-06-20,5,3219,2735,3628,1723,4496,15801
2022-06-21,5,2463,1095,3330,2838,2538,12264
2022-06-22,5,2081,1842,1624,1907,5918,13372
2022-06-23,5,2297,2890,3194,2939,4247,15567
2022-06-24,5,3718,2355,2884,3139,3627,15723
2022-06-25,5,3865,2573,1679,3774,4412,16303
2022-06-26,5,3617,1634,1497,3000,4729,14477
2022-06-27,5,1438,1460,3850,3965,2231,12944
2022-06-28,5,4209,827,2711,3907,3250,14904
2022-06-29,5,1387,825,2389,4095,4873,13569
2022-06-30,5,1133,2247,3285,2229,3095,11989
2022-07-01,5,2009,1520,3648,2851,3524,13552
2022-07-02,5,1278,2174,2123,2187,5119,12881
2022-07-03,5,1173,1163,2383,3917,4744,13380
2022-07-04,5,3760,1165,3488,1563,5747,15723
2022-07-05,5,2693,2223,2173,2473,2675,12237
2022-07-06,5,3927,2523,2162,1906,5051,15569
2022-07-07,5,4790,2301,1433,3028,4192,15744
2022-07-08,5,1457,831,2936,3375,3542,12141
2022-07-09,5,4002,2969,2788,2874,5380,18013
2022-07-10,5,3201,2613,1921,2322,3473,13530
2022-07-11,5,2088,1714,3581,4002,5041,16426
2022-07-12,5,3964,1607,2665,4075,3331,15642
2022-07-13,5,1504,822,1627,4428,4762,13143
2022-07-14,5,3764,1989,1902,2343,2193,12191
2022-07-15,5,1539,1489,3782,4494,2856,14160
2022-07-16,5,3141,2673,3897,1847,2557,14115
2022-07-17,5,1567,2995,2418,4402,5807,17189
2022-07-18,5,1491,1572,2098,1522,5993,12676
2022-07-19,5,1071,2839,1296,3774,5487,14467
2022-07-20,5,4276,2492,2061,4426,4161,17416
2022-07-21,5,4082,960,3273,2386,3460,14161
2022-07-22,5,1060,2090,1589,3449,4667,12855
2022-07-23,5,2300,1730,3461,2671,5293,15455
2022-07-24,5,1416,2080,2500,1617,2296,9909
2022-07-25,5,1577,2733,3434,2578,5924,16246
2022-07-26,5,3441,1038,2839,2227,2891,12436
2022-07-27,5,1203,949,1832,3065,2552,9601
2022-07-28,5,2361,968,2900,2146,5967,14342
2022-07-29,5,1386,2144,1438,3861,3156,11985
2022-07-30,5,4513,1356,2071,3295,2106,13341
2022-07-31,5,2556,1152,2417,2021,4535,12681
2022-08-01,5,2872,2574,3513,4294,5918,19171
2022-08-02,5,1298,1594,3770,3452,2591,12705
2022-08-03,5,1280,2594,2049,1716,2245,9884
2022-08-04,5,3696,2894,1982,3254,2098,13924
2022-08-05,5,4135,2461,3938,1785,2417,14736
2022-08-06,5,3924,2755,2192,3998,5752,18621
2022-08-07,5,1634,1906,3990,3300,2729,13559
2022-08-08,5,2657,2068,2400,2317,5654,15096
2022-08-09,5,1089,2098,2396,4194,3503,13280
2022-08-10,5,1206,1735,2731,3366,2209,11247
2022-08-11,5,2201,2709,3035,2924,4189,15058
2022-08-12,5,3460,2516,3138,3363,2169,14646
2022-08-13,5,4026,2730,1351,4141,2363,14611
2022-08-14,5,4555,2771,2932,2895,5301,18454
2022-08-15,5,2070,2626,1392,2925,2237,11250
2022-08-16,5,2754,1185,3369,2887,2366,12561
2022-08-17,5,4373,1534,3990,3996,4350,18243
2022-08-18,5,3053,2013,2577,2868,2502,13013
2022-08-19,5,4453,2672,1588,2647,2348,13708
2022-08-20,5,1052,1866,2650,3760,4722,14050
2022-08-21,5,4196,2187,1252,1830,2512,11977
2022-08-22,5,1198,2826,3777,4462,4990,17253
2022-08-23,5,3983,1049,2006,3375,5643,16056
2022-08-24,5,1601,2289,1910,3081,2586,11467
2022-08-25,5,1776,1252,2123,4235,5548,14934
2022-08-26,5,1794,2374,2504,4407,4275,15354
2022-08-27,5,2877,2930,1330,1957,3161,12255
2022-08-28,5,3308,1238,1226,4498,5549,15819
2022-08-29,5,2684,1437,3262,2416,5313,15112
2022-08-30,5,2593,2057,2223,4409,5834,17116
2022-08-31,5,1967,1269,3167,3909,3453,13765
2022-09-01,5,4402,2529,3105,3314,2232,15582
2022-09-02,5,2045,1611,2697,1546,5841,13740
2022-09-03,5,4541,2747,3045,4351,5179,19863
2022-09-04,5,1673,1021,1334,2019,5495,11542
2022-09-05,5,1707,2018,2968,2393,4065,13151
2022-09-06,5,3471,2423,2792,1644,4772,15102
2022-09-07,5,4235,1183,1369,4406,2525,13718
2022-09-08,5,1954,1417,2492,3985,4681,14529
2022-09-09,5,3294,1511,1694,4067,3080,13646
2022-09-10,5,2841,1056,1603,3005,5381,13886
2022-09-11,5,3636,1281,2624,2641,3551,13733
2022-09-12,5,4731,2727,3914,3422,3351,18145
2022-09-13,5,4174,2086,1397,2745,3167,13569
2022-09-14,5,1309,1994,1404,1607,5889,12203
2022-09-15,5,3454,1164,2920,4186,5779,17503
2022-09-16,5,3981,2566,2262,2381,3304,14494
2022-09-17,5,4211,1482,2505,4461,3712,16371
2022-09-18,5,4617,908,3078,2098,2990,13691
2022-09-19,5,1070,2319,3773,3783,4942,15887
2022-09-20,5,4339,1941,3933,2831,4131,17175
2022-09-21,5,3744,1664,3990,2277,4789,16464
2022-09-22,5,2349,2589,1807,2464,5201,14410
2022-09-23,5,1638,2615,1960,3191,2423,11827
2022-09-24,5,4698,1554,2220,4252,2825,15549
2022-09-25,5,3961,1840,1781,2830,2927,13339
2022-09-26,5,1777,2575,3310,2305,3092,13059
2022-09-27,5,4140,2976,2258,2766,4360,16500
2022-09-28,5,4407,2859,2329,2901,3457,15953
2022-09-29,5,3017,2532,3670,1712,3740,14671
2022-09-30,5,1321,843,3746,1550,3776,11236
2022-10-01,5,4306,2621,3300,1698,2662,14587
2022-10-02,5,4507,861,1463,2634,4390,13855
2022-10-03,5,4217,2755,1369,3370,3114,14825
2022-10-04,5,2713,1148,3387,1865,3310,12423
2022-10-05,5,1654,1971,3200,3705,5174,15704
2022-10-06,5,1094,1820,1816,4072,5757,14559
2022-10-07,5,3318,1408,3151,4270,5749,17896
2022-10-08,5,1267,2368,2823,3539,2495,12492
2022-10-09,5,1295,2907,3431,4239,2484,14356
2022-10-10,5,1148,2346,2741,4174,5472,15881
2022-10-11,5,3472,1329,2627,2064,2564,12056
2022-10-12,5,3736,2356,3264,3842,4193,17391
2022-10-13,5,1124,2513,1939,4001,4676,14253
2022-10-14,5,2106,1161,2896,2223,4508,12894
2022-10-15,5,4019,2240,1527,2050,5577,15413
2022-10-16,5,2853,2089,2418,4092,4453,15905
2022-10-17,5,4891,2283,1594,3372,4028,16168
2022-10-18,5,4393,945,1773,2965,2808,12884
2022-10-19,5,3703,1773,2970,3230,4030,15706
2022-10-20,5,2126,854,1645,3820,2399,10844
2022-10-21,5,3246,2868,3514,3717,2140,15485
2022-10-22,5,2099,2631,2122,3861,4330,15043
2022-10-23,5,2920,1482,2206,1697,4684,12989
2022-10-24,5,1823,2917,1382,3528,4544,14194
2022-10-25,5,1665,2768,3620,3742,3840,15635
2022-10-26,5,1392,1771,1982,3958,5548,14651
2022-10-27,5,3695,1918,1805,2337,5969,15724
2022-10-28,5,4345,2037,2287,4435,3101,16205
2022-10-29,5,3561,1462,2810,1535,2967,12335
2022-10-30,5,1499,2125,3305,1969,3670,12568
2022-10-31,5,1726,2192,1738,1974,3117,10747
2022-11-01,5,2293,1551,2742,2344,4626,13556
2022-11-02,5,1442,1367,2353,2027,5925,13114
2022-11-03,5,3134,884,2811,3237,4090,14156
2022-11-04,5,2907,1424,2534,3192,5460,15517
2022-11-05,5,4584,1045,2887,4497,5328,18341
2022-11-06,5,4610,2806,1295,3621,2435,14767
2022-11-07,5,2147,1172,2798,3983,5280,15380
2022-11-08,5,3064,2369,1983,3886,4238,15540
2022-11-09,5,3877,1023,3287,2302,2680,13169
2022-11-10,5,2484,2775,1345,2391,4233,13228
2022-11-11,5,4368,2772,1389,1718,4509,14756
2022-11-12,5,4779,2473,1864,3576,5118,17810
2022-11-13,5,2929,1671,2004,2729,3257,12590
2022-11-14,5,4557,1230,3697,3358,4366,17208
2022-11-15,5,3935,1173,2352,3515,4353,15328
2022-11-16,5,1239,1732,3988,2474,3649,13082
2022-11-17,5,3607,1967,3009,2052,5116,15751
2022-11-18,5,4070,2361,2151,2954,4403,15939
2022-11-19,5,1716,2086,1548,2470,5595,13415
2022-11-20,5,3216,2923,1472,2778,3734,14123
2022-11-21,5,1928,924,2248,3815,3048,11963
2022-11-22,5,1852,2372,3718,2986,4517,15445
2022-11-23,5,2977,2470,2189,3817,5234,16687
2022-11-24,5,3208,1623,2682,2430,3714,13657
2022-11-25,5,2634,2934,3712,4410,2845,16535
2022-11-26,5,2928,1338,2182,3114,2189,11751
2022-11-27,5,4892,1223,3135,1913,4272,15435
2022-11-28,5,4308,2680,1331,2876,2907,14102
2022-11-29,5,2336,2113,1476,4108,4461,14494
2022-11-30,5,4259,907,1768,3075,2522,12531
2022-12-01,5,4717,2743,1553,1768,4842,15623
2022-12-02,5,1297,2885,3200,3368,3818,14568
2022-12-03,5,3052,935,1894,2687,5672,14240
2022-12-04,5,1368,876,1811,3236,2971,10262
2022-12-05,5,1553,1646,1509,3540,2394,10642
2022-12-06,5,3987,1894,2819,2948,2253,13901
2022-12-07,5,3584,1825,1951,3515,3882,14757
2022-12-08,5,1769,2858,1913,2223,2070,10833
2022-12-09,5,2709,1407,3785,2881,2407,13189
2022-12-10,5,1128,2531,2320,1755,3673,11407
2022-12-11,5,3926,2445,3439,3399,2762,15971
2022-12-12,5,3031,1052,3395,1567,3352,12397
2022-12-13,5,1239,2531,1243,3728,3963,12704
2022-12-14,5,4387,871,1591,4124,5159,16132
2022-12-15,5,1929,1892,3066,1866,3795,12548
2022-12-16,5,4676,2402,3717,2773,4620,18188
2022-12-17,5,2307,1150,1226,3346,3747,11776
2022-12-18,5,4687,1308,1411,2748,3946,14100
2022-12-19,5,1982,1865,2607,4129,3151,13734
2022-12-20,5,2596,954,3046,2167,4547,13310
2022-12-21,5,1188,1892,1606,3342,5290,13318
2022-12-22,5,1657,1695,2084,2396,3857,11689
2022-12-23,5,2312,1613,2105,4239,5471,15740
2022-12-24,5,4507,2042,2356,2026,2731,13662
2022-12-25,5,4872,1309,1942,1723,5387,15233
2022-12-26,5,3364,2053,2904,2582,3272,14175
2022-12-27,5,2964,2897,3173,2618,2035,13687
2022-12-28,5,4984,972,3025,3189,3603,15773
2022-12-29,5,2999,2292,3674,3337,5035,17337
2022-12-30,5,3005,2987,3650,2749,2987,15378
2022-12-31,5,2584,1289,3133,4375,4527,15908
2023-01-01,5,2533,2104,3917,3321,2774,14649
2023-01-02,5,4958,2607,1386,2018,5417,16386
2023-01-03,5,2738,806,1695,2230,4615,12084
2023-01-04,5,4670,2891,2504,3499,3948,17512
2023-01-05,5,2561,1822,1566,4045,4768,14762
2023-01-06,5,4670,1529,2234,1689,4036,14158
2023-01-07,5,3289,1239,2565,2024,4572,13689
2023-01-08,5,4342,1941,2111,3933,3519,15846
2023-01-09,5,4137,2925,3065,1535,3674,15336
2023-01-10,5,4853,1467,2753,4319,5898,19290
2023-01-11,5,2517,2893,3119,4049,3333,15911
2023-01-12,5,1238,2165,2250,1849,2626,10128
2023-01-13,5,3274,2949,3890,2626,5531,18270
2023-01-14,5,2531,2301,1741,2771,5227,14571
2023-01-15,5,2760,1941,1729,4209,3419,14058
2023-01-16,5,2317,2093,1868,4299,3066,13643
2023-01-17,5,2339,925,3814,3862,4580,15520
2023-01-18,5,4565,2237,2283,1968,3087,14140
2023-01-19,5,4021,1398,3807,3625,4894,17745
2023-01-20,5,2668,1823,2695,2054,3327,12567
2023-01-21,5,2951,1650,1286,2322,4186,12395
2023-01-22,5,3852,2928,1638,3139,4826,16383
2023-01-23,5,2696,2747,3675,3549,4678,17345
2023-01-24,5,3407,1423,1312,3978,2646,12766
2023-01-25,5,4274,2694,3748,2083,3817,16616
2023-01-26,5,1005,882,3887,2125,4247,12146
2023-01-27,5,3215,2398,1866,4137,5146,16762
2023-01-28,5,1845,1030,3079,3399,3321,12674
2023-01-29,5,2253,1001,3848,2433,3909,13444
2023-01-30,5,4868,883,2124,2835,3632,14342
2023-01-31,5,4056,2155,3451,4172,3817,17651
2023-02-01,5,3938,951,2628,1753,5295,14565
2023-02-02,5,3595,1843,2368,4094,3291,15191
2023-02-03,5,1420,2325,2812,3147,5817,15521
2023-02-04,5,2696,1164,2448,2338,2116,10762
2023-02-05,5,1963,1048,3742,2072,5111,13936
2023-02-06,5,2047,2715,2594,2708,3350,13414
2023-02-07,5,2218,1580,1826,3695,5689,15008
2023-02-08,5,4362,1895,3672,3759,2847,16535
2023-02-09,5,2130,2165,2898,2714,5956,15863
2023-02-10,5,4833,914,3063,1514,5659,15983
2023-02-11,5,2847,2218,3588,2356,4716,15725
2023-02-12,5,3350,2884,3735,2175,3529,15673
2023-02-13,5,1741,966,1216,3281,2877,10081
2023-02-14,5,1066,1784,2121,2877,4483,12331
2023-02-15,5,2314,2802,3608,3220,4626,16570
2023-02-16,5,3191,2241,2400,3698,2368,13898
2023-02-17,5,2065,1609,1313,2610,5522,13119
2023-02-18,5,4104,1857,2197,2403,4127,14688
2023-02-19,5,4853,2722,3863,2743,2366,16547
2023-02-20,5,1462,1912,3977,3366,3348,14065
2023-02-21,5,3617,2783,3919,3652,4168,18139
2023-02-22,5,4013,2793,1319,3776,5252,17153
2023-02-23,5,3754,2038,2193,3459,2720,14164
2023-02-24,5,3351,1278,3271,1560,2896,12356
2023-02-25,5,3898,1417,3988,4319,2746,16368
2023-02-26,5,1137,1871,3433,3319,4704,14464
2023-02-27,5,1131,2747,3137,1833,3711,12559
2023-02-28,5,2851,1691,1830,3145,3549,13066
2023-03-01,5,4671,2801,3100,3907,3748,18227
2023-03-02,5,3426,956,1602,3686,2710,12380
2023-03-03,5,3443,2935,2101,4266,2204,14949
2023-03-04,5,1692,1373,3352,1897,3858,12172
2023-03-05,5,2940,1209,3514,2625,2292,12580
2023-03-06,5,2323,1786,2786,2843,4783,14521
2023-03-07,5,4071,1908,3662,4153,2479,16273
2023-03-08,5,1329,826,2808,3401,3326,11690
2023-03-09,5,4831,1347,2289,2659,5278,16404
2023-03-10,5,4892,2474,2074,2971,4472,16883
2023-03-11,5,4121,2642,1643,2180,3690,14276
2023-03-12,5,4811,1014,1734,3281,2035,12875
2023-03-13,5,1504,1722,2810,3235,2043,11314
2023-03-14,5,1341,1655,2048,3420,2633,11097
2023-03-15,5,3696,2948,1565,4351,3397,15957
2023-03-16,5,2512,1526,3913,4394,3500,15845
2023-03-17,5,4601,2787,3325,2831,5447,18991
2023-03-18,5,1251,2303,3752,2036,4703,14045
2023-03-19,5,3343,1510,2844,4465,4248,16410
2023-03-20,5,1522,2232,3908,1752,4184,13598
2023-03-21,5,1303,2194,1609,3255,4085,12446
2023-03-22,5,2110,1128,2502,2469,2602,10811
2023-03-23,5,3775,1416,2128,3775,2503,13597
2023-03-24,5,4942,2297,3891,2981,5104,19215
2023-03-25,5,4131,2574,1651,1579,3237,13172
2023-03-26,5,1778,1902,2814,2270,4216,12980
2023-03-27,5,1635,2494,1884,3747,5855,15615
2023-03-28,5,1929,1322,3722,3077,4511,14561
2023-03-29,5,2398,2006,1389,2963,4131,12887
2023-03-30,5,3536,2465,2281,3920,3106,15308
2023-03-31,5,2331,2789,1529,1734,5367,13750
2023-04-01,5,1231,1631,2646,2152,3517,11177
2023-04-02,5,4610,1736,2686,3381,5297,17710
2023-04-03,5,1885,1689,1413,1822,2246,9055
2023-04-04,5,1094,1875,3659,3325,3448,13401
2023-04-05,5,2199,2781,3923,2979,4238,16120
2023-04-06,5,1003,2298,3628,4433,3795,15157
2023-04-07,5,2645,1654,2229,2278,3941,12747
2023-04-08,5,3823,2010,3643,2321,2709,14506
2023-04-09,5,3191,2467,2465,3350,3334,14807
2023-04-10,5,2760,1078,1314,2774,4262,12188
2023-04-11,5,3231,943,2331,3305,5742,15552
2023-04-12,5,1684,859,3708,4263,2331,12845
2023-04-13,5,4051,1425,1912,2716,4057,14161
2023-04-14,5,2135,1298,1579,4382,4969,14363
2023-04-15,5,2606,2062,1536,3441,4291,13936
2023-04-16,5,3335,1202,3977,3776,5534,17824
2023-04-17,5,2452,2129,1403,4096,2945,13025
2023-04-18,5,2352,1142,3125,2684,4023,13326
2023-04-19,5,4024,1932,2245,3958,4770,16929
2023-04-20,5,1750,2109,1966,3865,3477,13167
2023-04-21,5,3887,1323,1779,3628,2065,12682
2023-04-22,5,2511,2161,3943,3065,4199,15879
2023-04-23,5,2580,2858,1752,2939,2699,12828
2023-04-24,5,1518,1676,3766,1641,3681,12282
2023-04-25,5,4537,2029,2755,1523,3735,14579
2023-04-26,5,3575,1340,3168,3766,3558,15407
2023-04-27,5,2286,1177,2092,4108,3155,12818
2023-04-28,5,3290,1900,2998,3657,4469,16314
2023-04-29,5,4678,2908,1658,3342,2330,14916
2023-04-30,5,1989,2157,1450,2861,3250,11707
2023-05-01,5,2819,2304,2825,4225,5365,17538
2023-05-02,5,4687,2470,3454,2025,5966,18602
2023-05-03,5,1918,1458,2070,2311,3415,11172
2023-05-04,5,4784,1721,3425,2682,3560,16172
2023-05-05,5,2873,825,1732,3131,2133,10694
2023-05-06,5,1155,1766,2130,3732,3011,11794
2023-05-07,5,3928,1819,3615,4131,4927,18420
2023-05-08,5,1789,2758,3450,2197,2182,12376
2023-05-09,5,1179,1804,1639,2177,5416,12215
2023-05-10,5,1452,1941,1950,4077,2799,12219
2023-05-11,5,3373,972,3965,2024,2772,13106
2023-05-12,5,4624,2303,2502,4387,4389,18205
2023-05-13,5,4596,2522,3136,3969,2269,16492
2023-05-14,5,1004,2841,2258,3857,5693,15653
2023-05-15,5,4595,2988,3325,3360,3120,17388
2023-05-16,5,4302,2942,3150,1668,5114,17176
2023-05-17,5,3739,2122,2276,4324,4586,17047
2023-05-18,5,4054,923,3104,3367,3641,15089
2023-05-19,5,1302,2692,2412,3168,4275,13849
2023-05-20,5,2369,1941,3956,4452,5300,18018
2023-05-21,5,3913,1029,2186,3455,2872,13455
2023-05-22,5,3079,1517,3536,1848,4643,14623
2023-05-23,5,4689,2610,1715,3908,3115,16037
2023-05-24,5,1284,1762,2113,2753,4981,12893
2023-05-25,5,2435,2235,1996,1504,2056,10226
2023-05-26,5,2241,2918,2948,4130,3390,15627
2023-05-27,5,4692,2913,2211,2403,4411,16630
2023-05-28,5,1204,2527,1776,4499,5552,15558
2023-05-29,5,1330,2642,1418,2189,2849,10428
2023-05-30,5,3463,2240,3260,1533,5535,16031
2023-05-31,5,2455,1078,1742,3988,2304,11567
2023-06-01,5,4841,1307,3090,1800,2397,13435
2023-06-02,5,3114,860,2889,4288,2173,13324
2023-06-03,5,1501,805,1841,3080,3237,10464
2023-06-04,5,3151,2127,3303,2179,3417,14177
2023-06-05,5,2278,2858,3478,3701,5882,18197
2023-06-06,5,4367,2340,1749,2768,4510,15734
2023-06-07,5,3465,983,2547,3379,2330,12704
2023-06-08,5,3740,1315,2263,4471,2102,13891
2023-06-09,5,1496,977,2207,2526,2736,9942
2023-06-10,5,3819,2627,2725,4277,2631,16079
2023-06-11,5,1830,2307,1566,4439,4817,14959
2023-06-12,5,2648,2016,3811,2190,3981,14646
2023-06-13,5,4268,851,1620,1571,3941,12251
2023-06-14,5,4877,1658,3196,3566,4506,17803
2023-06-15,5,1815,2477,3263,1800,4735,14090
2023-06-16,5,3244,1195,2066,2622,3846,12973
2023-06-17,5,3349,1424,3784,2570,2947,14074
2023-06-18,5,1721,2069,3809,4017,5706,17322
2023-06-19,5,4006,2690,1516,1530,5820,15562
2023-06-20,5,1557,1240,3533,4104,3087,13521
2023-06-21,5,4160,1953,1741,2272,3499,13625
2023-06-22,5,1572,835,3975,2306,5143,13831
2023-06-23,5,3600,2044,1858,2967,3429,13898
2023-06-24,5,1609,2177,1266,2221,2592,9865
2023-06-25,5,2068,2475,2939,3353,2508,13343
2023-06-26,5,2539,2161,1843,4072,3512,14127
2023-06-27,5,4300,1938,1848,3851,5486,17423
2023-06-28,5,3468,1196,2467,3112,5808,16051
2023-06-29,5,1844,950,1438,2885,4669,11786
2023-06-30,5,4796,2435,2259,4315,4181,17986
2023-07-01,5,4745,1283,2084,4286,5768,18166
2023-07-02,5,3636,2986,3577,1976,5061,17236
2023-07-03,5,3679,1562,2493,2769,4257,14760
2023-07-04,5,4761,2637,1985,1651,5463,16497
2023-07-05,5,4465,2962,2343,1563,3311,14644
2023-07-06,5,3451,1808,1906,3876,3702,14743
2023-07-07,5,2329,2780,1757,4405,3413,14684
2023-07-08,5,3384,2158,1342,2257,4396,13537
2023-07-09,5,4862,2985,1881,3361,4621,17710
2023-07-10,5,3900,982,2652,1732,5778,15044
2023-07-11,5,1448,2765,1341,4192,5054,14800
2023-07-12,5,2381,1399,3515,3279,5566,16140
2023-07-13,5,1851,1105,2589,1745,3377,10667
2023-07-14,5,3611,1402,2715,3370,2212,13310
2023-07-15,5,4824,1091,2448,2577,5861,16801
2023-07-16,5,3805,1094,2157,1799,2115,10970
2023-07-17,5,3166,1333,2473,2590,5675,15237
2023-07-18,5,4696,965,3886,2624,3562,15733
2023-07-19,5,3590,2462,3050,1748,2443,13293
2023-07-20,5,2899,2283,3015,4035,4751,16983
2023-07-21,5,2055,1167,1357,3062,4297,11938
2023-07-22,5,4614,2782,1497,2664,2515,14072
2023-07-23,5,3425,2212,1373,3830,4285,15125
2023-07-24,5,2752,2442,1610,2545,2900,12249
2023-07-25,5,3892,1875,3651,3953,2974,16345
2023-07-26,5,1456,1431,1723,1864,5915,12389
2023-07-27,5,1337,2245,1298,4049,5561,14490
2023-07-28,5,1835,2391,3343,2056,3880,13505
2023-07-29,5,1902,1241,2501,2111,3777,11532
2023-07-30,5,4135,2852,3796,1649,4506,16938
2023-07-31,5,2402,2902,2534,2571,5301,15710
2023-08-01,5,4660,2706,3748,1653,2520,15287
2023-08-02,5,3510,2435,2550,2081,2438,13014
2023-08-03,5,4278,2737,2588,3642,5295,18540
2023-08-04,5,3286,1679,3891,4396,4864,18116
2023-08-05,5,1829,2634,2935,4312,3345,15055
2023-08-06,5,3907,2485,3330,1845,5498,17065
2023-08-07,5,1223,1788,2192,3697,2968,11868
2023-08-08,5,3624,844,3556,2850,3900,14774
2023-08-09,5,3314,2122,3939,3867,2509,15751
2023-08-10,5,4907,2461,3816,2755,2934,16873
2023-08-11,5,2696,1755,2838,1717,2736,11742
2023-08-12,5,1115,2967,2394,2789,5995,15260
2023-08-13,5,3214,983,2799,1713,2602,11311
2023-08-14,5,2570,1579,3242,1996,3256,12643
2023-08-15,5,4223,2362,2799,1616,5558,16558
2023-08-16,5,3107,2156,2981,2777,3559,14580
2023-08-17,5,1504,1908,2237,3257,2612,11518
2023-08-18,5,3374,2717,3762,4482,5480,19815
2023-08-19,5,2188,2212,3870,3626,3653,15549
2023-08-20,5,4702,986,2610,4194,4813,17305
2023-08-21,5,2324,1067,3712,1822,2816,11741
2023-08-22,5,1863,2573,1330,2235,3470,11471
2023-08-23,5,1500,2423,3966,2472,2312,12673
2023-08-24,5,4230,1609,2247,1789,4740,14615
2023-08-25,5,4087,2165,1371,3626,5305,16554
2023-08-26,5,2359,2092,1955,3912,3585,13903
2023-08-27,5,4580,2993,3082,3470,4879,19004
2023-08-28,5,4395,1989,2906,2814,4757,16861
2023-08-29,5,1116,2864,2286,4436,2622,13324
2023-08-30,5,1118,2593,3417,3398,3858,14384
2023-08-31,5,4580,1272,1843,3794,3363,14852
2023-09-01,5,1981,1765,3746,1801,4993,14286
2023-09-02,5,4542,1977,3662,3389,3741,17311
2023-09-03,5,2757,2183,2953,4442,4154,16489
2023-09-04,5,4276,2683,2728,1595,4547,15829
2023-09-05,5,3078,1805,3114,3301,2151,13449
2023-09-06,5,1038,1570,3003,1881,3537,11029
2023-09-07,5,1406,996,2641,2491,3005,10539
2023-09-08,5,4228,901,2122,1857,2607,11715
2023-09-09,5,4218,2943,3001,4088,2482,16732
2023-09-10,5,2008,1917,2150,2617,3423,12115
2023-09-11,5,1603,1550,2316,2792,4481,12742
2023-09-12,5,3542,1052,1493,2365,3705,12157
2023-09-13,5,1103,928,2566,3800,5822,14219
2023-09-14,5,3157,2089,3732,3623,3976,16577
2023-09-15,5,2835,1565,1492,3588,2231,11711
2023-09-16,5,3442,803,1817,1625,5374,13061
2023-09-17,5,1437,2770,3459,3290,5039,15995
2023-09-18,5,1164,1616,3517,1583,3379,11259
2023-09-19,5,4404,1656,1218,1520,4723,13521
2023-09-20,5,1352,810,2638,3300,2517,10617
2023-09-21,5,4124,2962,1228,4137,2858,15309
2023-09-22,5,1401,2278,3568,3200,3302,13749
2023-09-23,5,1196,1847,1979,3455,5688,14165
2023-09-24,5,4454,1574,3417,1839,3685,14969
2023-09-25,5,4491,2520,1395,2351,3706,14463
2023-09-26,5,3062,1514,1238,3150,3225,12189
2023-09-27,5,1017,2741,3231,4484,4443,15916
2023-09-28,5,1597,2296,1230,2906,2782,10811
2023-09-29,5,1742,2119,1387,3884,5891,15023
2023-09-30,5,2592,2342,3605,3976,4571,17086
2023-10-01,5,3796,1771,2589,3045,5755,16956
2023-10-02,5,2605,2676,3316,3991,3461,16049
2023-10-03,5,2967,2104,3112,2514,3964,14661
2023-10-04,5,3868,974,2633,1937,2659,12071
2023-10-05,5,4149,983,2361,4449,3926,15868
2023-10-06,5,3464,1078,3689,4044,4489,16764
2023-10-07,5,4089,2366,2656,3946,4643,17700
2023-10-08,5,4182,2654,3577,3702,4336,18451
2023-10-09,5,3726,2265,2760,3454,3657,15862
2023-10-10,5,1791,2319,2558,2027,4911,13606
2023-10-11,5,2349,1594,3135,4435,5410,16923
2023-10-12,5,3679,2720,3425,3144,3323,16291
2023-10-13,5,4051,2530,3980,3327,4045,17933
2023-10-14,5,1486,1415,3031,1644,5613,13189
2023-10-15,5,1955,1467,1737,3361,4206,12726
2023-10-16,5,3493,2767,2559,2378,5257,16454
2023-10-17,5,2390,2507,3561,4180,2647,15285
2023-10-18,5,4791,1176,2098,4472,5177,17714
2023-10-19,5,2216,2979,3145,3191,5726,17257
2023-10-20,5,1337,2976,3093,2128,3083,12617
2023-10-21,5,4514,1404,2310,2423,2439,13090
2023-10-22,5,1753,2500,3813,4250,4471,16787
2023-10-23,5,4471,2574,3552,2064,5732,18393
2023-10-24,5,1858,1836,1587,3056,5750,14087
2023-10-25,5,2111,1764,3058,3875,3861,14669
2023-10-26,5,4594,1549,2355,1817,2371,12686
2023-10-27,5,2773,2525,2504,3215,4110,15127
2023-10-28,5,1181,2235,1566,2593,3883,11458
2023-10-29,5,3145,2384,3714,2419,3616,15278
2023-10-30,5,2055,1245,2896,4432,2132,12760
2023-10-31,5,4770,2048,2555,1839,3347,14559
2023-11-01,5,4674,1239,2456,3476,2507,14352
2023-11-02,5,4074,2911,1280,2640,5770,16675
2023-11-03,5,2013,2659,1884,4274,3112,13942
2023-11-04,5,2543,1672,2179,3651,3796,13841
2023-11-05,5,2146,2523,2397,1789,3976,12831
2023-11-06,5,4898,2306,2201,4271,2547,16223
2023-11-07,5,4038,2681,2826,2796,3669,16010
2023-11-08,5,2725,2879,3727,3565,3165,16061
2023-11-09,5,3968,2788,3963,1673,4923,17315
2023-11-10,5,4881,2803,3401,3125,2840,17050
2023-11-11,5,3851,2670,3442,1695,5178,16836
2023-11-12,5,4879,1447,1787,1561,2979,12653
2023-11-13,5,3073,2527,3233,3934,5754,18521
2023-11-14,5,1685,1054,3082,1763,5074,12658
2023-11-15,5,2259,1190,2927,3760,2545,12681
2023-11-16,5,2948,1199,3187,1552,2399,11285
2023-11-17,5,1207,1102,2252,1675,3001,9237
2023-11-18,5,3525,2572,3128,1801,2282,13308
2023-11-19,5,3850,2561,1237,4092,5664,17404
2023-11-20,5,2387,1701,2219,4145,2180,12632
2023-11-21,5,3979,2295,3472,1891,3948,15585
2023-11-22,5,2172,2407,1261,4273,3059,13172
2023-11-23,5,2114,2969,1985,2568,3212,12848
2023-11-24,5,3207,2721,2372,2269,5275,15844
2023-11-25,5,3479,2741,3099,4288,2639,16246
2023-11-26,5,4318,2610,2838,1782,4141,15689
2023-11-27,5,2149,2148,3840,2640,4422,15199
2023-11-28,5,3262,1481,2963,4275,3200,15181
2023-11-29,5,1379,1682,3024,1517,5083,12685
2023-11-30,5,2057,2410,1792,1651,4993,12903
2023-12-01,5,3893,1759,2187,2995,5980,16814
2023-12-02,5,1786,2147,3197,1706,2024,10860
2023-12-03,5,3502,957,3498,3816,4282,16055
2023-12-04,5,4308,1131,3214,4117,4861,17631
2023-12-05,5,1138,1016,3530,3273,5208,14165
2023-12-06,5,2100,804,2755,3167,3630,12456
2023-12-07,5,2880,1210,2257,2786,2274,11407
2023-12-08,5,3178,2348,2770,1744,3348,13388
2023-12-09,5,1774,2456,2007,2211,5618,14066
2023-12-10,5,2206,870,2710,2032,2887,10705
2023-12-11,5,3904,2329,1557,1681,4271,13742
2023-12-12,5,3170,2035,2175,2490,4308,14178
2023-12-13,5,3454,2245,2072,1873,5118,14762
2023-12-14,5,3809,1134,3099,1840,2953,12835
2023-12-15,5,4082,1962,3018,1791,4548,15401
2023-12-16,5,1718,2133,3149,3238,4963,15201
2023-12-17,5,3922,1228,1270,2362,3171,11953
2023-12-18,5,3274,1531,3971,2478,4114,15368
2023-12-19,5,4589,2431,3714,3348,4493,18575
2023-12-20,5,4603,1521,2770,3748,2816,15458
2023-12-21,5,4556,2198,2796,3640,2062,15252
2023-12-22,5,3540,2037,2535,2098,2456,12666
2023-12-23,5,4446,1003,3827,3911,3600,16787
2023-12-24,5,1502,1185,3718,4115,5943,16463
2023-12-25,5,4017,1375,1926,1616,3010,11944
2023-12-26,5,1672,1222,1867,1738,3595,10094
2023-12-27,5,2055,1311,3336,3660,5483,15845
2023-12-28,5,3343,2205,3940,2212,4186,15886
2023-12-29,5,2219,1298,2394,3493,5320,14724
2023-12-30,5,3878,2086,2359,3847,5753,17923
2023-12-31,5,3776,892,1354,2792,2724,11538
2022-01-01,6,2874,2109,3598,3869,2126,14576
2022-01-02,6,1223,913,3783,1719,4648,12286
2022-01-03,6,3830,1068,1977,2428,2565,11868
2022-01-04,6,1052,2305,1229,2824,2861,10271
2022-01-05,6,3862,1118,1970,1749,4356,13055
2022-01-06,6,3108,1334,2254,2609,3921,13226
2022-01-07,6,4389,1960,1248,3776,3357,14730
2022-01-08,6,3727,959,2071,1819,3793,12369
2022-01-09,6,4815,1504,2548,3614,2082,14563
2022-01-10,6,3455,1766,1509,3491,2326,12547
2022-01-11,6,1422,1153,3363,2053,5921,13912
2022-01-12,6,1165,2653,2224,1878,3255,11175
2022-01-13,6,1819,1506,1681,3150,2808,10964
2022-01-14,6,4121,1941,3512,3944,3786,17304
2022-01-15,6,4447,1255,3694,4443,5525,19364
2022-01-16,6,2903,1467,2140,2259,3562,12331
2022-01-17,6,1464,2227,2132,3423,4957,14203
2022-01-18,6,3447,1213,2490,1568,3790,12508
2022-01-19,6,4496,2000,2813,4195,2846,16350
2022-01-20,6,1682,2396,2953,3674,5683,16388
2022-01-21,6,2181,1442,3613,3492,4631,15359
2022-01-22,6,1586,996,2059,3756,2068,10465
2022-01-23,6,4914,1323,3917,1571,3523,15248
2022-01-24,6,3148,1110,1934,3424,5386,15002
2022-01-25,6,2021,2787,1735,3354,5058,14955
2022-01-26,6,1582,2030,2734,2616,3467,12429
2022-01-27,6,3097,1072,1283,3681,5736,14869
2022-01-28,6,3457,1934,1535,1728,5782,14436
2022-01-29,6,4789,1688,1548,3825,2643,14493
2022-01-30,6,2297,2815,2153,2111,2356,11732
2022-01-31,6,1882,1989,2256,2232,3583,11942
2022-02-01,6,1441,837,3690,4397,5674,16039
2022-02-02,6,1334,1812,1502,3544,3779,11971
2022-02-03,6,3098,1388,2890,4434,3051,14861
2022-02-04,6,4002,1319,1761,3846,4994,15922
2022-02-05,6,2955,1404,3760,3313,2622,14054
2022-02-06,6,1866,2300,2340,1978,3242,11726
2022-02-07,6,3090,1009,2513,3476,5906,15994
2022-02-08,6,4375,1900,2997,3520,5728,18520
2022-02-09,6,3006,875,1937,3693,2538,12049
2022-02-10,6,3287,2476,3052,1786,2523,13124
2022-02-11,6,4594,2658,3618,4415,4115,19400
2022-02-12,6,2993,1823,3336,3371,4748,16271
2022-02-13,6,4903,2833,3549,3833,2377,17495
2022-02-14,6,2674,1135,3290,4387,4644,16130
2022-02-15,6,1424,1554,1979,2572,2477,10006
2022-02-16,6,4224,2180,2932,2488,4038,15862
2022-02-17,6,4991,1797,2598,3986,3215,16587
2022-02-18,6,4815,1083,3280,3033,3952,16163
2022-02-19,6,4787,1913,3259,2383,3319,15661
2022-02-20,6,4565,2043,3531,3517,5763,19419
2022-02-21,6,4943,2441,1842,4028,5169,18423
2022-02-22,6,1292,1988,2238,2328,3795,11641
2022-02-23,6,4572,2613,2130,2397,3646,15358
2022-02-24,6,1632,1459,3596,2221,4288,13196
2022-02-25,6,3977,2317,1498,2852,5867,16511
2022-02-26,6,3362,1199,3220,4448,4717,16946
2022-02-27,6,4142,2355,1200,4476,5698,17871
2022-02-28,6,3974,2125,1865,2622,3354,13940
2022-03-01,6,2331,2751,3510,1852,5093,15537
2022-03-02,6,2784,2873,1783,1963,3047,12450
2022-03-03,6,3722,2205,3309,2977,4597,16810
2022-03-04,6,4140,1122,1726,2216,5025,14229
2022-03-05,6,3014,2909,3971,4321,4041,18256
2022-03-06,6,4632,1056,2830,2350,4890,15758
2022-03-07,6,4958,1106,3994,2525,3927,16510
2022-03-08,6,4185,971,2650,2576,5702,16084
2022-03-09,6,1030,1800,3487,3245,3721,13283
2022-03-10,6,1055,1391,1260,4423,2197,10326
2022-03-11,6,3924,2681,1942,4333,4227,17107
2022-03-12,6,3661,1760,2410,1688,3489,13008
2022-03-13,6,1740,1311,2052,1741,5517,12361
2022-03-14,6,3109,1811,2501,4185,4607,16213
2022-03-15,6,2994,1660,2181,4033,2674,13542
2022-03-16,6,3875,2947,3126,2354,3457,15759
2022-03-17,6,2687,1908,1436,3378,4708,14117
2022-03-18,6,2830,1306,2286,3727,5928,16077
2022-03-19,6,2379,1772,2616,3208,5555,15530
2022-03-20,6,3657,2070,1775,3492,3133,14127
2022-03-21,6,4092,2404,2077,3640,4991,17204
2022-03-22,6,3566,1715,1421,4228,3176,14106
2022-03-23,6,2763,2573,1416,2491,3712,12955
2022-03-24,6,3392,1435,1526,1554,5686,13593
2022-03-25,6,4636,2622,2488,3378,4404,17528
2022-03-26,6,1170,2007,2247,1614,3209,10247
2022-03-27,6,4848,1939,3612,2157,3627,16183
2022-03-28,6,4929,1502,3530,4020,5444,19425
2022-03-29,6,2888,2798,1769,3704,2284,13443
2022-03-30,6,3278,2226,1493,3174,2259,12430
2022-03-31,6,1282,2753,3273,1565,2754,11627
2022-04-01,6,3263,1751,1878,2845,4315,14052
2022-04-02,6,2822,2512,2732,3281,4859,16206
2022-04-03,6,1683,1024,3808,3395,2660,12570
2022-04-04,6,1003,1688,2338,1645,4442,11116
2022-04-05,6,4958,2809,2516,2327,2632,15242
2022-04-06,6,4497,2309,2533,2283,4409,16031
2022-04-07,6,4511,2773,2176,2787,2503,14750
2022-04-08,6,4421,2525,2396,2189,5582,17113
2022-04-09,6,2959,1021,3548,1635,2492,11655
2022-04-10,6,1008,1883,3304,4498,3411,14104
2022-04-11,6,1776,1243,2883,3783,5780,15465
2022-04-12,6,1475,2089,1802,3172,3015,11553
2022-04-13,6,1713,2580,1972,4500,4382,15147
2022-04-14,6,3017,1186,2216,3079,3367,12865
2022-04-15,6,2838,1536,3194,2747,2725,13040
2022-04-16,6,4409,1490,3203,1757,4389,15248
2022-04-17,6,4079,1710,2499,3859,4683,16830
2022-04-18,6,1884,2482,2094,4001,5540,16001
2022-04-19,6,3458,2194,2591,1939,4073,14255
2022-04-20,6,3057,2460,3768,3704,5614,18603
2022-04-21,6,4235,2057,2449,2975,3540,15256
2022-04-22,6,3689,1913,1749,1966,3499,12816
2022-04-23,6,3222,1775,3926,2905,5183,17011
2022-04-24,6,2565,2569,2945,1929,5755,15763
2022-04-25,6,4923,2117,2753,4454,2522,16769
2022-04-26,6,2679,1472,3032,3750,4729,15662
2022-04-27,6,2727,1811,3084,4235,4622,16479
2022-04-28,6,2432,986,2484,3399,4640,13941
2022-04-29,6,3476,1536,3705,4147,5359,18223
2022-04-30,6,4991,2789,3860,3262,4891,19793
2022-05-01,6,2980,1111,1794,2564,4823,13272
2022-05-02,6,4039,1373,3900,3746,3218,16276
2022-05-03,6,1214,1848,1765,4170,4136,13133
2022-05-04,6,1263,2371,1424,1865,3424,10347
2022-05-05,6,1383,2620,3786,2877,2363,13029
2022-05-06,6,2168,2723,3842,3341,3130,15204
2022-05-07,6,1167,1027,3434,3363,4775,13766
2022-05-08,6,3290,2268,2744,2624,2520,13446
2022-05-09,6,4162,976,2576,1898,2971,12583
2022-05-10,6,2366,2384,3134,2173,5486,15543
2022-05-11,6,1181,1730,3836,3323,3892,13962
2022-05-12,6,4521,860,3493,4323,5764,18961
2022-05-13,6,3130,875,3354,2922,2187,12468
2022-05-14,6,2475,2882,3833,2075,4493,15758
2022-05-15,6,2802,2233,3754,1600,4744,15133
2022-05-16,6,1823,1859,2388,4489,3179,13738
2022-05-17,6,2770,838,2474,4162,3776,14020
2022-05-18,6,2456,2464,1917,2063,2682,11582
2022-05-19,6,4634,1952,3502,3599,3934,17621
2022-05-20,6,3060,2884,1873,3024,3262,14103
2022-05-21,6,1415,2673,1740,4103,2855,12786
2022-05-22,6,1681,2636,1909,2984,4963,14173
2022-05-23,6,1139,880,3864,3257,5325,14465
2022-05-24,6,4440,1352,1966,2222,4321,14301
2022-05-25,6,1617,2010,2378,2025,3208,11238
2022-05-26,6,3249,1635,1721,3524,2385,12514
2022-05-27,6,3174,1956,2102,3417,5852,16501
2022-05-28,6,4730,1239,3178,4441,3238,16826
2022-05-29,6,3761,1250,2473,2340,2445,12269
2022-05-30,6,2445,967,2769,3478,5352,15011
2022-05-31,6,4371,2920,1829,1765,3646,14531
2022-06-01,6,1401,2750,2260,1810,4306,12527
2022-06-02,6,3782,838,1294,4420,2366,12700
2022-06-03,6,2359,1689,1631,1899,4748,12326
2022-06-04,6,4899,2565,3713,1535,2802,15514
2022-06-05,6,2371,1487,2937,2706,2135,11636
2022-06-06,6,1111,1169,3241,3334,5592,14447
2022-06-07,6,2174,2339,2383,3747,5020,15663
2022-06-08,6,2262,1903,3507,2077,5848,15597
2022-06-09,6,1364,2911,1372,2336,2641,10624
2022-06-10,6,2155,2197,3558,2294,5090,15294
2022-06-11,6,1684,1806,2990,2164,5719,14363
2022-06-12,6,1218,1050,3511,3493,4974,14246
2022-06-13,6,2790,1327,2583,1643,3159,11502
2022-06-14,6,1552,1144,1511,3358,5616,13181
2022-06-15,6,2190,2267,3917,3091,2021,13486
2022-06-16,6,2453,1797,2213,2762,2071,11296
2022-06-17,6,2653,2916,2227,2463,4580,14839
2022-06-18,6,1298,2711,1751,3200,4147,13107
2022-06-19,6,2985,1674,3433,3591,5237,16920
2022-06-20,6,1153,2470,3361,4266,5852,17102
2022-06-21,6,2309,1723,1280,3427,2904,11643
2022-06-22,6,3984,2780,2653,2251,3190,14858
2022-06-23,6,4310,1978,2525,2357,3273,14443
2022-06-24,6,1069,2630,2776,4005,3942,14422
2022-06-25,6,4874,2931,2020,3563,5212,18600
2022-06-26,6,4558,1544,2760,2394,4928,16184
2022-06-27,6,1892,1151,3224,4135,5183,15585
2022-06-28,6,3258,2338,3508,2341,3593,15038
2022-06-29,6,1258,994,2403,3449,5084,13188
2022-06-30,6,1953,1241,3686,3431,3838,14149
2022-07-01,6,4852,1623,3000,2410,2059,13944
2022-07-02,6,2407,875,2662,2690,3445,12079
2022-07-03,6,4310,2704,2161,4456,3630,17261
2022-07-04,6,1253,2121,1482,4312,5693,14861
2022-07-05,6,3393,2695,2718,1911,4517,15234
2022-07-06,6,1730,939,3752,3623,2262,12306
2022-07-07,6,4140,2932,3127,2355,2659,15213
2022-07-08,6,3188,2315,1285,1769,2035,10592
2022-07-09,6,3975,1004,2464,3335,2435,13213
2022-07-10,6,1972,2517,1426,2674,5704,14293
2022-07-11,6,2271,1731,3777,3784,4244,15807
2022-07-12,6,4178,1406,2279,3757,3093,14713
2022-07-13,6,3163,952,1999,4234,4243,14591
2022-07-14,6,2157,2417,2696,3457,3868,14595
2022-07-15,6,1665,2155,3417,4378,5987,17602
2022-07-16,6,1275,2366,1408,1649,2970,9668
2022-07-17,6,4768,2549,3873,2411,5786,19387
2022-07-18,6,4496,975,3024,2666,4923,16084
2022-07-19,6,3152,2954,2777,4466,5517,18866
2022-07-20,6,1948,2234,2755,2371,2217,11525
2022-07-21,6,2145,945,3133,3700,5779,15702
2022-07-22,6,4470,867,1851,3293,5234,15715
2022-07-23,6,4604,2758,1676,4463,3089,16590
2022-07-24,6,2319,1679,3825,3251,4923,15997
2022-07-25,6,2420,883,2902,2599,2339,11143
2022-07-26,6,1828,1294,1617,3774,3500,12013
2022-07-27,6,1113,2777,3846,2683,3425,13844
2022-07-28,6,1724,1503,3380,3273,2356,12236
2022-07-29,6,3765,2980,3789,3738,4465,18737
2022-07-30,6,2828,2340,1561,2986,2845,12560
2022-07-31,6,3258,1094,3588,2185,5712,15837
2022-08-01,6,2561,1988,1917,2454,2489,11409
2022-08-02,6,1349,2263,3473,3931,5414,16430
2022-08-03,6,1543,878,1769,3261,5433,12884
2022-08-04,6,1773,1375,2987,3537,4469,14141
2022-08-05,6,3451,2383,3570,3698,5911,19013
2022-08-06,6,2282,1628,3109,2060,3046,12125
2022-08-07,6,3949,1165,2749,2940,3032,13835
2022-08-08,6,3774,2893,3452,2319,3237,15675
2022-08-09,6,4092,1238,1274,3123,5599,15326
2022-08-10,6,1700,1838,1280,2670,2195,9683
2022-08-11,6,3900,2276,3530,2243,4877,16826
2022-08-12,6,2511,1112,1664,3926,2768,11981
2022-08-13,6,2430,2268,1669,1583,5251,13201
2022-08-14,6,3652,1502,1581,1512,5741,13988
2022-08-15,6,4245,2506,2408,3472,3250,15881
2022-08-16,6,4155,2304,2510,2569,5011,16549
2022-08-17,6,1523,1999,1814,2932,2576,10844
2022-08-18,6,2711,2854,3969,4458,5563,19555
2022-08-19,6,3815,2110,3987,1525,4511,15948
2022-08-20,6,1646,2216,2896,2028,5371,14157
2022-08-21,6,3466,2482,2489,3548,4587,16572
2022-08-22,6,4686,2045,3608,1911,2037,14287
2022-08-23,6,1150,2082,3494,3655,3131,13512
2022-08-24,6,1123,1069,2285,1958,2755,9190
2022-08-25,6,3158,1598,2414,3679,3055,13904
2022-08-26,6,4185,861,2761,2335,3643,13785
2022-08-27,6,1402,2987,2146,1899,5216,13650
2022-08-28,6,3645,1956,2122,3849,4732,16304
2022-08-29,6,3965,2570,1398,1536,2577,12046
2022-08-30,6,1771,1061,2257,1626,2768,9483
2022-08-31,6,2521,2277,2382,4321,4371,15872
2022-09-01,6,4537,2213,2532,1540,4474,15296
2022-09-02,6,4466,2629,3522,2843,2464,15924
2022-09-03,6,4546,929,1996,3513,2966,13950
2022-09-04,6,2853,2779,3835,4058,5428,18953
2022-09-05,6,1621,2742,1724,2422,3477,11986
2022-09-06,6,4044,2834,2512,2632,2144,14166
2022-09-07,6,4080,2935,2104,4225,5623,18967
2022-09-08,6,1777,957,1642,4219,2200,10795
2022-09-09,6,3611,2187,2394,2187,2070,12449
2022-09-10,6,4154,1856,1681,1593,3340,12624
2022-09-11,6,3637,1670,1400,2111,3411,12229
2022-09-12,6,2225,2014,3139,3829,4254,15461
2022-09-13,6,3709,2643,2787,2858,4429,16426
2022-09-14,6,2967,2877,3336,2803,2643,14626
2022-09-15,6,4527,2788,2860,3254,5876,19305
2022-09-16,6,2217,2328,1378,1807,2319,10049
2022-09-17,6,4181,2737,1673,3303,5386,17280
2022-09-18,6,4561,2228,2527,3591,2636,15543
2022-09-19,6,3674,2467,3251,4091,4110,17593
2022-09-20,6,3005,2198,2756,1823,2341,12123
2022-09-21,6,3770,2030,3927,3967,3088,16782
2022-09-22,6,2872,2801,3149,4388,4667,17877
2022-09-23,6,4162,2235,2020,4386,5299,18102
2022-09-24,6,2604,2618,1532,2329,3280,12363
2022-09-25,6,1530,2822,3009,4480,5192,17033
2022-09-26,6,1669,2652,3205,2294,5181,15001
2022-09-27,6,2393,2110,1975,1980,2538,10996
2022-09-28,6,2717,2049,1245,3505,2712,12228
2022-09-29,6,1797,1151,3095,3311,3081,12435
2022-09-30,6,4455,2593,2196,2356,3093,14693
2022-10-01,6,1954,959,1884,2598,5384,12779
2022-10-02,6,1731,1973,3378,1891,3164,12137
2022-10-03,6,4931,1516,3779,3700,5506,19432
2022-10-04,6,4293,2040,3527,1913,2288,14061
2022-10-05,6,2479,1659,2988,3609,3101,13836
2022-10-06,6,3247,969,3506,2665,5311,15698
2022-10-07,6,4023,2999,2483,3586,3661,16752
2022-10-08,6,1706,2400,1825,3330,2161,11422
2022-10-09,6,2448,1370,1913,3227,5947,14905
2022-10-10,6,3172,1144,1572,2429,5207,13524
2022-10-11,6,2261,2712,3061,2855,5462,16351
2022-10-12,6,1953,2957,2010,3368,2777,13065
2022-10-13,6,4877,871,1869,4379,2954,14950
2022-10-14,6,4712,910,2976,4005,2476,15079
2022-10-15,6,2248,1213,3964,2425,3256,13106
2022-10-16,6,3274,1139,1636,3556,2855,12460
2022-10-17,6,3629,1373,2762,2040,3510,13314
2022-10-18,6,2139,2153,1224,2805,5366,13687
2022-10-19,6,2175,1737,1393,2906,4251,12462
2022-10-20,6,3520,2050,2614,4353,3624,16161
2022-10-21,6,3966,2660,3842,2836,3452,16756
2022-10-22,6,2775,1141,2625,3545,2280,12366
2022-10-23,6,1316,1100,2129,3627,5463,13635
2022-10-24,6,2115,1128,2088,1622,2856,9809
2022-10-25,6,3915,2259,1971,3821,5400,17366
2022-10-26,6,2647,1086,1541,3315,3449,12038
2022-10-27,6,4649,2134,3323,2270,3901,16277
2022-10-28,6,2840,2623,3523,1998,3820,14804
2022-10-29,6,1871,2144,3755,3256,4910,15936
2022-10-30,6,3062,1915,1763,4259,2984,13983
2022-10-31,6,4690,1327,3328,3963,2962,16270
2022-11-01,6,2520,1194,3477,1701,3192,12084
2022-11-02,6,1529,2709,2185,3428,2756,12607
2022-11-03,6,3844,1185,2391,1549,3824,12793
2022-11-04,6,3920,2584,3406,4450,4389,18749
2022-11-05,6,1778,1233,3580,1721,2700,11012
2022-11-06,6,3582,971,3885,3728,4382,16548
2022-11-07,6,2656,2629,1922,1566,5189,13962
2022-11-08,6,4020,1607,2486,3806,5700,17619
2022-11-09,6,1388,1483,1924,1762,2737,9294
2022-11-10,6,1585,958,1321,3805,5299,12968
2022-11-11,6,1849,1944,2499,3666,4799,14757
2022-11-12,6,2408,2299,3797,2295,2787,13586
2022-11-13,6,3841,2178,3666,1822,4119,15626
2022-11-14,6,3486,2785,2235,4417,3304,16227
2022-11-15,6,2142,1502,2570,2704,4509,13427
2022-11-16,6,4818,1611,3797,1706,5544,17476
2022-11-17,6,3435,1016,1796,2374,2339,10960
2022-11-18,6,2543,2853,2503,1944,2437,12280
2022-11-19,6,1759,2970,2053,2184,4253,13219
2022-11-20,6,4121,2098,3035,2737,5447,17438
2022-11-21,6,4997,1872,3563,2424,4341,17197
2022-11-22,6,1657,2906,1899,3654,4990,15106
2022-11-23,6,4311,1698,2389,2611,2668,13677
2022-11-24,6,4468,2610,2600,2277,2760,14715
2022-11-25,6,4358,1924,1878,2731,2393,13284
2022-11-26,6,2161,1513,2279,3430,2749,12132
2022-11-27,6,3886,843,1267,2170,4467,12633
2022-11-28,6,2350,2295,1622,3504,2654,12425
2022-11-29,6,3706,990,1996,3906,3463,14061
2022-11-30,6,2227,975,2133,2153,2703,10191
2022-12-01,6,3237,1676,2192,2665,2677,12447
2022-12-02,6,2839,2161,3366,3007,5051,16424
2022-12-03,6,2764,2978,2393,2059,4324,14518
2022-12-04,6,4202,916,1607,1915,5985,14625
2022-12-05,6,3276,1150,3826,3315,3853,15420
2022-12-06,6,3682,2969,3723,3722,4395,18491
2022-12-07,6,3162,1358,2109,2362,4685,13676
2022-12-08,6,3264,1149,2265,4207,5924,16809
2022-12-09,6,3541,1373,3589,2085,4002,14590
2022-12-10,6,1333,1092,2651,2272,3765,11113
2022-12-11,6,2078,2826,3597,1634,4406,14541
2022-12-12,6,3989,1682,2455,3080,4530,15736
2022-12-13,6,2265,1264,1536,3269,5736,14070
2022-12-14,6,3067,2347,2527,2532,2546,13019
2022-12-15,6,4307,2226,2240,1762,2046,12581
2022-12-16,6,4123,931,2445,1809,2927,12235
2022-12-17,6,3378,1008,3049,2079,5732,15246
2022-12-18,6,3156,2332,2673,1610,4098,13869
2022-12-19,6,4041,1994,1430,2398,2152,12015
2022-12-20,6,1439,1561,1666,4352,2546,11564
2022-12-21,6,4100,2343,3796,3536,4371,18146
2022-12-22,6,4177,2550,2183,1755,3919,14584
2022-12-23,6,2693,2139,3229,3243,2784,14088
2022-12-24,6,4750,2865,3489,4269,5266,20639
2022-12-25,6,2057,2737,3381,3346,5440,16961
2022-12-26,6,1708,2702,1569,3519,4794,14292
2022-12-27,6,1009,1648,1635,2694,2471,9457
2022-12-28,6,3336,1625,2120,3211,5233,15525
2022-12-29,6,3585,2450,1693,1831,4182,13741
2022-12-30,6,1617,937,2050,3329,3215,11148
2022-12-31,6,3287,1112,2095,2682,5072,14248
2023-01-01,6,4829,2202,3227,1992,3988,16238
2023-01-02,6,2463,1897,2482,3167,5341,15350
2023-01-03,6,1653,1025,1858,2688,2276,9500
2023-01-04,6,1844,2531,1247,2314,4646,12582
2023-01-05,6,4838,2757,2213,2517,4072,16397
2023-01-06,6,1438,2921,3441,3177,2431,13408
2023-01-07,6,4316,1073,2371,2521,4643,14924
2023-01-08,6,3112,2679,3865,1567,3583,14806
2023-01-09,6,3958,1556,1348,2139,3029,12030
2023-01-10,6,1520,1171,1800,2388,5869,12748
2023-01-11,6,4741,1379,2218,2573,5630,16541
2023-01-12,6,2747,1988,1531,3129,2208,11603
2023-01-13,6,3787,1516,3325,3773,5405,17806
2023-01-14,6,3409,1037,2979,3013,5386,15824
2023-01-15,6,3930,2553,3375,2641,5736,18235
2023-01-16,6,1761,2198,2411,3153,2671,12194
2023-01-17,6,2375,1540,3686,3718,2038,13357
2023-01-18,6,3980,1807,2129,1521,4587,14024
2023-01-19,6,1876,2803,3431,3305,4449,15864
2023-01-20,6,1150,2910,2603,4009,3220,13892
2023-01-21,6,3710,2333,1831,2805,2588,13267
2023-01-22,6,2136,941,1669,2966,3160,10872
2023-01-23,6,4438,2602,1537,1875,5296,15748
2023-01-24,6,4556,2035,2569,2404,3843,15407
2023-01-25,6,2905,2513,1389,4146,4384,15337
2023-01-26,6,2292,2423,1620,2797,5459,14591
2023-01-27,6,4383,2998,1301,3278,4598,16558
2023-01-28,6,1761,2049,1576,2771,5647,13804
2023-01-29,6,3445,2104,1387,4097,5982,17015
2023-01-30,6,3617,1604,2384,3136,3402,14143
2023-01-31,6,1904,1967,3844,3719,3053,14487
2023-02-01,6,4564,1924,3788,3201,4052,17529
2023-02-02,6,4487,1242,1355,3991,5004,16079
2023-02-03,6,1802,939,3051,2904,4010,12706
2023-02-04,6,3597,2108,2795,2533,5310,16343
2023-02-05,6,2196,2108,3844,3976,3274,15398
2023-02-06,6,1015,1380,3017,3416,2753,11581
2023-02-07,6,4935,869,2883,1829,2569,13085
2023-02-08,6,3821,2065,1852,4099,5142,16979
2023-02-09,6,3537,2718,2099,3414,3216,14984
2023-02-10,6,2276,2131,2358,2745,5698,15208
2023-02-11,6,4476,1432,3931,2831,3839,16509
2023-02-12,6,1460,2671,2700,2392,5312,14535
2023-02-13,6,3219,941,3149,3629,4474,15412
2023-02-14,6,3190,2153,3062,2585,3328,14318
2023-02-15,6,1029,2303,2675,1713,4954,12674
2023-02-16,6,3492,1647,1946,2674,4757,14516
2023-02-17,6,2193,894,1794,3811,2589,11281
2023-02-18,6,2064,1284,1846,4111,3857,13162
2023-02-19,6,2768,1971,2973,3847,5546,17105
2023-02-20,6,2670,2940,1847,1845,4413,13715
2023-02-21,6,3279,2389,1627,3270,2841,13406
2023-02-22,6,3435,1476,1284,2330,4478,13003
2023-02-23,6,1852,2786,2795,3451,5250,16134
2023-02-24,6,1914,1474,2364,3034,3147,11933
2023-02-25,6,3293,1280,2466,2015,3683,12737
2023-02-26,6,4565,1965,1323,4397,3167,15417
2023-02-27,6,1393,1439,3848,3068,5938,15686
2023-02-28,6,2800,1875,3200,3380,2244,13499
2023-03-01,6,2464,1529,2813,2204,3881,12891
2023-03-02,6,4385,2353,2857,2152,4600,16347
2023-03-03,6,1843,841,2810,1578,5360,12432
2023-03-04,6,1765,2414,1950,1599,2683,10411
2023-03-05,6,4265,1112,2264,2409,2036,12086
2023-03-06,6,4382,1160,3358,3822,5589,18311
2023-03-07,6,3428,1108,2102,2436,5373,14447
2023-03-08,6,2790,1255,1387,3287,3895,12614
2023-03-09,6,4419,1912,3922,1769,3887,15909
2023-03-10,6,2166,2035,3956,1969,5290,15416
2023-03-11,6,2281,2954,1504,1642,4724,13105
2023-03-12,6,2386,1034,2561,4276,5976,16233
2023-03-13,6,1777,1044,1412,3957,5749,13939
2023-03-14,6,4017,2725,1577,1788,3761,13868
2023-03-15,6,1909,1167,3352,3000,5981,15409
2023-03-16,6,3487,1894,1890,4232,5549,17052
2023-03-17,6,2955,1969,1206,2104,5464,13698
2023-03-18,6,3356,1555,3999,3547,4680,17137
2023-03-19,6,3259,2517,2543,3210,5593,17122
2023-03-20,6,1332,1409,1678,2762,3165,10346
2023-03-21,6,3330,1501,1942,1742,5814,14329
2023-03-22,6,2288,1755,1834,2054,5552,13483
2023-03-23,6,1135,2058,1966,2467,2455,10081
2023-03-24,6,4859,2208,2279,4075,5827,19248
2023-03-25,6,3932,2420,2377,4165,5473,18367
2023-03-26,6,4927,2317,1790,1949,2276,13259
2023-03-27,6,1324,1175,2223,3502,5748,13972
2023-03-28,6,2886,2908,2880,1956,3980,14610
2023-03-29,6,2311,870,3539,4384,2026,13130
2023-03-30,6,1695,2549,1869,1888,3154,11155
2023-03-31,6,3995,1726,3632,2098,2614,14065
2023-04-01,6,4050,1476,3322,3677,2203,14728
2023-04-02,6,3474,2625,3715,3015,4019,16848
2023-04-03,6,2862,1799,1324,2424,5894,14303
2023-04-04,6,1648,1662,3926,4015,5537,16788
2023-04-05,6,3441,1141,2873,2845,3466,13766
2023-04-06,6,4843,1830,2751,3127,5594,18145
2023-04-07,6,2897,976,3096,1572,5706,14247
2023-04-08,6,2043,1126,2282,2177,4287,11915
2023-04-09,6,3094,2070,2259,3882,4391,15696
2023-04-10,6,3471,2978,2981,4225,4496,18151
2023-04-11,6,3944,2531,3239,2616,3961,16291
2023-04-12,6,2194,912,3841,1516,5106,13569
2023-04-13,6,2882,1350,1722,4075,4125,14154
2023-04-14,6,1356,2893,1567,2021,3589,11426
2023-04-15,6,1043,1314,1916,1657,2316,8246
2023-04-16,6,1582,2169,1484,4398,4068,13701
2023-04-17,6,3213,1197,3657,3762,4911,16740
2023-04-18,6,4082,2032,2175,2574,5539,16402
2023-04-19,6,2483,1040,1825,3321,4090,12759
2023-04-20,6,2162,1215,2257,3161,5901,14696
2023-04-21,6,4266,846,3111,3789,4975,16987
2023-04-22,6,3223,1509,3843,3215,3415,15205
2023-04-23,6,1911,2160,2958,2841,3954,13824
2023-04-24,6,4397,1750,2505,2153,5284,16089
2023-04-25,6,2559,2156,1782,2876,3798,13171
2023-04-26,6,2966,2243,3873,3839,4630,17551
2023-04-27,6,4313,2547,1625,2242,4926,15653
2023-04-28,6,3020,800,2063,3023,2300,11206
2023-04-29,6,2462,1427,2416,2287,2689,11281
2023-04-30,6,1780,2569,3171,3275,5756,16551
2023-05-01,6,1720,2709,2539,2290,5130,14388
2023-05-02,6,1343,2095,2892,3248,2317,11895
2023-05-03,6,4109,1494,1985,3237,2997,13822
2023-05-04,6,1129,2426,2547,2805,3897,12804
2023-05-05,6,4057,2527,2805,3678,3628,16695
2023-05-06,6,1706,1694,3516,4499,5949,17364
2023-05-07,6,4462,1115,3128,3852,5314,17871
2023-05-08,6,2297,2512,1708,4213,2827,13557
2023-05-09,6,1267,1698,2677,4331,3035,13008
2023-05-10,6,2324,2579,3956,1723,3447,14029
2023-05-11,6,1582,1650,1278,3035,5903,13448
2023-05-12,6,4761,1604,3048,2575,3173,15161
2023-05-13,6,2948,2724,3731,3128,2227,14758
2023-05-14,6,1776,2309,1453,3499,5229,14266
2023-05-15,6,4352,2700,1750,4388,3497,16687
2023-05-16,6,1330,1945,1808,3396,5997,14476
2023-05-17,6,1320,914,2666,1655,3994,10549
2023-05-18,6,4591,2830,2302,3625,2034,15382
2023-05-19,6,1483,1098,3407,3041,2151,11180
2023-05-20,6,1733,989,1691,1719,5773,11905
2023-05-21,6,1014,2606,2276,3934,5783,15613
2023-05-22,6,2620,1301,2994,4476,3079,14470
2023-05-23,6,1317,2950,1768,3826,5764,15625
2023-05-24,6,3839,1100,2435,3128,4266,14768
2023-05-25,6,4313,1291,1972,3909,5085,16570
2023-05-26,6,3169,2124,2108,4464,4041,15906
2023-05-27,6,4140,1624,2969,2954,3087,14774
2023-05-28,6,1435,1725,3104,2753,3217,12234
2023-05-29,6,4835,1366,1405,3407,3532,14545
2023-05-30,6,2732,999,3713,2671,2611,12726
2023-05-31,6,3842,1646,1277,1624,3804,12193
2023-06-01,6,2165,1347,3262,2652,3180,12606
2023-06-02,6,3826,2192,3368,2965,3914,16265
2023-06-03,6,3004,2781,3342,1760,2624,13511
2023-06-04,6,2386,1163,3635,4129,3714,15027
2023-06-05,6,2245,2184,2158,2941,2271,11799
2023-06-06,6,2550,1179,2773,2084,4204,12790
2023-06-07,6,2017,945,2786,2797,2939,11484
2023-06-08,6,3401,2384,3323,1544,2699,13351
2023-06-09,6,1134,2869,1726,3448,3144,12321
2023-06-10,6,2703,2835,3053,2491,4703,15785
2023-06-11,6,3030,1616,3304,4330,3991,16271
2023-06-12,6,2990,899,3919,4183,5886,17877
2023-06-13,6,2141,2194,3221,3044,3445,14045
2023-06-14,6,3065,1175,2506,2754,5516,15016
2023-06-15,6,3057,2403,3746,4009,2618,15833
2023-06-16,6,1733,1682,2007,4360,5604,15386
2023-06-17,6,2781,1389,1205,2923,2004,10302
2023-06-18,6,3545,1312,3486,1731,5493,15567
2023-06-19,6,1820,1301,1595,3678,2072,10466
2023-06-20,6,2971,1642,2941,2265,3204,13023
2023-06-21,6,4528,899,3293,3617,5768,18105
2023-06-22,6,1807,2627,3491,3523,3215,14663
2023-06-23,6,2955,2092,2766,2312,5050,15175
2023-06-24,6,4053,2095,3563,3924,4069,17704
2023-06-25,6,2038,2536,2459,3386,3995,14414
2023-06-26,6,4986,2490,1295,3233,5046,17050
2023-06-27,6,2490,1817,1825,2893,4154,13179
2023-06-28,6,1073,2076,1919,1876,2825,9769
2023-06-29,6,3368,811,2359,4445,5830,16813
2023-06-30,6,3636,2699,2970,3023,4104,16432
2023-07-01,6,4135,1572,3203,4172,5194,18276
2023-07-02,6,3694,2036,1236,2228,5287,14481
2023-07-03,6,1381,2032,3900,2816,3995,14124
2023-07-04,6,2382,1306,1681,3967,4457,13793
2023-07-05,6,4760,1488,2237,3687,4893,17065
2023-07-06,6,4199,2994,1532,2053,5111,15889
2023-07-07,6,4692,1289,1572,2485,5225,15263
2023-07-08,6,4637,1782,1747,1683,3429,13278
2023-07-09,6,4383,1762,1376,4247,4932,16700
2023-07-10,6,1704,2185,1994,3524,5669,15076
2023-07-11,6,4372,1931,3031,3043,3032,15409
2023-07-12,6,4984,2507,3701,2882,2064,16138
2023-07-13,6,4055,2253,2193,3183,2007,13691
2023-07-14,6,3516,1207,3180,1841,2169,11913
2023-07-15,6,1236,1869,2183,3975,2443,11706
2023-07-16,6,3499,2201,2785,3995,4779,17259
2023-07-17,6,3965,1167,2426,4417,3351,15326
2023-07-18,6,4213,1099,1618,4418,3708,15056
2023-07-19,6,4775,1041,2083,1610,5030,14539
2023-07-20,6,2345,1670,3411,1967,3093,12486
2023-07-21,6,3610,1222,3907,3969,5529,18237
2023-07-22,6,3124,1395,3897,1511,3863,13790
2023-07-23,6,1995,1210,3598,3505,3257,13565
2023-07-24,6,3069,2463,2203,3131,3591,14457
2023-07-25,6,1255,1510,2687,3652,3354,12458
2023-07-26,6,1204,1258,1751,4331,5396,13940
2023-07-27,6,1716,2684,3732,3670,2843,14645
2023-07-28,6,1577,853,3388,4465,2611,12894
2023-07-29,6,3682,2374,3180,3540,5677,18453
2023-07-30,6,4855,1066,2163,3368,5904,17356
2023-07-31,6,3190,1256,1240,3898,3814,13398
2023-08-01,6,3992,1640,3707,3404,3447,16190
2023-08-02,6,2952,1254,2490,1744,2827,11267
2023-08-03,6,3926,2712,2716,2834,5620,17808
2023-08-04,6,4533,1724,3800,1693,4905,16655
2023-08-05,6,1051,1059,1402,3229,3339,10080
2023-08-06,6,4449,1779,3477,3747,2044,15496
2023-08-07,6,2525,975,2001,1629,2639,9769
2023-08-08,6,4885,1865,3193,3178,5365,18486
2023-08-09,6,1732,2121,3622,1676,3184,12335
2023-08-10,6,3135,2675,2853,4099,2993,15755
2023-08-11,6,3017,2640,2104,2807,4829,15397
2023-08-12,6,2967,2674,2039,2969,2249,12898
2023-08-13,6,1208,2577,3924,2270,5040,15019
2023-08-14,6,4382,1829,2345,2167,2747,13470
2023-08-15,6,1847,1057,2216,2534,3853,11507
2023-08-16,6,4987,2314,3902,2565,3889,17657
2023-08-17,6,4195,2795,3434,2294,4399,17117
2023-08-18,6,1884,1288,2826,3864,4256,14118
2023-08-19,6,1919,1854,3240,3141,4094,14248
2023-08-20,6,2866,2081,3072,4487,3020,15526
2023-08-21,6,3903,1907,1238,2080,5789,14917
2023-08-22,6,2505,1411,2634,3595,3689,13834
2023-08-23,6,1359,2017,3034,3117,3952,13479
2023-08-24,6,1407,2294,2275,3046,2883,11905
2023-08-25,6,3377,2731,1896,2212,5344,15560
2023-08-26,6,2134,2896,2493,3806,4494,15823
2023-08-27,6,2482,2853,2311,2394,2605,12645
2023-08-28,6,3265,2034,3660,3139,3644,15742
2023-08-29,6,2863,1736,2040,1684,2052,10375
2023-08-30,6,4519,835,3389,3221,2106,14070
2023-08-31,6,2394,2425,1447,2340,5182,13788
2023-09-01,6,4451,1296,3052,1932,3182,13913
2023-09-02,6,1073,1492,2693,4375,4558,14191
2023-09-03,6,2531,1490,2054,4111,4210,14396
2023-09-04,6,3227,1382,2210,2706,5858,15383
2023-09-05,6,2988,2870,2596,2865,5311,16630
2023-09-06,6,2457,2778,1291,4049,5713,16288
2023-09-07,6,4160,2164,2556,3563,3448,15891
2023-09-08,6,1964,1828,2390,4320,3959,14461
2023-09-09,6,1628,2594,2840,2575,5733,15370
2023-09-10,6,3731,1017,3175,4185,4120,16228
2023-09-11,6,4144,1551,2702,2936,5551,16884
2023-09-12,6,1626,876,3656,2339,3555,12052
2023-09-13,6,2588,1199,2914,3787,2234,12722
2023-09-14,6,4762,889,2548,4260,2684,15143
2023-09-15,6,1258,930,1268,2896,3222,9574
2023-09-16,6,1100,1436,3183,2154,3658,11531
2023-09-17,6,4260,1874,2125,3406,3076,14741
2023-09-18,6,1390,2454,1236,1616,5525,12221
2023-09-19,6,2045,2287,3203,3149,4246,14930
2023-09-20,6,2958,2236,1982,2904,4893,14973
2023-09-21,6,3355,1937,2449,3876,3051,14668
2023-09-22,6,1895,2036,1514,3560,4970,13975
2023-09-23,6,2302,867,2897,3809,5234,15109
2023-09-24,6,3840,2384,3188,2245,5536,17193
2023-09-25,6,1234,2221,1747,2761,3493,11456
2023-09-26,6,3270,1453,3864,3693,5604,17884
2023-09-27,6,2391,2043,2632,4212,3375,14653
2023-09-28,6,4924,2711,2018,2968,5838,18459
2023-09-29,6,1817,1748,3328,1535,3765,12193
2023-09-30,6,4698,2930,3984,3844,5349,20805
2023-10-01,6,1790,1490,2168,1549,4636,11633
2023-10-02,6,2290,2711,2671,3425,4891,15988
2023-10-03,6,2259,1208,1991,3651,2302,11411
2023-10-04,6,1932,2234,3254,3746,2192,13358
2023-10-05,6,4202,2715,1898,3387,4396,16598
2023-10-06,6,3964,2443,2238,3645,2383,14673
2023-10-07,6,1933,1471,2127,1716,4668,11915
2023-10-08,6,2571,1256,3420,1695,3461,12403
2023-10-09,6,2301,1458,3270,3951,3779,14759
2023-10-10,6,2780,2678,2142,2859,4716,15175
2023-10-11,6,2305,1104,3240,3439,5111,15199
2023-10-12,6,3830,2849,2727,1545,3003,13954
2023-10-13,6,2024,1242,3087,2683,3599,12635
2023-10-14,6,4210,1442,3758,4197,2228,15835
2023-10-15,6,4434,2979,3741,3233,5010,19397
2023-10-16,6,4925,2471,2532,3693,4342,17963
2023-10-17,6,4603,2174,2354,4053,2663,15847
2023-10-18,6,1133,2296,1921,1681,3431,10462
2023-10-19,6,1203,2277,2309,3593,5058,14440
2023-10-20,6,3485,917,1360,3965,2938,12665
2023-10-21,6,3298,1219,1303,3112,5181,14113
2023-10-22,6,1137,1204,2567,3690,4336,12934
2023-10-23,6,3383,2099,1282,1936,3542,12242
2023-10-24,6,3259,1266,3035,4123,3235,14918
2023-10-25,6,2500,2921,2406,1753,3027,12607
2023-10-26,6,4422,1139,1204,2277,4300,13342
2023-10-27,6,3930,1675,3584,3323,4057,16569
2023-10-28,6,2795,1137,3363,2022,5813,15130
2023-10-29,6,2573,942,2237,3475,3014,12241
2023-10-30,6,4230,2544,3255,2861,4739,17629
2023-10-31,6,2889,1588,2035,3154,2301,11967
2023-11-01,6,3126,1848,3918,2170,2756,13818
2023-11-02,6,2892,2625,1793,4239,4973,16522
2023-11-03,6,1618,1636,1556,2642,3557,11009
2023-11-04,6,3614,891,2494,3506,4735,15240
2023-11-05,6,2460,2714,1416,3782,5038,15410
2023-11-06,6,3918,2608,2871,3665,2914,15976
2023-11-07,6,3223,2045,2717,4260,4671,16916
2023-11-08,6,1953,2504,3312,3333,3118,14220
2023-11-09,6,4799,2586,2250,4008,4405,18048
2023-11-10,6,4224,2205,2658,3915,4595,17597
2023-11-11,6,3348,1179,3147,3336,4495,15505
2023-11-12,6,4622,1460,1853,2363,3442,13740
2023-11-13,6,3914,1873,3167,3091,4408,16453
2023-11-14,6,2278,2370,2329,1960,2619,11556
2023-11-15,6,3588,1708,3287,1894,3236,13713
2023-11-16,6,2941,2307,1901,4120,5324,16593
2023-11-17,6,4460,868,1499,2136,4504,13467
2023-11-18,6,1602,1951,1904,1705,4130,11292
2023-11-19,6,2916,1789,3338,1910,2933,12886
2023-11-20,6,1675,2672,2113,2937,3120,12517
2023-11-21,6,4546,2169,1367,3496,3464,15042
2023-11-22,6,1828,2860,3550,3967,3788,15993
2023-11-23,6,4323,2561,1761,4221,3843,16709
2023-11-24,6,1321,2509,2963,4451,5881,17125
2023-11-25,6,2098,2412,1956,4013,2764,13243
2023-11-26,6,2529,2970,2245,4448,4556,16748
2023-11-27,6,1769,1061,3646,2226,3294,11996
2023-11-28,6,4552,1965,1213,4120,4735,16585
2023-11-29,6,4793,2671,1816,3986,5600,18866
2023-11-30,6,4708,1535,1779,3747,4155,15924
2023-12-01,6,2264,895,1538,1799,2765,9261
2023-12-02,6,1991,1925,3179,2042,4424,13561
2023-12-03,6,4872,2658,1312,3578,5270,17690
2023-12-04,6,2259,1131,3506,4273,2004,13173
2023-12-05,6,4152,1912,2897,1722,2136,12819
2023-12-06,6,4711,991,1312,3542,3941,14497
2023-12-07,6,4662,1438,3115,4262,4158,17635
2023-12-08,6,4052,1818,1777,2257,2735,12639
2023-12-09,6,1500,1114,1376,3196,4635,11821
2023-12-10,6,4077,2860,3608,3990,2030,16565
2023-12-11,6,4860,2212,2888,2390,2607,14957
2023-12-12,6,3079,1078,3087,4403,2743,14390
2023-12-13,6,3392,2221,3834,2582,3870,15899
2023-12-14,6,4417,2623,3953,3997,2059,17049
2023-12-15,6,3295,2172,3686,1672,4510,15335
2023-12-16,6,1538,1767,2288,2390,5068,13051
2023-12-17,6,4750,1846,2249,2654,4266,15765
2023-12-18,6,4862,2259,2132,3484,3737,16474
2023-12-19,6,4805,2886,3764,3426,5286,20167
2023-12-20,6,1226,1822,2773,2517,2167,10505
2023-12-21,6,4387,2406,1724,1854,2336,12707
2023-12-22,6,1961,1022,2751,1504,3539,10777
2023-12-23,6,2023,2290,2822,3252,4188,14575
2023-12-24,6,1883,1785,1706,1679,4857,11910
2023-12-25,6,2769,2173,3707,4268,2546,15463
2023-12-26,6,3864,1534,3580,3619,3624,16221
2023-12-27,6,3862,2072,3757,2324,3903,15918
2023-12-28,6,2080,2661,3183,4434,5951,18309
2023-12-29,6,1376,2471,2925,3560,4078,14410
2023-12-30,6,2891,1254,3659,3026,4914,15744
2023-12-31,6,2018,1099,2844,1794,3584,11339
2022-01-01,7,4770,1178,3902,4416,5342,19608
2022-01-02,7,4866,1667,2378,1662,4763,15336
2022-01-03,7,2407,2948,1792,2456,5772,15375
2022-01-04,7,1099,1108,1827,3596,3022,10652
2022-01-05,7,3452,2621,1279,3961,3044,14357
2022-01-06,7,1537,2343,3404,3416,4085,14785
2022-01-07,7,4078,2189,1413,2163,5445,15288
2022-01-08,7,3018,2173,3453,3138,4187,15969
2022-01-09,7,3792,2210,3104,2461,5550,17117
2022-01-10,7,4759,2619,3313,1580,5714,17985
2022-01-11,7,1069,1441,1402,4039,2598,10549
2022-01-12,7,1657,2462,1753,3626,4451,13949
2022-01-13,7,1726,1177,3501,2624,2505,11533
2022-01-14,7,1090,2448,1924,2662,2808,10932
2022-01-15,7,3894,2991,3291,2101,3947,16224
2022-01-16,7,1688,2146,3646,3827,3030,14337
2022-01-17,7,4274,1554,2887,4373,2367,15455
2022-01-18,7,1507,2385,3073,4050,3082,14097
2022-01-19,7,1494,1163,2695,3140,5329,13821
2022-01-20,7,2433,1923,1302,1692,3809,11159
2022-01-21,7,4215,1018,2305,4156,5433,17127
2022-01-22,7,3598,844,2188,3492,5271,15393
2022-01-23,7,3422,1399,3464,3902,3450,15637
2022-01-24,7,3198,2478,1692,2562,3248,13178
2022-01-25,7,1842,1054,2019,1936,3683,10534
2022-01-26,7,4144,2692,3397,4146,5127,19506
2022-01-27,7,1910,1614,3101,2572,3063,12260
2022-01-28,7,4108,2128,3526,3385,5401,18548
2022-01-29,7,3769,901,3298,4007,2410,14385
2022-01-30,7,3842,1840,3660,3548,5270,18160
2022-01-31,7,1444,1104,3675,1583,4681,12487
2022-02-01,7,2448,2121,3472,2821,3715,14577
2022-02-02,7,2403,2607,1764,3813,4782,15369
2022-02-03,7,3577,1754,3725,3104,3961,16121
2022-02-04,7,4954,1293,1952,4376,4757,17332
2022-02-05,7,3314,2011,2367,2592,3020,13304
2022-02-06,7,4135,2597,1947,2019,3379,14077
2022-02-07,7,2868,2030,3490,1623,3040,13051
2022-02-08,7,1581,2034,3386,1687,3070,11758
2022-02-09,7,4371,2390,2647,4129,4359,17896
2022-02-10,7,2955,1634,2758,3492,4783,15622
2022-02-11,7,2720,2328,3124,1834,2195,12201
2022-02-12,7,2303,2265,3919,2845,2408,13740
2022-02-13,7,1082,1106,1433,2648,5188,11457
2022-02-14,7,4190,1959,1747,2067,3850,13813
2022-02-15,7,4582,2740,2462,2672,3002,15458
2022-02-16,7,1337,1865,1432,3102,2228,9964
2022-02-17,7,2035,2909,2767,2886,2507,13104
2022-02-18,7,1276,1516,2757,2081,4791,12421
2022-02-19,7,3276,1464,1432,3367,4705,14244
2022-02-20,7,1857,1416,2653,2564,3779,12269
2022-02-21,7,4339,1756,1208,4239,4061,15603
2022-02-22,7,2668,1715,3178,3913,2075,13549
2022-02-23,7,2265,2301,3175,3640,5321,16702
2022-02-24,7,2980,1434,2508,2211,5178,14311
2022-02-25,7,1120,1794,1565,4462,5542,14483
2022-02-26,7,1419,2472,2732,2858,4900,14381
2022-02-27,7,2507,1972,3545,1658,3999,13681
2022-02-28,7,4177,2455,1607,3514,4158,15911
2022-03-01,7,1867,859,2651,4242,2378,11997
2022-03-02,7,2711,925,1524,2781,3747,11688
2022-03-03,7,2948,1786,3391,3448,3714,15287
2022-03-04,7,1822,2270,2619,1875,2776,11362
2022-03-05,7,4046,2810,2294,3317,2591,15058
2022-03-06,7,2759,1252,2034,3202,3067,12314
2022-03-07,7,1024,1978,2286,1723,4423,11434
2022-03-08,7,3616,1514,3588,4135,3523,16376
2022-03-09,7,3480,2822,2513,2867,4750,16432
2022-03-10,7,2926,2756,1244,1542,2647,11115
2022-03-11,7,1204,1495,2783,1899,3558,10939
2022-03-12,7,1554,2555,2135,3396,3281,12921
2022-03-13,7,1532,2770,1683,1503,5802,13290
2022-03-14,7,1203,853,1642,2592,2559,8849
2022-03-15,7,2488,1743,1609,3060,3265,12165
2022-03-16,7,1684,2192,3322,1855,2873,11926
2022-03-17,7,4727,1719,3982,2965,4894,18287
2022-03-18,7,4882,1766,3340,3947,3257,17192
2022-03-19,7,1354,2283,1614,3466,5585,14302
2022-03-20,7,3426,1561,1203,2935,2754,11879
2022-03-21,7,2982,2753,3604,3385,5158,17882
2022-03-22,7,4453,2526,3875,3870,4626,19350
2022-03-23,7,2582,2399,2811,3177,3730,14699
2022-03-24,7,2300,1836,1606,3154,3994,12890
2022-03-25,7,4491,1269,1417,3747,5122,16046
2022-03-26,7,1488,895,1931,1590,5340,11244
2022-03-27,7,4647,2969,3130,2951,5579,19276
2022-03-28,7,4505,2350,1457,3913,2289,14514
2022-03-29,7,1375,1380,2771,4374,5697,15597
2022-03-30,7,1530,2307,3140,1962,4252,13191
2022-03-31,7,2473,2494,3020,1656,2557,12200
2022-04-01,7,2511,988,1814,2604,3716,11633
2022-04-02,7,4319,2018,2897,2421,5806,17461
2022-04-03,7,2596,2847,3246,2232,5255,16176
2022-04-04,7,1676,2218,1699,2178,4823,12594
2022-04-05,7,3281,1961,1259,2835,4280,13616
2022-04-06,7,1562,2811,2637,2177,5390,14577
2022-04-07,7,2943,1688,3959,1878,5110,15578
2022-04-08,7,4875,2626,1866,1618,4777,15762
2022-04-09,7,4377,1656,2844,1782,3317,13976
2022-04-10,7,3859,2510,2181,2901,3043,14494
2022-04-11,7,4075,2484,1478,3892,5141,17070
2022-04-12,7,1946,1731,2909,3367,2207,12160
2022-04-13,7,1819,1200,2720,1759,3398,10896
2022-04-14,7,2976,2982,1907,3813,4987,16665
2022-04-15,7,4167,1835,1442,2964,4020,14428
2022-04-16,7,2967,1272,2824,2983,5997,16043
2022-04-17,7,4340,2252,2366,1674,5647,16279
2022-04-18,7,3391,1855,3934,1544,4404,15128
2022-04-19,7,1928,2979,1437,3865,5116,15325
2022-04-20,7,4021,2457,1805,2192,5442,15917
2022-04-21,7,4308,2715,2469,1600,2520,13612
2022-04-22,7,1176,947,3978,2650,3291,12042
2022-04-23,7,4431,2633,3780,3771,2310,16925
2022-04-24,7,1563,2111,2231,2957,2445,11307
2022-04-25,7,4849,1444,3964,2976,3307,16540
2022-04-26,7,4428,1318,2794,2732,4205,15477
2022-04-27,7,1268,820,3195,3709,4986,13978
2022-04-28,7,3472,2689,1534,3568,2212,13475
2022-04-29,7,4023,2773,2509,3410,5080,17795
2022-04-30,7,4416,1004,3841,3728,4591,17580
2022-05-01,7,4823,1968,2504,3614,2605,15514
2022-05-02,7,2803,1144,1671,2829,3642,12089
2022-05-03,7,1337,1794,1871,2570,4702,12274
2022-05-04,7,4053,2940,2704,4397,2017,16111
2022-05-05,7,4957,1802,3652,1689,4630,16730
2022-05-06,7,2671,1524,3927,4204,4409,16735
2022-05-07,7,2784,1475,2529,3389,3744,13921
2022-05-08,7,1872,1827,3191,3115,5583,15588
2022-05-09,7,3735,2406,2679,1976,4618,15414
2022-05-10,7,2482,2716,1268,3679,5648,15793
2022-05-11,7,1367,2030,3495,1624,3522,12038
2022-05-12,7,3211,2462,1428,4327,3236,14664
2022-05-13,7,1600,910,1969,3266,5289,13034
2022-05-14,7,3048,2592,2380,4340,4912,17272
2022-05-15,7,4512,997,2627,2575,4952,15663
2022-05-16,7,3499,2154,1985,1716,3958,13312
2022-05-17,7,3385,1802,2876,3926,4417,16406
2022-05-18,7,2416,1089,3720,3425,2075,12725
2022-05-19,7,2355,1004,3848,4279,3387,14873
2022-05-20,7,4125,1215,2841,2235,5415,15831
2022-05-21,7,2691,2379,3307,2832,3550,14759
2022-05-22,7,1104,1088,3565,2237,2257,10251
2022-05-23,7,4596,2125,1582,3162,5111,16576
2022-05-24,7,3649,2072,3092,3142,2601,14556
2022-05-25,7,3031,1019,1711,3289,5693,14743
2022-05-26,7,1477,2478,3115,3225,3129,13424
2022-05-27,7,2067,2841,1789,1787,5427,13911
2022-05-28,7,1743,1620,1715,2497,5065,12640
2022-05-29,7,4631,1964,1552,1739,2984,12870
2022-05-30,7,3736,2881,2351,3898,3383,16249
2022-05-31,7,1971,2510,2323,2500,4471,13775
2022-06-01,7,1644,1824,3510,2478,5770,15226
2022-06-02,7,1067,910,2878,4121,3236,12212
2022-06-03,7,4642,2603,2201,2032,5374,16852
2022-06-04,7,4787,2784,3012,2346,2741,15670
2022-06-05,7,4343,1922,3308,1796,2565,13934
2022-06-06,7,4851,2164,2132,4111,2953,16211
2022-06-07,7,3112,2702,1672,2807,4175,14468
2022-06-08,7,1931,2479,3918,2520,4733,15581
2022-06-09,7,1909,825,3337,3334,4846,14251
2022-06-10,7,4508,2033,2130,2818,2874,14363
2022-06-11,7,4942,1224,3117,2231,2534,14048
2022-06-12,7,2297,1620,1291,1516,2793,9517
2022-06-13,7,1551,2618,1944,4479,5013,15605
2022-06-14,7,1898,981,1561,2546,3160,10146
2022-06-15,7,4321,2050,2662,3062,5617,17712
2022-06-16,7,2270,1976,3382,2885,4752,15265
2022-06-17,7,4168,2274,2556,1935,3181,14114
2022-06-18,7,2585,1167,2213,2736,5937,14638
2022-06-19,7,1188,1399,1386,3250,3383,10606
2022-06-20,7,3869,2037,1604,3978,4537,16025
2022-06-21,7,1427,2984,1990,3635,5902,15938
2022-06-22,7,1085,940,3089,2696,4578,12388
2022-06-23,7,3448,993,3616,2458,5041,15556
2022-06-24,7,3202,1510,1908,3806,4504,14930
2022-06-25,7,2100,2000,2675,3035,4584,14394
2022-06-26,7,2499,1353,2149,2941,3221,12163
2022-06-27,7,1576,2670,2767,2065,3448,12526
2022-06-28,7,4985,1917,2767,2252,2723,14644
2022-06-29,7,2377,975,1319,1954,4684,11309
2022-06-30,7,1180,1798,1686,3339,4772,12775
2022-07-01,7,4277,2204,3877,3680,5541,19579
2022-07-02,7,3916,2510,2854,2218,5152,16650
2022-07-03,7,3052,2335,2475,2181,3875,13918
2022-07-04,7,4478,1912,3193,1967,2146,13696
2022-07-05,7,4545,1072,1431,4071,2515,13634
2022-07-06,7,3246,1224,3124,3748,2117,13459
2022-07-07,7,3678,1841,3838,2435,2361,14153
2022-07-08,7,3101,1398,2744,4275,3607,15125
2022-07-09,7,4070,1856,2600,2940,2700,14166
2022-07-10,7,4663,1756,3536,2115,2644,14714
2022-07-11,7,3890,824,1681,4196,2336,12927
2022-07-12,7,2956,1061,1425,3522,2043,11007
2022-07-13,7,2270,1730,1668,4103,2190,11961
2022-07-14,7,1449,2530,2273,4441,5711,16404
2022-07-15,7,2142,858,1646,3312,2633,10591
2022-07-16,7,2656,1089,1802,3778,2792,12117
2022-07-17,7,3908,978,2593,4355,4933,16767
2022-07-18,7,4766,2118,1246,2921,4460,15511
2022-07-19,7,1220,2218,2420,2730,2961,11549
2022-07-20,7,2575,2246,1774,3985,5493,16073
2022-07-21,7,2642,809,3728,2424,3976,13579
2022-07-22,7,3095,963,1844,1552,2166,9620
2022-07-23,7,2539,1430,2598,4484,2246,13297
2022-07-24,7,1127,1588,1971,3405,5949,14040
2022-07-25,7,4083,1363,3702,3116,3430,15694
2022-07-26,7,1176,1482,2746,3270,3171,11845
2022-07-27,7,1785,2534,2936,1984,3174,12413
2022-07-28,7,2120,1169,1745,4071,5634,14739
2022-07-29,7,3313,2730,1234,4049,3043,14369
2022-07-30,7,4467,1526,1580,3615,5663,16851
2022-07-31,7,1811,2085,3508,3572,4526,15502
2022-08-01,7,4917,2630,2761,2668,5128,18104
2022-08-02,7,2347,2153,2989,3642,2769,13900
2022-08-03,7,5000,1151,2356,4310,5687,18504
2022-08-04,7,4831,951,2288,4352,3088,15510
2022-08-05,7,3064,1936,3641,1856,3810,14307
2022-08-06,7,4390,1814,2064,2667,5142,16077
2022-08-07,7,4382,2757,2566,4037,2923,16665
2022-08-08,7,2955,1443,2038,4197,5107,15740
2022-08-09,7,2523,988,3235,3390,5274,15410
2022-08-10,7,3166,1107,1774,4169,5584,15800
2022-08-11,7,3385,1884,1580,2443,4258,13550
2022-08-12,7,1281,2147,2312,3411,2889,12040
2022-08-13,7,2541,2962,3506,3065,5641,17715
2022-08-14,7,1887,1616,2050,2438,3060,11051
2022-08-15,7,1327,2191,3141,2529,4992,14180
2022-08-16,7,3531,2949,2177,2113,2863,13633
2022-08-17,7,2185,1983,2645,4466,2358,13637
2022-08-18,7,3929,1607,1805,1763,4528,13632
2022-08-19,7,2748,2210,2460,4083,4106,15607
2022-08-20,7,1718,1904,3649,2372,5194,14837
2022-08-21,7,2805,1513,1814,4180,2038,12350
2022-08-22,7,3083,2544,2480,4485,2672,15264
2022-08-23,7,3544,2228,2470,3409,4976,16627
2022-08-24,7,4433,1830,3436,4060,2051,15810
2022-08-25,7,2327,2487,2865,2170,5906,15755
2022-08-26,7,4871,1957,1715,2427,5449,16419
2022-08-27,7,1503,953,1405,2043,2544,8448
2022-08-28,7,1023,2562,3638,3506,3075,13804
2022-08-29,7,4006,841,1901,4023,2880,13651
2022-08-30,7,4099,804,2321,3777,3907,14908
2022-08-31,7,2678,2592,2743,4460,3361,15834
2022-09-01,7,1506,1601,3985,3870,3033,13995
2022-09-02,7,1818,2404,3948,3921,4903,16994
2022-09-03,7,3023,2193,1369,4027,3751,14363
2022-09-04,7,1861,1611,2319,1862,5411,13064
2022-09-05,7,2386,1082,1821,4305,3376,12970
2022-09-06,7,2570,2494,3055,1792,4905,14816
2022-09-07,7,2410,1986,2227,2226,2134,10983
2022-09-08,7,3248,2827,2959,4330,2809,16173
2022-09-09,7,1795,1173,2762,2185,3889,11804
2022-09-10,7,2649,1238,1222,2612,5054,12775
2022-09-11,7,1567,896,2534,3872,4404,13273
2022-09-12,7,3661,1733,2880,4155,2241,14670
2022-09-13,7,3468,2635,1348,4374,2655,14480
2022-09-14,7,2087,961,2700,3540,4218,13506
2022-09-15,7,3897,1225,2318,1938,4813,14191
2022-09-16,7,3365,940,1743,1716,2659,10423
2022-09-17,7,4378,2157,2647,1837,2607,13626
2022-09-18,7,3236,2938,1481,4275,5574,17504
2022-09-19,7,3433,2897,2187,2787,3754,15058
2022-09-20,7,3189,2647,1460,2207,3101,12604
2022-09-21,7,2344,938,3518,1652,3358,11810
2022-09-22,7,2403,1558,1639,2118,4478,12196
2022-09-23,7,1475,2966,1844,2387,3764,12436
2022-09-24,7,3734,1255,3810,2779,3809,15387
2022-09-25,7,2054,2862,1960,3693,5401,15970
2022-09-26,7,2152,1506,2719,4364,3159,13900
2022-09-27,7,3168,1675,1667,2541,5471,14522
2022-09-28,7,2866,2361,2921,4256,5062,17466
2022-09-29,7,2652,1928,3340,1559,4029,13508
2022-09-30,7,2012,958,1618,2705,5082,12375
2022-10-01,7,4960,2394,3653,3194,4198,18399
2022-10-02,7,3837,2430,3316,2937,2334,14854
2022-10-03,7,3267,1327,3872,3386,2446,14298
2022-10-04,7,3109,862,1461,3634,4521,13587
2022-10-05,7,3720,1791,3034,4109,5401,18055
2022-10-06,7,3365,2036,2884,4030,4471,16786
2022-10-07,7,3563,1412,3005,3567,3106,14653
2022-10-08,7,4316,2310,1750,4132,4272,16780
2022-10-09,7,2485,1480,3350,1637,2611,11563
2022-10-10,7,3098,1358,3244,3002,4859,15561
2022-10-11,7,4121,826,3673,4034,5044,17698
2022-10-12,7,2562,1188,3540,2569,5910,15769
2022-10-13,7,3972,2044,1621,2872,3383,13892
2022-10-14,7,3588,2630,3303,4291,5253,19065
2022-10-15,7,4205,1170,1266,1791,5660,14092
2022-10-16,7,4755,1931,1790,2160,3581,14217
2022-10-17,7,2448,1214,2870,3944,5977,16453
2022-10-18,7,1648,2050,2297,2848,2277,11120
2022-10-19,7,2600,2173,3280,4263,3273,15589
2022-10-20,7,2784,1149,2296,4402,2535,13166
2022-10-21,7,4968,2746,2730,2431,3138,16013
2022-10-22,7,1135,1590,1752,2585,5120,12182
2022-10-23,7,2932,2690,3569,2790,5398,17379
2022-10-24,7,2294,2337,1865,2796,4863,14155
2022-10-25,7,2907,2325,1699,3849,2023,12803
2022-10-26,7,1244,1482,3572,2365,3533,12196
2022-10-27,7,4386,2904,1238,3566,2892,14986
2022-10-28,7,2667,1534,2913,1600,5411,14125
2022-10-29,7,4709,1815,3779,4416,5547,20266
2022-10-30,7,1808,1897,3020,3560,2972,13257
2022-10-31,7,1900,941,3219,2308,3776,12144
2022-11-01,7,1585,1537,2414,3994,5383,14913
2022-11-02,7,4506,1708,3792,1541,4985,16532
2022-11-03,7,3256,951,2489,2122,4789,13607
2022-11-04,7,4763,817,3413,1912,2790,13695
2022-11-05,7,3615,1384,1918,1664,5841,14422
2022-11-06,7,3810,2734,2323,2403,3895,15165
2022-11-07,7,2535,2449,2075,2989,3499,13547
2022-11-08,7,4024,2419,1735,4442,5262,17882
2022-11-09,7,1799,2769,3187,2860,2271,12886
2022-11-10,7,3458,2646,3670,3097,3636,16507
2022-11-11,7,3390,2863,2238,1558,4296,14345
2022-11-12,7,3149,2972,3854,1973,4523,16471
2022-11-13,7,4271,1333,3629,4088,3836,17157
2022-11-14,7,3564,1816,1827,2786,4581,14574
2022-11-15,7,1596,2190,1310,3131,3045,11272
2022-11-16,7,4113,2048,1709,3901,2936,14707
2022-11-17,7,2846,2525,3020,3359,4751,16501
2022-11-18,7,4163,980,3075,3631,3056,14905
2022-11-19,7,4219,2716,1707,3220,5666,17528
2022-11-20,7,2756,1498,2631,3476,3249,13610
2022-11-21,7,2202,1336,2072,2511,5273,13394
2022-11-22,7,2882,2834,2602,2791,5949,17058
2022-11-23,7,2645,2417,2507,2676,4421,14666
2022-11-24,7,4189,1164,2836,3853,5515,17557
2022-11-25,7,2959,2558,1425,3245,2752,12939
2022-11-26,7,2690,1543,2862,2683,4216,13994
2022-11-27,7,3584,1840,1690,4367,3554,15035
2022-11-28,7,2362,2812,2268,2601,3350,13393
2022-11-29,7,3858,941,2533,2627,3250,13209
2022-11-30,7,2940,2316,3915,2423,5674,17268
2022-12-01,7,1692,2721,3887,3088,3320,14708
2022-12-02,7,1216,2987,1614,2236,5709,13762
2022-12-03,7,1746,2477,2095,2033,2726,11077
2022-12-04,7,4841,1419,2662,1750,5488,16160
2022-12-05,7,1250,2245,2157,4425,2197,12274
2022-12-06,7,2603,2353,3996,3357,3461,15770
2022-12-07,7,1527,1414,1509,2683,2778,9911
2022-12-08,7,1818,1597,2899,4406,2486,13206
2022-12-09,7,4037,2183,3406,2514,5649,17789
2022-12-10,7,3780,2703,2898,1783,5160,16324
2022-12-11,7,4274,1979,2087,2675,4191,15206
2022-12-12,7,1199,868,1751,4439,5587,13844
2022-12-13,7,3904,1451,2538,2026,3094,13013
2022-12-14,7,3285,2450,2137,1771,4696,14339
2022-12-15,7,1006,2808,3733,2384,2163,12094
2022-12-16,7,3698,953,2511,1510,2815,11487
2022-12-17,7,4461,1628,1617,4023,2133,13862
2022-12-18,7,1275,1187,2330,3441,4822,13055
2022-12-19,7,4592,1891,1340,4280,3598,15701
2022-12-20,7,3672,2076,2411,4134,2922,15215
2022-12-21,7,2703,1473,1947,2895,5375,14393
2022-12-22,7,1192,2090,2627,2979,3369,12257
2022-12-23,7,3909,2154,1911,3527,3270,14771
2022-12-24,7,1455,1644,3192,2096,2834,11221
2022-12-25,7,2256,1270,3572,2267,4364,13729
2022-12-26,7,4818,1403,2241,1622,5227,15311
2022-12-27,7,3736,2367,2483,2600,4256,15442
2022-12-28,7,2223,1697,3990,2921,4140,14971
2022-12-29,7,4600,999,3309,2132,2458,13498
2022-12-30,7,3738,1374,1525,1616,4788,13041
2022-12-31,7,4675,1885,2296,2497,5894,17247
2023-01-01,7,4075,1642,2793,4229,3364,16103
2023-01-02,7,3672,1244,2564,2147,5796,15423
2023-01-03,7,3586,1374,1565,2046,2108,10679
2023-01-04,7,3687,2963,1660,2783,5521,16614
2023-01-05,7,2805,2594,1374,2515,5801,15089
2023-01-06,7,4283,2863,3806,2350,3704,17006
2023-01-07,7,3146,2006,3825,4074,5199,18250
2023-01-08,7,4741,2909,3981,3982,5762,21375
2023-01-09,7,2241,2428,2358,2796,3977,13800
2023-01-10,7,3980,969,2759,1747,5581,15036
2023-01-11,7,1405,911,3385,2018,5817,13536
2023-01-12,7,2881,1466,3975,2707,5755,16784
2023-01-13,7,3941,2468,3032,3420,4736,17597
2023-01-14,7,4907,2333,3151,4335,2382,17108
2023-01-15,7,1753,1844,2303,2099,5998,13997
2023-01-16,7,3408,2247,2645,4232,2271,14803
2023-01-17,7,4300,2332,3806,1707,4973,17118
2023-01-18,7,3851,880,2876,3224,4031,14862
2023-01-19,7,4726,1825,1407,1930,3430,13318
2023-01-20,7,1471,1321,3325,3114,5640,14871
2023-01-21,7,2130,2064,3358,3538,5902,16992
2023-01-22,7,1360,2248,1382,4148,3136,12274
2023-01-23,7,4745,1544,1688,1890,4567,14434
2023-01-24,7,4537,1096,3628,3269,2701,15231
2023-01-25,7,4021,1881,3008,4208,3359,16477
2023-01-26,7,1194,1474,2626,3500,3774,12568
2023-01-27,7,3447,2590,1454,3612,3567,14670
2023-01-28,7,1921,1795,2499,4223,2509,12947
2023-01-29,7,2065,1581,2987,2859,4604,14096
2023-01-30,7,3430,2122,2569,2274,2103,12498
2023-01-31,7,3073,2893,1260,2618,4780,14624
2023-02-01,7,4295,1883,3111,2688,5799,17776
2023-02-02,7,3685,2368,2244,3056,2678,14031
2023-02-03,7,2997,2765,1553,2949,5324,15588
2023-02-04,7,1397,995,1600,1802,3911,9705
2023-02-05,7,1266,1219,3996,3951,2449,12881
2023-02-06,7,1931,1711,1271,2392,5834,13139
2023-02-07,7,3859,1176,3917,2812,5186,16950
2023-02-08,7,2534,2038,3723,2646,2524,13465
2023-02-09,7,1428,1432,3647,2353,2172,11032
2023-02-10,7,2526,1720,3365,3898,3917,15426
2023-02-11,7,2888,887,2417,2862,4934,13988
2023-02-12,7,4168,2922,3718,1795,5884,18487
2023-02-13,7,3694,1834,3614,1633,5730,16505
2023-02-14,7,1817,2360,3751,2238,4767,14933
2023-02-15,7,1109,1535,3890,2603,2062,11199
2023-02-16,7,2280,2222,3942,3340,5125,16909
2023-02-17,7,4486,1364,2526,4003,3374,15753
2023-02-18,7,4085,1340,1790,1669,3167,12051
2023-02-19,7,4832,2026,2085,4297,2841,16081
2023-02-20,7,4672,2130,3734,4112,4497,19145
2023-02-21,7,4119,1586,2020,2121,5665,15511
2023-02-22,7,3025,1494,3559,4453,5463,17994
2023-02-23,7,1023,1408,1270,3221,3944,10866
2023-02-24,7,4175,2220,3518,1800,5879,17592
2023-02-25,7,2748,2380,2241,3552,3190,14111
2023-02-26,7,2805,2213,3666,3604,3742,16030
2023-02-27,7,1337,1294,2334,2899,5252,13116
2023-02-28,7,4462,2810,2684,3459,2181,15596
2023-03-01,7,2053,2291,3147,2969,2594,13054
2023-03-02,7,1490,2404,2103,2942,5881,14820
2023-03-03,7,3896,1310,2147,4192,5125,16670
2023-03-04,7,4539,2762,1275,4307,4662,17545
2023-03-05,7,2839,2384,1246,4084,2056,12609
2023-03-06,7,3874,2263,2544,2252,4505,15438
2023-03-07,7,4277,1928,1883,1690,5921,15699
2023-03-08,7,2197,1494,2465,3899,4216,14271
2023-03-09,7,4591,1572,2276,3950,5804,18193
2023-03-10,7,1116,2320,2080,3970,5545,15031
2023-03-11,7,2123,1232,3748,4447,3096,14646
2023-03-12,7,4813,1392,2942,2243,4843,16233
2023-03-13,7,4444,2411,3381,1918,3979,16133
2023-03-14,7,3756,1338,3967,3278,2205,14544
2023-03-15,7,2500,2938,3631,2914,4794,16777
2023-03-16,7,1417,1551,3777,1734,2954,11433
2023-03-17,7,4189,2072,3286,2361,5284,17192
2023-03-18,7,3325,2443,3354,2221,5969,17312
2023-03-19,7,4511,2531,3263,2914,5998,19217
2023-03-20,7,2360,1106,1721,3845,3921,12953
2023-03-21,7,3066,2584,3442,3883,2068,15043
2023-03-22,7,3734,1428,2605,3794,2004,13565
2023-03-23,7,4663,1937,2953,3613,5697,18863
2023-03-24,7,2297,836,3157,2467,5490,14247
2023-03-25,7,3011,2564,2464,3170,3052,14261
2023-03-26,7,4478,1525,2756,4459,4679,17897
2023-03-27,7,1204,2035,1698,1776,5223,11936
2023-03-28,7,2677,1256,2769,2340,3559,12601
2023-03-29,7,1749,1653,2784,2320,2343,10849
2023-03-30,7,4406,2723,3557,3860,3922,18468
2023-03-31,7,1938,1742,3658,3931,4284,15553
2023-04-01,7,2173,823,1582,1506,2114,8198
2023-04-02,7,1298,2245,1741,2016,5431,12731
2023-04-03,7,1087,1865,3864,3505,3215,13536
2023-04-04,7,4333,1326,1757,3785,2200,13401
2023-04-05,7,3196,2531,3298,1697,5500,16222
2023-04-06,7,1446,2088,1703,2649,3922,11808
2023-04-07,7,3645,1767,1927,3992,5250,16581
2023-04-08,7,4314,1717,1853,2804,4264,14952
2023-04-09,7,4119,808,2022,4241,5864,17054
2023-04-10,7,1831,1539,3452,3872,3345,14039
2023-04-11,7,3116,2859,3547,3869,3028,16419
2023-04-12,7,3906,1478,1997,2345,3434,13160
2023-04-13,7,2653,2916,1222,2800,5673,15264
2023-04-14,7,2001,2541,2126,1873,3404,11945
2023-04-15,7,4560,2983,2268,2340,5356,17507
2023-04-16,7,3930,1007,3938,1686,5441,16002
2023-04-17,7,3214,971,3801,2225,3159,13370
2023-04-18,7,1173,1753,3080,4458,5059,15523
2023-04-19,7,2069,872,3769,3667,4160,14537
2023-04-20,7,4194,2321,3719,3212,4222,17668
2023-04-21,7,3840,1795,1392,2470,3868,13365
2023-04-22,7,1799,2275,2738,3552,4493,14857
2023-04-23,7,1304,2896,3477,3678,4906,16261
2023-04-24,7,3114,1307,2763,3430,5226,15840
2023-04-25,7,2388,1157,1253,2908,3690,11396
2023-04-26,7,4561,1774,1485,4036,2495,14351
2023-04-27,7,2722,1625,3012,2974,3458,13791
2023-04-28,7,1584,2880,2980,3136,2182,12762
2023-04-29,7,1115,2717,1296,2785,2732,10645
2023-04-30,7,1994,1814,2999,2303,2617,11727
2023-05-01,7,2570,1140,2897,1785,5228,13620
2023-05-02,7,1292,959,2113,2967,3053,10384
2023-05-03,7,1049,2941,1362,2632,2587,10571
2023-05-04,7,3955,2998,3613,3955,3310,17831
2023-05-05,7,4253,1489,2779,1596,3634,13751
2023-05-06,7,4271,1734,1858,1717,5403,14983
2023-05-07,7,4524,2207,1253,3146,2407,13537
2023-05-08,7,3105,920,1432,3685,5007,14149
2023-05-09,7,2415,2415,3731,3121,3228,14910
2023-05-10,7,4235,1193,2653,3572,4115,15768
2023-05-11,7,4310,1813,2128,3129,5360,16740
2023-05-12,7,3396,1689,1622,2634,3548,12889
2023-05-13,7,3042,2343,3513,2371,4973,16242
2023-05-14,7,2489,935,2441,3286,4641,13792
2023-05-15,7,1269,2009,2214,3833,2403,11728
2023-05-16,7,3577,1857,3395,4191,5020,18040
2023-05-17,7,2072,1009,1865,3340,5499,13785
2023-05-18,7,1036,2928,2956,2328,5139,14387
2023-05-19,7,3639,971,1655,3778,2211,12254
2023-05-20,7,3347,1874,3043,3166,2944,14374
2023-05-21,7,4944,1050,3699,3053,3908,16654
2023-05-22,7,2415,2870,2033,4202,5076,16596
2023-05-23,7,1939,2661,2647,3586,5779,16612
2023-05-24,7,1208,1272,2409,2450,4661,12000
2023-05-25,7,1238,2549,1714,3442,5843,14786
2023-05-26,7,1852,2653,3389,2485,4308,14687
2023-05-27,7,3648,1724,3544,2819,4680,16415
2023-05-28,7,3764,2597,1626,2032,5144,15163
2023-05-29,7,4022,1605,3442,2445,2120,13634
2023-05-30,7,2011,2470,3320,3733,2418,13952
2023-05-31,7,3904,1281,1378,4335,4279,15177
2023-06-01,7,3386,1661,2548,2155,4765,14515
2023-06-02,7,4614,2299,1717,2529,3422,14581
2023-06-03,7,1480,1088,3019,3811,3728,13126
2023-06-04,7,2809,2203,2032,4362,3764,15170
2023-06-05,7,3086,1947,1552,3632,3341,13558
2023-06-06,7,4158,2510,2225,3991,4883,17767
2023-06-07,7,4451,1364,2152,2107,2442,12516
2023-06-08,7,2711,1792,3253,2026,4551,14333
2023-06-09,7,2314,2267,2811,3432,4972,15796
2023-06-10,7,1413,813,1580,2018,2985,8809
2023-06-11,7,4512,1201,2735,1729,3594,13771
2023-06-12,7,1930,2560,1650,2702,3443,12285
2023-06-13,7,3857,1249,2307,3087,3501,14001
2023-06-14,7,2623,1606,2343,3892,5621,16085
2023-06-15,7,4799,881,2244,3737,4117,15778
2023-06-16,7,4241,2046,2401,3316,4564,16568
2023-06-17,7,3782,1737,2372,2325,3125,13341
2023-06-18,7,4937,1521,3584,2560,4243,16845
2023-06-19,7,4063,2759,3862,1816,3102,15602
2023-06-20,7,4966,2195,2607,1667,2531,13966
2023-06-21,7,1256,1551,1988,3417,2375,10587
2023-06-22,7,2299,1466,2435,3062,3270,12532
2023-06-23,7,4696,1655,1668,3429,2284,13732
2023-06-24,7,2170,2127,2483,2143,2992,11915
2023-06-25,7,4556,949,3308,4252,2555,15620
2023-06-26,7,3917,1927,2390,1932,4387,14553
2023-06-27,7,3686,1549,3100,4248,2004,14587
2023-06-28,7,1030,2526,2027,2364,2452,10399
2023-06-29,7,2744,1491,2023,3287,3356,12901
2023-06-30,7,4104,815,1571,2884,2797,12171
2023-07-01,7,1575,1011,1434,1501,4500,10021
2023-07-02,7,1012,2922,1269,2066,4253,11522
2023-07-03,7,4889,1594,3472,2303,5079,17337
2023-07-04,7,3329,1803,1364,2050,3270,11816
2023-07-05,7,1377,990,3473,2753,4930,13523
2023-07-06,7,3466,2478,1847,1971,5725,15487
2023-07-07,7,2117,1613,3877,3464,3692,14763
2023-07-08,7,4074,1248,2511,4259,3487,15579
2023-07-09,7,1767,2517,2296,2527,5111,14218
2023-07-10,7,1210,1507,1553,4489,5708,14467
2023-07-11,7,2941,2828,3776,2946,2085,14576
2023-07-12,7,4421,968,2999,2817,3333,14538
2023-07-13,7,4505,2999,3396,4474,2289,17663
2023-07-14,7,2882,1752,2979,2625,5090,15328
2023-07-15,7,2850,2076,3525,3938,4551,16940
2023-07-16,7,1444,1555,1706,2320,3566,10591
2023-07-17,7,3459,2860,1204,2160,5223,14906
2023-07-18,7,3180,2601,1544,1991,5464,14780
2023-07-19,7,2191,1609,2738,1689,5484,13711
2023-07-20,7,3742,2131,3073,2726,5154,16826
2023-07-21,7,2741,989,3198,3415,4412,14755
2023-07-22,7,3481,2764,3207,2944,4485,16881
2023-07-23,7,4283,2768,2746,1608,4043,15448
2023-07-24,7,1804,869,3120,3749,4361,13903
2023-07-25,7,1317,1592,1570,2312,4080,10871
2023-07-26,7,3563,1364,2228,2743,3783,13681
2023-07-27,7,2449,900,2979,3626,5661,15615
2023-07-28,7,3501,2008,2221,4037,5719,17486
2023-07-29,7,2928,2115,1332,2106,3966,12447
2023-07-30,7,2908,1307,1582,2356,3343,11496
2023-07-31,7,4849,1492,2598,2008,4090,15037
2023-08-01,7,1162,1118,1348,2220,2280,8128
2023-08-02,7,2960,2625,1968,2650,3090,13293
2023-08-03,7,4893,1647,2767,3971,2289,15567
2023-08-04,7,4385,818,3046,3754,2703,14706
2023-08-05,7,3510,954,3680,4260,4123,16527
2023-08-06,7,3938,2748,3997,2773,2407,15863
2023-08-07,7,4324,1489,2224,3303,3238,14578
2023-08-08,7,2835,1844,2092,2472,2301,11544
2023-08-09,7,2548,2022,2211,1654,4672,13107
2023-08-10,7,3473,2281,2092,1637,4482,13965
2023-08-11,7,4745,2121,2646,3163,3996,16671
2023-08-12,7,4029,2512,3374,4367,2750,17032
2023-08-13,7,3129,1844,2257,1696,5699,14625
2023-08-14,7,2007,1666,2592,2002,4652,12919
2023-08-15,7,2027,1102,2388,3742,2391,11650
2023-08-16,7,1053,1139,3895,3813,5949,15849
2023-08-17,7,4739,2347,1394,2220,4806,15506
2023-08-18,7,2038,858,1909,2809,4809,12423
2023-08-19,7,4802,1852,1234,2321,3240,13449
2023-08-20,7,3251,2559,1769,1903,4608,14090
2023-08-21,7,2396,2229,1550,3885,4298,14358
2023-08-22,7,3837,1632,3409,3594,2104,14576
2023-08-23,7,4202,2636,3832,2659,3735,17064
2023-08-24,7,1951,1276,3927,4290,2945,14389
2023-08-25,7,3518,2226,3104,4406,5880,19134
2023-08-26,7,1864,2677,3568,2112,5240,15461
2023-08-27,7,2700,1928,3125,2940,5967,16660
2023-08-28,7,3402,2157,2207,3871,2000,13637
2023-08-29,7,3166,1440,3355,2405,4123,14489
2023-08-30,7,1941,819,2582,4408,2669,12419
2023-08-31,7,2470,2696,3068,4051,4031,16316
2023-09-01,7,4997,2604,1550,3173,2756,15080
2023-09-02,7,3665,2623,2614,3195,2023,14120
2023-09-03,7,4413,2561,1856,4001,2565,15396
2023-09-04,7,3906,2658,1923,4389,2315,15191
2023-09-05,7,3534,2044,1351,3259,3631,13819
2023-09-06,7,2750,1269,1865,2695,4785,13364
2023-09-07,7,2685,1685,3510,1958,5292,15130
2023-09-08,7,4904,1848,2916,2075,2721,14464
2023-09-09,7,2137,1124,2785,3501,4909,14456
2023-09-10,7,3269,1695,3921,1994,2637,13516
2023-09-11,7,3548,1798,2589,3176,4105,15216
2023-09-12,7,1474,1628,3031,1617,3097,10847
2023-09-13,7,3419,844,3608,2881,4727,15479
2023-09-14,7,3966,2393,1444,2921,2354,13078
2023-09-15,7,1891,2412,3178,2798,3369,13648
2023-09-16,7,2922,2122,3118,3025,5091,16278
2023-09-17,7,2962,2266,3721,2340,2992,14281
2023-09-18,7,1276,1881,2564,2590,4579,12890
2023-09-19,7,4577,1445,3316,2683,2463,14484
2023-09-20,7,1717,1743,3419,2891,4870,14640
2023-09-21,7,2422,1684,3845,3711,2072,13734
2023-09-22,7,2580,2486,2055,1536,5322,13979
2023-09-23,7,2044,1368,1484,4356,3091,12343
2023-09-24,7,3494,804,3945,4435,5630,18308
2023-09-25,7,2991,1374,2190,2702,5889,15146
2023-09-26,7,2398,2667,2340,2159,4612,14176
2023-09-27,7,4298,1104,3168,3298,5091,16959
2023-09-28,7,2440,1343,3121,1821,2412,11137
2023-09-29,7,2135,2642,3694,3653,3550,15674
2023-09-30,7,4094,2875,2329,2748,4673,16719
2023-10-01,7,3002,2674,2335,1707,3097,12815
2023-10-02,7,4212,2154,3914,3581,2953,16814
2023-10-03,7,3353,2994,2599,3647,5452,18045
2023-10-04,7,4396,1359,2344,1553,5604,15256
2023-10-05,7,3434,870,3176,2382,4037,13899
2023-10-06,7,1576,2538,3044,2994,2855,13007
2023-10-07,7,3527,1586,3131,2118,2214,12576
2023-10-08,7,3575,826,1890,2796,2994,12081
2023-10-09,7,1934,2762,1720,4431,4458,15305
2023-10-10,7,4032,1350,2333,2193,3864,13772
2023-10-11,7,4729,1367,2219,2425,5364,16104
2023-10-12,7,3534,1383,3446,2832,4295,15490
2023-10-13,7,1500,2811,1389,2507,4435,12642
2023-10-14,7,1233,882,3378,2080,2719,10292
2023-10-15,7,2307,2048,2225,1718,4376,12674
2023-10-16,7,2541,2604,1205,3863,3480,13693
2023-10-17,7,2096,2988,2473,2292,2076,11925
2023-10-18,7,4296,2194,1517,4165,4671,16843
2023-10-19,7,1253,2165,2289,3463,5424,14594
2023-10-20,7,3184,2857,2539,3984,2992,15556
2023-10-21,7,3616,2151,3033,2613,4395,15808
2023-10-22,7,1170,1935,2835,2341,4193,12474
2023-10-23,7,4684,2488,2284,2599,3609,15664
2023-10-24,7,3112,2060,1841,1972,5677,14662
2023-10-25,7,1169,2282,3862,4334,4186,15833
2023-10-26,7,3453,1117,1747,2849,2754,11920
2023-10-27,7,2893,1155,2932,3369,5825,16174
2023-10-28,7,2111,2161,2393,3219,3469,13353
2023-10-29,7,2184,1644,3112,2454,4053,13447
2023-10-30,7,2273,1339,2798,3210,2913,12533
2023-10-31,7,2015,1047,1753,3450,4981,13246
2023-11-01,7,1959,2181,1271,2517,2203,10131
2023-11-02,7,2603,2505,2581,3120,5045,15854
2023-11-03,7,1162,1918,3697,1584,2073,10434
2023-11-04,7,4555,1286,3104,1568,3866,14379
2023-11-05,7,2195,1723,3713,1649,3521,12801
2023-11-06,7,4606,2605,2212,2291,3390,15104
2023-11-07,7,1116,1566,2525,2135,5818,13160
2023-11-08,7,1321,2053,1515,4043,2604,11536
2023-11-09,7,4327,1189,2798,4322,3244,15880
2023-11-10,7,4375,1374,3442,4163,2264,15618
2023-11-11,7,4216,2270,3622,2877,3678,16663
2023-11-12,7,2195,2362,2839,1701,5272,14369
2023-11-13,7,4386,1399,1738,1965,2624,12112
2023-11-14,7,2575,1096,2492,2941,4447,13551
2023-11-15,7,2361,2157,3924,2629,3914,14985
2023-11-16,7,2665,1361,3568,2128,2439,12161
2023-11-17,7,2516,2314,2083,4160,3643,14716
2023-11-18,7,3819,2855,1580,4243,5700,18197
2023-11-19,7,3373,2862,3810,3998,3480,17523
2023-11-20,7,4882,963,1482,1631,3565,12523
2023-11-21,7,2824,1682,3522,2655,2350,13033
2023-11-22,7,1405,1404,2273,3800,2500,11382
2023-11-23,7,1688,2251,1671,1755,5883,13248
2023-11-24,7,2413,1056,2223,3299,5683,14674
2023-11-25,7,3421,1278,2687,3114,5107,15607
2023-11-26,7,4952,1519,3160,3400,4602,17633
2023-11-27,7,1301,1863,2572,1968,5832,13536
2023-11-28,7,3250,1023,3331,2658,2375,12637
2023-11-29,7,3547,1957,3831,2775,3462,15572
2023-11-30,7,2627,2415,3058,3395,3137,14632
2023-12-01,7,3413,1061,2120,1764,5384,13742
2023-12-02,7,1038,1732,3447,3774,3416,13407
2023-12-03,7,2926,1900,3743,3521,2215,14305
2023-12-04,7,1439,1879,3924,3836,3702,14780
2023-12-05,7,3070,2273,1581,2781,4698,14403
2023-12-06,7,4085,2165,2778,1531,5877,16436
2023-12-07,7,1532,2150,3715,2219,4506,14122
2023-12-08,7,2416,2913,2203,2026,4764,14322
2023-12-09,7,2712,911,2096,3739,2354,11812
2023-12-10,7,3062,2121,3320,3693,2715,14911
2023-12-11,7,4330,2639,2281,2643,5643,17536
2023-12-12,7,4060,1871,3399,3710,4957,17997
2023-12-13,7,2960,2559,2668,1527,5973,15687
2023-12-14,7,4847,2525,1903,4449,5558,19282
2023-12-15,7,3238,1963,3170,3946,2954,15271
2023-12-16,7,3106,2518,2769,4177,2880,15450
2023-12-17,7,3822,2162,1831,2372,3999,14186
2023-12-18,7,1904,2529,1727,3356,4674,14190
2023-12-19,7,1421,1448,3894,2484,4694,13941
2023-12-20,7,2919,2984,2322,3453,2905,14583
2023-12-21,7,1663,2682,1355,1512,3499,10711
2023-12-22,7,1447,1182,1575,2112,3376,9692
2023-12-23,7,1627,2761,2679,2938,5152,15157
2023-12-24,7,2227,2398,2119,2565,3102,12411
2023-12-25,7,4552,2557,2941,3576,4826,18452
2023-12-26,7,2984,2953,1639,2843,2917,13336
2023-12-27,7,2300,2692,1800,1949,3992,12733
2023-12-28,7,4056,1427,2228,3341,2881,13933
2023-12-29,7,2864,1803,3770,4104,4175,16716
2023-12-30,7,3705,1611,3706,3381,3112,15515
2023-12-31,7,3217,871,3019,2205,3687,12999
2022-01-01,8,1471,2942,3849,4164,4985,17411
2022-01-02,8,3821,1970,2043,2058,2792,12684
2022-01-03,8,4762,2048,2623,4419,3462,17314
2022-01-04,8,3157,1827,3893,2206,2818,13901
2022-01-05,8,1974,1144,1237,3352,2000,9707
2022-01-06,8,1474,2500,3708,2879,4053,14614
2022-01-07,8,1358,1757,3013,3103,3058,12289
2022-01-08,8,3457,933,1454,4059,3359,13262
2022-01-09,8,3283,2640,2082,4429,2229,14663
2022-01-10,8,3178,2980,1207,1969,3631,12965
2022-01-11,8,3891,1915,1260,2961,3301,13328
2022-01-12,8,3868,2194,2525,1981,3481,14049
2022-01-13,8,3985,2021,2050,1729,3356,13141
2022-01-14,8,1128,1084,1866,3891,5005,12974
2022-01-15,8,4944,2497,2671,3479,2791,16382
2022-01-16,8,4802,2620,2257,3840,2567,16086
2022-01-17,8,3057,2014,2362,2154,5929,15516
2022-01-18,8,2026,2809,2922,4044,4276,16077
2022-01-19,8,1909,2091,2435,4484,5297,16216
2022-01-20,8,2706,876,3137,4123,3912,14754
2022-01-21,8,2838,2791,3207,3549,3258,15643
2022-01-22,8,2382,955,2911,2615,4373,13236
2022-01-23,8,1783,927,1800,4469,5379,14358
2022-01-24,8,1479,2255,1431,3638,3975,12778
2022-01-25,8,1311,1685,1201,2149,5601,11947
2022-01-26,8,4292,2357,2316,3684,2501,15150
2022-01-27,8,4912,2219,2976,4490,5364,19961
2022-01-28,8,3159,2000,1806,4117,2068,13150
2022-01-29,8,3951,1721,1941,2014,2993,12620
2022-01-30,8,1421,1900,3478,3059,2166,12024
2022-01-31,8,3839,2437,2053,4082,5054,17465
2022-02-01,8,2411,1945,3194,2632,3945,14127
2022-02-02,8,4139,1034,2463,3823,5900,17359
2022-02-03,8,4338,2868,3086,4196,4082,18570
2022-02-04,8,2630,1803,3976,2308,5049,15766
2022-02-05,8,2009,2952,2909,2627,3920,14417
2022-02-06,8,3148,2822,3666,1691,4103,15430
2022-02-07,8,3321,1886,2315,4152,2684,14358
2022-02-08,8,4452,2552,2872,3077,5818,18771
2022-02-09,8,2797,2902,3754,4398,5637,19488
2022-02-10,8,4913,1115,1457,2180,4010,13675
2022-02-11,8,2137,2022,2942,2836,2045,11982
2022-02-12,8,1747,1654,2108,3364,5022,13895
2022-02-13,8,3611,2504,3345,1636,2444,13540
2022-02-14,8,2461,2640,3661,2436,2807,14005
2022-02-15,8,1488,1998,3585,1749,2843,11663
2022-02-16,8,1772,2986,2165,3980,3848,14751
2022-02-17,8,1091,2635,3588,3245,4638,15197
2022-02-18,8,2916,1138,1375,3317,3368,12114
2022-02-19,8,4946,1107,1337,3747,3513,14650
2022-02-20,8,4880,2108,2223,2214,3012,14437
2022-02-21,8,3909,1009,3534,2290,2485,13227
2022-02-22,8,4320,930,2024,2236,5054,14564
2022-02-23,8,4852,2573,3562,1704,4761,17452
2022-02-24,8,2203,1947,2692,3106,5616,15564
2022-02-25,8,4343,2103,2963,3515,2041,14965
2022-02-26,8,4245,2298,2411,2747,2593,14294
2022-02-27,8,1329,1659,2954,4474,2942,13358
2022-02-28,8,4195,1072,3923,2724,5522,17436
2022-03-01,8,1216,2496,3195,2160,4324,13391
2022-03-02,8,4482,2815,2702,2366,4826,17191
2022-03-03,8,1119,1283,1298,2288,3269,9257
2022-03-04,8,3560,2521,3880,3795,5633,19389
2022-03-05,8,3761,2273,2140,3582,3033,14789
2022-03-06,8,1548,862,3012,3417,3079,11918
2022-03-07,8,3065,1720,2526,2233,3898,13442
2022-03-08,8,4006,1777,3876,3689,5874,19222
2022-03-09,8,4265,1196,2365,4251,4165,16242
2022-03-10,8,3145,1206,1319,3358,3605,12633
2022-03-11,8,3628,2612,3861,1613,3072,14786
2022-03-12,8,1814,1282,3583,4127,2623,13429
2022-03-13,8,4830,1955,3733,2179,5165,17862
2022-03-14,8,1086,942,1629,4157,4715,12529
2022-03-15,8,3939,2511,2263,4478,3491,16682
2022-03-16,8,3684,2689,3563,4161,2003,16100
2022-03-17,8,3907,1397,3794,2610,5376,17084
2022-03-18,8,1569,1833,3092,3739,4795,15028
2022-03-19,8,4057,2622,2845,4386,3201,17111
2022-03-20,8,1472,1955,3010,2827,2126,11390
2022-03-21,8,2073,2796,3470,4100,2785,15224
2022-03-22,8,2937,1318,3210,4337,5874,17676
2022-03-23,8,2608,1263,2216,2958,5070,14115
2022-03-24,8,4797,1140,2090,1704,4830,14561
2022-03-25,8,3030,2678,1448,1836,4756,13748
2022-03-26,8,3458,2670,1729,3561,2645,14063
2022-03-27,8,3733,2123,3391,3917,3678,16842
2022-03-28,8,4623,2831,3483,3707,4971,19615
2022-03-29,8,4595,2362,3002,4224,3540,17723
2022-03-30,8,4066,2024,3869,1502,5415,16876
2022-03-31,8,1845,2849,3867,3503,6000,18064
2022-04-01,8,4886,2182,2989,3075,4390,17522
2022-04-02,8,2641,1002,3357,2023,4515,13538
2022-04-03,8,3512,1205,3573,2273,4591,15154
2022-04-04,8,2963,1641,2609,2418,5816,15447
2022-04-05,8,4140,947,1592,2250,4716,13645
2022-04-06,8,1101,2833,3920,3746,3607,15207
2022-04-07,8,4118,1395,3899,3540,5680,18632
2022-04-08,8,1988,1396,2702,3025,4642,13753
2022-04-09,8,1523,1735,3605,2357,4020,13240
2022-04-10,8,2148,955,3485,2348,5992,14928
2022-04-11,8,2857,2449,3273,3506,3246,15331
2022-04-12,8,2500,1514,2798,2871,2783,12466
2022-04-13,8,3069,2756,1650,2355,5682,15512
2022-04-14,8,3074,1273,1875,3721,4139,14082
2022-04-15,8,4439,1507,3583,4432,3198,17159
2022-04-16,8,2589,1942,2911,4041,3516,14999
2022-04-17,8,2689,1576,1371,1944,2317,9897
2022-04-18,8,2301,2740,1701,3305,3598,13645
2022-04-19,8,3915,970,1275,3115,4327,13602
2022-04-20,8,1393,1021,3374,3636,4112,13536
2022-04-21,8,3043,1571,1316,3849,2920,12699
2022-04-22,8,3470,2660,3690,1538,2359,13717
2022-04-23,8,3587,1779,2072,3323,4991,15752
2022-04-24,8,4317,1597,2327,3867,2957,15065
2022-04-25,8,4234,2185,2940,4427,5612,19398
2022-04-26,8,4526,1907,1289,1508,4034,13264
2022-04-27,8,1844,2341,3090,3925,2157,13357
2022-04-28,8,3572,2674,2443,4270,5732,18691
2022-04-29,8,3573,2016,1811,4141,4194,15735
2022-04-30,8,3988,1426,3429,3978,5993,18814
2022-05-01,8,2445,1774,3107,1889,4270,13485
2022-05-02,8,3355,2417,1347,1638,2248,11005
2022-05-03,8,2871,800,1859,2575,5584,13689
2022-05-04,8,2010,2123,2086,4085,5791,16095
2022-05-05,8,4787,2756,3629,3896,4810,19878
2022-05-06,8,3293,998,3397,1699,4579,13966
2022-05-07,8,4036,2948,2695,4360,4972,19011
2022-05-08,8,2945,2479,1343,4484,4616,15867
2022-05-09,8,3161,2166,1644,3221,5846,16038
2022-05-10,8,1178,1675,2478,3032,5726,14089
2022-05-11,8,1476,838,2849,3047,3881,12091
2022-05-12,8,1066,904,2189,2641,2847,9647
2022-05-13,8,4644,1050,3263,4439,4060,17456
2022-05-14,8,1458,1734,3681,3413,5691,15977
2022-05-15,8,2704,2173,2597,3762,5355,16591
2022-05-16,8,2497,1090,1384,2325,2125,9421
2022-05-17,8,1530,1751,1833,3256,2839,11209
2022-05-18,8,2681,1508,1694,3858,4646,14387
2022-05-19,8,1095,2638,3307,1537,2475,11052
2022-05-20,8,1390,2551,2802,3184,3036,12963
2022-05-21,8,2827,2174,3505,3954,4659,17119
2022-05-22,8,2239,2025,2212,2960,2661,12097
2022-05-23,8,2136,835,1293,3574,4265,12103
2022-05-24,8,2471,2551,1760,3553,2701,13036
2022-05-25,8,1255,1954,3257,4389,5227,16082
2022-05-26,8,3107,2505,2243,3614,5618,17087
2022-05-27,8,4008,941,3026,4431,5509,17915
2022-05-28,8,3562,1207,2265,4409,3864,15307
2022-05-29,8,2356,2988,3772,4401,5967,19484
2022-05-30,8,1399,2715,1624,1522,5717,12977
2022-05-31,8,3548,2145,2327,4480,4023,16523
2022-06-01,8,4676,2789,3448,4015,2906,17834
2022-06-02,8,2425,2796,2557,4201,5329,17308
2022-06-03,8,1458,1384,3949,2346,3120,12257
2022-06-04,8,2130,2406,1495,4193,4936,15160
2022-06-05,8,3947,2076,3987,3976,5398,19384
2022-06-06,8,1990,2302,2080,4470,3656,14498
2022-06-07,8,1200,1173,1233,3728,2645,9979
2022-06-08,8,4950,2049,3767,3640,5473,19879
2022-06-09,8,3551,1581,2500,1614,4590,13836
2022-06-10,8,3108,910,2576,3929,2876,13399
2022-06-11,8,2181,2148,2331,1820,2167,10647
2022-06-12,8,4829,1149,2502,2164,5774,16418
2022-06-13,8,2892,1723,2896,3683,4192,15386
2022-06-14,8,4411,2157,2525,1615,4897,15605
2022-06-15,8,2155,1418,4000,2209,4320,14102
2022-06-16,8,1603,2479,1293,3922,3188,12485
2022-06-17,8,4173,1898,3994,2616,2965,15646
2022-06-18,8,1505,2394,2692,3044,3302,12937
2022-06-19,8,1523,976,3196,2637,4450,12782
2022-06-20,8,4825,2922,3164,3847,5902,20660
2022-06-21,8,2920,1104,2423,2594,2570,11611
2022-06-22,8,2435,1860,1367,3863,3756,13281
2022-06-23,8,4157,2395,3088,2069,2354,14063
2022-06-24,8,2997,831,2432,1556,2985,10801
2022-06-25,8,1368,977,3727,2176,3408,11656
2022-06-26,8,1962,2941,3164,3949,3912,15928
2022-06-27,8,3285,2973,3967,1603,4180,16008
2022-06-28,8,4231,1929,2705,1900,4942,15707
2022-06-29,8,1005,1644,3726,4230,4476,15081
2022-06-30,8,3451,1155,4000,2551,4056,15213
2022-07-01,8,4017,1741,2249,3898,2913,14818
2022-07-02,8,4796,1605,3617,3746,3818,17582
2022-07-03,8,4581,837,3282,1827,5169,15696
2022-07-04,8,2577,1715,3667,1983,4800,14742
2022-07-05,8,4524,933,3329,3645,2440,14871
2022-07-06,8,4706,1494,3782,2151,4969,17102
2022-07-07,8,3580,2682,1704,1635,2587,12188
2022-07-08,8,3289,2772,1937,1583,5382,14963
2022-07-09,8,4199,2625,3669,3217,3822,17532
2022-07-10,8,4187,2159,2929,1572,2966,13813
2022-07-11,8,4462,963,3907,3220,4422,16974
2022-07-12,8,1580,2645,2072,2828,4829,13954
2022-07-13,8,3209,1369,1317,1727,5360,12982
2022-07-14,8,2571,1151,2309,4422,3675,14128
2022-07-15,8,2487,2031,2850,2804,4664,14836
2022-07-16,8,2585,1063,3235,2077,2347,11307
2022-07-17,8,1158,1533,3449,3896,5133,15169
2022-07-18,8,4979,1450,2001,3612,3420,15462
2022-07-19,8,3281,2321,3735,1910,2652,13899
2022-07-20,8,4486,1988,2650,3720,2970,15814
2022-07-21,8,1218,810,3337,2661,3986,12012
2022-07-22,8,3985,2913,2227,3926,2237,15288
2022-07-23,8,1967,2580,2482,3529,4356,14914
2022-07-24,8,4753,1234,2581,3541,5418,17527
2022-07-25,8,2657,1782,2573,3382,4671,15065
2022-07-26,8,4021,2378,2606,2134,2250,13389
2022-07-27,8,1769,1499,3777,4134,3305,14484
2022-07-28,8,4585,2919,3843,2207,2968,16522
2022-07-29,8,2453,882,2187,3239,5115,13876
2022-07-30,8,4912,2433,2725,2156,4515,16741
2022-07-31,8,1336,1590,1835,1750,2211,8722
2022-08-01,8,4357,2239,3540,1752,2563,14451
2022-08-02,8,2345,2515,3816,2616,5611,16903
2022-08-03,8,1432,1354,3400,4155,5997,16338
2022-08-04,8,1947,874,2329,2674,5541,13365
2022-08-05,8,4617,1397,2252,4243,3643,16152
2022-08-06,8,2421,2502,2231,3043,5993,16190
2022-08-07,8,1046,1663,2719,4240,3416,13084
2022-08-08,8,1015,2244,2631,3182,5921,14993
2022-08-09,8,2478,2327,1634,4481,3922,14842
2022-08-10,8,2394,2296,3757,3024,2576,14047
2022-08-11,8,2845,1891,3984,3405,4503,16628
2022-08-12,8,4262,1939,1720,2640,4039,14600
2022-08-13,8,2981,2604,2389,1826,5634,15434
2022-08-14,8,4616,2401,2159,2690,2245,14111
2022-08-15,8,2055,1043,1983,2077,4763,11921
2022-08-16,8,3448,2216,1680,4454,5231,17029
2022-08-17,8,3203,1353,1280,3199,2793,11828
2022-08-18,8,4999,1355,3763,3596,3345,17058
2022-08-19,8,1234,1348,1992,4386,4097,13057
2022-08-20,8,2081,1530,2202,3128,3118,12059
2022-08-21,8,4686,1740,2815,2031,3168,14440
2022-08-22,8,1135,2020,1736,1767,5642,12300
2022-08-23,8,1098,971,1576,3113,2699,9457
2022-08-24,8,4414,2540,2114,4133,2030,15231
2022-08-25,8,1656,1510,2100,3253,3462,11981
2022-08-26,8,2696,2874,2369,2228,5614,15781
2022-08-27,8,2443,2071,1536,3570,5377,14997
2022-08-28,8,2252,2463,3455,3907,2281,14358
2022-08-29,8,4126,2716,2178,2785,2558,14363
2022-08-30,8,2737,1428,2620,3936,4529,15250
2022-08-31,8,2123,1853,2984,1930,2771,11661
2022-09-01,8,3800,2954,1448,3388,4944,16534
2022-09-02,8,1119,1387,2122,2462,4407,11497
2022-09-03,8,1590,2974,1461,4315,5513,15853
2022-09-04,8,2279,2950,3701,1506,2758,13194
2022-09-05,8,4158,1737,3113,1827,5258,16093
2022-09-06,8,4826,2755,1412,1535,5790,16318
2022-09-07,8,2060,2218,3539,4376,2204,14397
2022-09-08,8,4254,2271,2550,2676,3061,14812
2022-09-09,8,3572,1245,1306,2490,2780,11393
2022-09-10,8,3229,1245,3802,4356,2076,14708
2022-09-11,8,3882,2777,2515,1859,5877,16910
2022-09-12,8,4738,2713,2779,3861,2205,16296
2022-09-13,8,4292,2845,2537,2164,5670,17508
2022-09-14,8,2365,1594,3912,3959,3296,15126
2022-09-15,8,2925,2458,3475,3565,5228,17651
2022-09-16,8,1562,1736,3014,1819,4736,12867
2022-09-17,8,1153,1692,2677,3134,5163,13819
2022-09-18,8,2976,1847,2054,3367,5041,15285
2022-09-19,8,2502,2468,2221,4427,3036,14654
2022-09-20,8,2379,1805,2409,3812,4859,15264
2022-09-21,8,4228,1900,3400,3545,3091,16164
2022-09-22,8,1930,1486,2401,1994,3466,11277
2022-09-23,8,3291,2883,2962,4373,3353,16862
2022-09-24,8,2083,1935,2534,3993,2832,13377
2022-09-25,8,3847,2812,2552,2055,2471,13737
2022-09-26,8,1124,1235,2869,3801,4199,13228
2022-09-27,8,4411,2246,3925,1837,4240,16659
2022-09-28,8,3658,985,1595,4414,2030,12682
2022-09-29,8,4139,2861,2944,3564,2178,15686
2022-09-30,8,4622,2611,1803,3718,5378,18132
2022-10-01,8,3045,1758,2875,1888,3206,12772
2022-10-02,8,3247,1253,2129,1843,5462,13934
2022-10-03,8,1833,1308,3514,3627,5314,15596
2022-10-04,8,4614,2641,3388,2318,2982,15943
2022-10-05,8,3802,1461,2811,1512,5490,15076
2022-10-06,8,1829,882,2237,1770,4896,11614
2022-10-07,8,3229,1188,3513,4409,5104,17443
2022-10-08,8,4167,1487,3363,2017,4861,15895
2022-10-09,8,1630,1623,3750,4013,5226,16242
2022-10-10,8,2203,859,3809,4044,5221,16136
2022-10-11,8,2069,2736,2493,2404,4216,13918
2022-10-12,8,3904,2966,3330,3498,5040,18738
2022-10-13,8,3921,1344,1339,3943,2465,13012
2022-10-14,8,1632,1253,1970,3353,3309,11517
2022-10-15,8,2548,2123,2728,1523,4002,12924
2022-10-16,8,3254,1569,1997,2062,5588,14470
2022-10-17,8,2252,2415,1792,3461,3376,13296
2022-10-18,8,3875,934,2960,2106,4325,14200
2022-10-19,8,3201,2485,3832,4229,2769,16516
2022-10-20,8,1943,2657,3870,3271,3278,15019
2022-10-21,8,2643,1827,1867,3762,2711,12810
2022-10-22,8,2626,2913,3501,3396,2583,15019
2022-10-23,8,1991,2417,3975,3667,4480,16530
2022-10-24,8,2169,1114,3938,1764,4101,13086
2022-10-25,8,3491,1476,1834,3392,3732,13925
2022-10-26,8,1128,1938,1374,3413,3292,11145
2022-10-27,8,2240,1933,3004,3909,3568,14654
2022-10-28,8,2424,2643,1774,4291,2402,13534
2022-10-29,8,2027,1139,2101,2125,4810,12202
2022-10-30,8,1133,1467,2546,1799,2693,9638
2022-10-31,8,1594,1570,3683,4251,2733,13831
2022-11-01,8,3655,1727,2471,4420,5687,17960
2022-11-02,8,3974,2495,2176,1988,5729,16362
2022-11-03,8,4939,2330,1979,2808,4074,16130
2022-11-04,8,3235,1562,3329,3188,3936,15250
2022-11-05,8,1853,2590,2445,3648,2137,12673
2022-11-06,8,4350,1407,2507,2740,5222,16226
2022-11-07,8,4333,2230,3875,4163,5553,20154
2022-11-08,8,4586,2985,2130,3491,5631,18823
2022-11-09,8,3785,807,2296,3514,3337,13739
2022-11-10,8,2680,2924,2646,4239,5735,18224
2022-11-11,8,3517,2420,3005,3964,2698,15604
2022-11-12,8,2809,2880,2568,3290,4363,15910
2022-11-13,8,3670,2518,2602,1976,2454,13220
2022-11-14,8,3066,1434,3255,2261,4680,14696
2022-11-15,8,3408,905,3639,2432,2494,12878
2022-11-16,8,3820,1442,1483,4109,4520,15374
2022-11-17,8,2010,2935,2925,3978,3628,15476
2022-11-18,8,2736,2909,2255,2073,3522,13495
2022-11-19,8,4063,1180,3090,3085,4171,15589
2022-11-20,8,2022,1132,2109,3030,4661,12954
2022-11-21,8,2497,2541,3421,3830,4469,16758
2022-11-22,8,3593,1390,2162,4240,2340,13725
2022-11-23,8,4203,2058,3653,2061,5585,17560
2022-11-24,8,3160,2415,3426,1583,2140,12724
2022-11-25,8,1797,1740,2963,3143,2448,12091
2022-11-26,8,2951,2690,1815,2200,5857,15513
2022-11-27,8,2801,2156,3349,1904,4155,14365
2022-11-28,8,4180,2559,2398,2858,4299,16294
2022-11-29,8,3253,1404,1737,1760,5843,13997
2022-11-30,8,4197,1987,2718,3105,2357,14364
2022-12-01,8,1392,1329,2339,2215,4002,11277
2022-12-02,8,3421,2867,2046,3646,2558,14538
2022-12-03,8,1397,1229,1494,1949,2351,8420
2022-12-04,8,1456,2299,3040,3355,5897,16047
2022-12-05,8,2222,2991,2294,2049,2694,12250
2022-12-06,8,2841,2702,3643,4381,4153,17720
2022-12-07,8,2400,2166,2581,2661,3844,13652
2022-12-08,8,2982,1935,3840,2522,4091,15370
2022-12-09,8,4817,2567,1605,1975,2808,13772
2022-12-10,8,2233,807,1250,1954,5304,11548
2022-12-11,8,2452,2107,3253,3408,3268,14488
2022-12-12,8,4690,1179,2647,3462,2695,14673
2022-12-13,8,2038,1747,3157,1763,5893,14598
2022-12-14,8,1229,2625,2162,3220,5203,14439
2022-12-15,8,4608,2583,3226,4049,4815,19281
2022-12-16,8,1318,2781,2184,1950,5482,13715
2022-12-17,8,2263,1669,2524,1907,5984,14347
2022-12-18,8,4470,1264,2597,1643,4633,14607
2022-12-19,8,1360,1529,1658,1989,3082,9618
2022-12-20,8,4407,2045,2798,4313,4045,17608
2022-12-21,8,3018,2362,1411,1670,2523,10984
2022-12-22,8,4573,1407,1719,2748,3493,13940
2022-12-23,8,2679,1727,3286,3956,3598,15246
2022-12-24,8,1108,1875,3631,3661,2880,13155
2022-12-25,8,1255,2522,1992,3354,3414,12537
2022-12-26,8,1211,802,2593,2380,3103,10089
2022-12-27,8,2773,1975,3191,2783,5174,15896
2022-12-28,8,1614,912,1583,1684,2799,8592
2022-12-29,8,1532,1370,2029,1852,3544,10327
2022-12-30,8,2685,2442,1266,4186,3537,14116
2022-12-31,8,1287,2803,2559,2313,5236,14198
2023-01-01,8,2451,2581,1534,1765,3454,11785
2023-01-02,8,3578,1685,1205,3657,3006,13131
2023-01-03,8,3131,2294,1846,3825,2497,13593
2023-01-04,8,1501,2711,2962,3353,3012,13539
2023-01-05,8,4942,1716,2901,3439,3354,16352
2023-01-06,8,2726,2148,1360,1743,4166,12143
2023-01-07,8,3100,1153,3583,2964,5369,16169
2023-01-08,8,4378,2094,3128,4040,4295,17935
2023-01-09,8,4564,1884,2748,3752,3089,16037
2023-01-10,8,3031,2378,3793,1597,5388,16187
2023-01-11,8,1643,1010,1305,4468,2947,11373
2023-01-12,8,1601,2519,1481,3871,5511,14983
2023-01-13,8,2551,2259,2865,3081,3693,14449
2023-01-14,8,4686,1965,3912,4402,3479,18444
2023-01-15,8,3425,2655,2634,2243,5350,16307
2023-01-16,8,3338,1444,3590,2927,3187,14486
2023-01-17,8,2653,2752,3937,2337,4923,16602
2023-01-18,8,2228,2084,3797,2811,2887,13807
2023-01-19,8,1115,1584,2080,2161,3590,10530
2023-01-20,8,1245,1771,2401,3168,5699,14284
2023-01-21,8,4662,872,1597,2753,5776,15660
2023-01-22,8,3850,1230,3268,4075,5024,17447
2023-01-23,8,2834,2822,3226,2544,3001,14427
2023-01-24,8,4482,830,2188,2733,4145,14378
2023-01-25,8,4167,2029,2382,3300,4986,16864
2023-01-26,8,3469,919,2253,2548,5188,14377
2023-01-27,8,4801,2117,2883,3249,2034,15084
2023-01-28,8,4309,1899,3809,2527,4703,17247
2023-01-29,8,2834,2640,1614,1664,5596,14348
2023-01-30,8,4581,2170,2695,3211,5158,17815
2023-01-31,8,4647,2122,3979,2451,3713,16912
2023-02-01,8,1261,2298,2659,2583,4899,13700
2023-02-02,8,1927,2681,2726,4019,3175,14528
2023-02-03,8,1817,2937,1294,2580,5576,14204
2023-02-04,8,4173,1236,2168,3233,4410,15220
2023-02-05,8,3377,1295,3668,4163,5254,17757
2023-02-06,8,1471,1583,1277,1807,4448,10586
2023-02-07,8,2096,957,2182,3630,4095,12960
2023-02-08,8,1003,1633,2507,2801,5746,13690
2023-02-09,8,4557,1698,2490,3308,5170,17223
2023-02-10,8,2273,846,2339,3711,5172,14341
2023-02-11,8,1658,2638,1723,3599,3648,13266
2023-02-12,8,4884,1694,2336,2152,4167,15233
2023-02-13,8,4453,2726,2844,1794,5487,17304
2023-02-14,8,1392,2450,3138,2256,2828,12064
2023-02-15,8,3794,1316,2234,2085,3031,12460
2023-02-16,8,3933,1055,3286,2406,5025,15705
2023-02-17,8,3218,2651,1510,2110,2428,11917
2023-02-18,8,2842,1880,1965,2528,3300,12515
2023-02-19,8,2043,1658,1267,3151,4523,12642
2023-02-20,8,4235,2066,2842,2171,3243,14557
2023-02-21,8,1553,2133,3078,1508,4593,12865
2023-02-22,8,2954,1403,1577,3468,2673,12075
2023-02-23,8,2217,1768,2106,1633,3339,11063
2023-02-24,8,1781,1585,3441,2666,5773,15246
2023-02-25,8,1040,1198,2775,4084,5484,14581
2023-02-26,8,2903,2889,2750,2498,4778,15818
2023-02-27,8,2388,2944,3754,2563,4729,16378
2023-02-28,8,3240,985,3531,3245,4266,15267
2023-03-01,8,3666,1672,2241,3302,5162,16043
2023-03-02,8,4207,2410,2129,4254,5243,18243
2023-03-03,8,1420,1952,3399,2609,4844,14224
2023-03-04,8,3977,1317,3038,2497,2533,13362
2023-03-05,8,4429,833,1503,4212,2609,13586
2023-03-06,8,4433,1599,1247,2520,4716,14515
2023-03-07,8,1299,898,1389,4294,2055,9935
2023-03-08,8,2851,2162,2770,4221,2428,14432
2023-03-09,8,1573,880,2599,4068,2206,11326
2023-03-10,8,3893,2253,1385,1756,4853,14140
2023-03-11,8,4580,1272,3134,4319,5572,18877
2023-03-12,8,1273,2191,3593,3112,3906,14075
2023-03-13,8,3501,1128,1944,2867,2858,12298
2023-03-14,8,4073,1028,1567,3618,2614,12900
2023-03-15,8,1056,2867,2135,3986,3698,13742
2023-03-16,8,3127,2628,1449,3434,5024,15662
2023-03-17,8,3020,2594,3228,2744,2471,14057
2023-03-18,8,1001,1988,1569,3268,3215,11041
2023-03-19,8,3521,971,2100,1960,5716,14268
2023-03-20,8,3290,1351,3423,3247,5417,16728
2023-03-21,8,1874,1958,3677,3191,5351,16051
2023-03-22,8,1965,2109,3678,3083,5737,16572
2023-03-23,8,3004,2950,2516,4086,3164,15720
2023-03-24,8,2386,1615,2099,2717,2292,11109
2023-03-25,8,2099,1464,2116,3865,4635,14179
2023-03-26,8,3172,1270,1579,3383,3228,12632
2023-03-27,8,4179,1471,3422,3510,4081,16663
2023-03-28,8,1385,1812,3505,3553,3983,14238
2023-03-29,8,4689,2610,2398,3286,2710,15693
2023-03-30,8,2329,2805,1594,2569,4905,14202
2023-03-31,8,3366,2924,3471,1884,5976,17621
2023-04-01,8,3738,2639,2884,4432,4320,18013
2023-04-02,8,2339,2273,1226,3408,3941,13187
2023-04-03,8,4244,1582,3440,1587,2657,13510
2023-04-04,8,2586,2896,3442,3123,3604,15651
2023-04-05,8,3076,1843,3948,1961,2932,13760
2023-04-06,8,2675,930,2721,1610,3228,11164
2023-04-07,8,3571,2220,1760,3501,5996,17048
2023-04-08,8,3564,1677,3838,2444,5542,17065
2023-04-09,8,4449,2453,3442,3615,4024,17983
2023-04-10,8,3258,2309,3259,1833,5431,16090
2023-04-11,8,2917,1528,2645,2732,4446,14268
2023-04-12,8,4833,2822,3159,4121,5262,20197
2023-04-13,8,4520,2293,2737,1761,2698,14009
2023-04-14,8,4149,2375,3704,2341,3689,16258
2023-04-15,8,2908,2298,3814,3732,4485,17237
2023-04-16,8,2018,1682,1667,3638,2467,11472
2023-04-17,8,2274,2453,3484,1890,4245,14346
2023-04-18,8,1592,1223,2659,2926,5807,14207
2023-04-19,8,4784,1826,2628,3530,5533,18301
2023-04-20,8,3028,869,2507,2896,3219,12519
2023-04-21,8,3760,813,2911,3566,5355,16405
2023-04-22,8,4771,2688,3216,1895,2298,14868
2023-04-23,8,3849,960,3655,3107,2060,13631
2023-04-24,8,4037,1693,2075,3940,4405,16150
2023-04-25,8,3998,2254,1268,2279,5822,15621
2023-04-26,8,1195,1924,2040,1951,5127,12237
2023-04-27,8,1803,1555,3077,2962,3865,13262
2023-04-28,8,1992,2332,3774,3397,5238,16733
2023-04-29,8,2509,1431,2037,3897,4378,14252
2023-04-30,8,4329,942,2460,2704,4536,14971
2023-05-01,8,2311,2579,2919,1679,2024,11512
2023-05-02,8,1453,1435,2802,2446,5932,14068
2023-05-03,8,2463,2810,1533,3330,3465,13601
2023-05-04,8,3228,1238,2458,2777,5941,15642
2023-05-05,8,2282,2647,2960,4233,4096,16218
2023-05-06,8,4684,1172,3536,2710,2056,14158
2023-05-07,8,1999,2603,3661,2506,5556,16325
2023-05-08,8,1653,1422,2519,4111,4781,14486
2023-05-09,8,3186,1212,1800,2082,4075,12355
2023-05-10,8,3241,2275,3625,2099,4171,15411
2023-05-11,8,2406,1904,1787,2001,4344,12442
2023-05-12,8,3403,1386,1652,2033,3587,12061
2023-05-13,8,1653,2045,2493,4051,5116,15358
2023-05-14,8,1486,1663,1858,2631,3258,10896
2023-05-15,8,3583,1713,2823,2326,2288,12733
2023-05-16,8,1580,2916,2193,3657,4650,14996
2023-05-17,8,3375,1743,3784,4186,2273,15361
2023-05-18,8,1547,2197,1417,1882,5795,12838
2023-05-19,8,2115,2500,1533,1718,5180,13046
2023-05-20,8,3331,1178,2121,4413,4494,15537
2023-05-21,8,3426,801,1918,4333,5225,15703
2023-05-22,8,4365,2999,3748,3154,3445,17711
2023-05-23,8,2505,2516,1960,3454,3607,14042
2023-05-24,8,2359,2710,3376,2514,2829,13788
2023-05-25,8,4770,2930,1600,2247,5255,16802
2023-05-26,8,4413,1210,1422,1555,4535,13135
2023-05-27,8,3851,1555,3966,4462,5897,19731
2023-05-28,8,1423,1162,1439,1944,2330,8298
2023-05-29,8,1970,921,1980,3772,4225,12868
2023-05-30,8,3255,2492,1227,4344,4084,15402
2023-05-31,8,1509,868,2005,4448,3365,12195
2023-06-01,8,2963,2139,1233,3771,2613,12719
2023-06-02,8,4903,2754,3409,4488,3220,18774
2023-06-03,8,1231,2026,2757,3754,5832,15600
2023-06-04,8,3991,1917,2778,4045,3658,16389
2023-06-05,8,3391,1203,2708,3620,4705,15627
2023-06-06,8,4972,2257,1448,3610,5412,17699
2023-06-07,8,2548,1812,3992,2596,2927,13875
2023-06-08,8,4910,1128,2880,3754,3978,16650
2023-06-09,8,1518,2967,3259,3659,4051,15454
2023-06-10,8,1902,1504,2037,4192,3881,13516
2023-06-11,8,4411,1978,1773,2985,3374,14521
2023-06-12,8,2114,2351,2750,1683,5698,14596
2023-06-13,8,1786,1512,3960,2620,3216,13094
2023-06-14,8,4322,2252,2228,1874,2110,12786
2023-06-15,8,3126,2258,2387,3299,5529,16599
2023-06-16,8,2733,1108,1400,4050,4919,14210
2023-06-17,8,4163,1477,3888,4329,2524,16381
2023-06-18,8,2087,2452,3183,3118,2692,13532
2023-06-19,8,1949,1073,3266,2611,4241,13140
2023-06-20,8,4076,1399,2664,2232,3484,13855
2023-06-21,8,2290,2062,2593,4478,4602,16025
2023-06-22,8,3117,2197,3431,4022,5843,18610
2023-06-23,8,1039,1658,2731,3276,2686,11390
2023-06-24,8,3153,1372,2784,4394,5467,17170
2023-06-25,8,3628,1124,1926,4267,4558,15503
2023-06-26,8,4155,2664,1453,4062,5522,17856
2023-06-27,8,2779,2426,2879,2107,4606,14797
2023-06-28,8,4325,863,3911,2799,2747,14645
2023-06-29,8,2930,1274,2633,3010,2162,12009
2023-06-30,8,3685,2473,2403,1661,4633,14855
2023-07-01,8,2127,2953,2102,1907,2990,12079
2023-07-02,8,1849,2299,3550,2287,4623,14608
2023-07-03,8,4209,2749,3283,2708,4552,17501
2023-07-04,8,4762,1486,3162,1810,4958,16178
2023-07-05,8,4204,2233,2245,3960,5591,18233
2023-07-06,8,2584,2946,1757,2770,2252,12309
2023-07-07,8,2500,2334,2308,4185,5244,16571
2023-07-08,8,3388,2912,2442,2516,2503,13761
2023-07-09,8,4843,2589,2665,2418,4904,17419
2023-07-10,8,3964,2071,3652,1856,5085,16628
2023-07-11,8,3508,2085,3452,3151,4705,16901
2023-07-12,8,1549,2716,1710,3402,3472,12849
2023-07-13,8,1425,896,3299,3006,4590,13216
2023-07-14,8,3096,2021,1892,4136,2402,13547
2023-07-15,8,1469,931,2746,2080,2739,9965
2023-07-16,8,4469,2316,3110,3084,2166,15145
2023-07-17,8,4954,1620,3530,1551,5007,16662
2023-07-18,8,4135,2497,3636,2810,2856,15934
2023-07-19,8,3609,1309,1285,1929,4750,12882
2023-07-20,8,2237,2397,3048,2897,3192,13771
2023-07-21,8,4472,2814,1772,1635,3746,14439
2023-07-22,8,3060,2081,2524,2700,2273,12638
2023-07-23,8,1451,2577,2439,2650,2133,11250
2023-07-24,8,2894,2931,2693,4153,3599,16270
2023-07-25,8,2891,2695,1548,2536,5385,15055
2023-07-26,8,3689,2768,3284,3013,5969,18723
2023-07-27,8,3288,1357,3878,3277,3760,15560
2023-07-28,8,1963,1719,1563,2227,4803,12275
2023-07-29,8,3413,1076,3891,4302,5321,18003
2023-07-30,8,1846,1160,3324,4488,4924,15742
2023-07-31,8,2929,2310,1253,2959,2329,11780
2023-08-01,8,4982,1577,2551,2239,5915,17264
2023-08-02,8,3060,1022,3473,2810,2171,12536
2023-08-03,8,2079,2936,3400,4301,2523,15239
2023-08-04,8,2261,1259,2492,3627,3926,13565
2023-08-05,8,2662,2337,2312,3611,5033,15955
2023-08-06,8,4108,2524,2158,3887,3297,15974
2023-08-07,8,3718,2008,2945,3726,5876,18273
2023-08-08,8,2649,1533,3723,2505,5985,16395
2023-08-09,8,1751,1822,2036,2253,3720,11582
2023-08-10,8,1313,1409,2019,3175,4506,12422
2023-08-11,8,3174,2438,2141,3359,3185,14297
2023-08-12,8,2889,2879,2902,4180,5821,18671
2023-08-13,8,1327,1446,3854,3174,5562,15363
2023-08-14,8,2203,2618,2365,1866,5997,15049
2023-08-15,8,2614,2806,1928,3151,2184,12683
2023-08-16,8,3504,1070,3245,3284,4483,15586
2023-08-17,8,2917,2909,3937,4221,3939,17923
2023-08-18,8,3454,2140,3293,4306,5992,19185
2023-08-19,8,2135,2691,2895,3041,5087,15849
2023-08-20,8,3005,2507,3540,2400,2266,13718
2023-08-21,8,3169,1652,2269,1801,3673,12564
2023-08-22,8,3867,1158,1886,1931,5651,14493
2023-08-23,8,1551,2879,1691,2288,4214,12623
2023-08-24,8,3646,1225,2202,2242,4740,14055
2023-08-25,8,3355,1837,2023,1695,4477,13387
2023-08-26,8,3198,2889,2072,2972,3259,14390
2023-08-27,8,4638,1872,2628,3937,2182,15257
2023-08-28,8,1683,2546,2984,3442,3564,14219
2023-08-29,8,4234,1256,1907,3113,3580,14090
2023-08-30,8,1454,981,2126,3057,2294,9912
2023-08-31,8,4108,1091,2097,2663,5866,15825
2023-09-01,8,1009,976,2351,2595,2089,9020
2023-09-02,8,4752,1035,2377,4003,5228,17395
2023-09-03,8,2745,2701,3017,3884,3742,16089
2023-09-04,8,3698,2255,1595,2498,5553,15599
2023-09-05,8,3158,1892,1418,1618,2038,10124
2023-09-06,8,2313,1567,2251,4437,3440,14008
2023-09-07,8,3151,2481,3926,1616,4808,15982
2023-09-08,8,1155,851,1772,3682,2900,10360
2023-09-09,8,2209,2312,2000,2800,5097,14418
2023-09-10,8,1002,1817,3992,2954,4537,14302
2023-09-11,8,1908,1082,3666,2188,5833,14677
2023-09-12,8,2215,2703,3711,2131,2908,13668
2023-09-13,8,1249,1556,2191,3362,5342,13700
2023-09-14,8,1350,2011,1776,3414,4261,12812
2023-09-15,8,2763,1596,1235,1763,2658,10015
2023-09-16,8,2351,1022,3269,3111,4641,14394
2023-09-17,8,4952,992,2580,3680,5547,17751
2023-09-18,8,3891,2440,3317,3581,2068,15297
2023-09-19,8,2833,1969,2746,2543,2964,13055
2023-09-20,8,2349,2424,1314,4428,5823,16338
2023-09-21,8,4041,2383,2546,2414,2468,13852
2023-09-22,8,3854,1978,3695,2812,3506,15845
2023-09-23,8,1236,2529,1978,3564,4062,13369
2023-09-24,8,4677,1506,1410,3959,3949,15501
2023-09-25,8,2352,838,2661,2226,4799,12876
2023-09-26,8,1428,1561,2693,2604,2141,10427
2023-09-27,8,2533,2546,1288,4148,2349,12864
2023-09-28,8,2998,1269,3017,3774,5026,16084
2023-09-29,8,2987,2275,2258,3603,3127,14250
2023-09-30,8,4654,1501,1593,4192,3554,15494
2023-10-01,8,3862,2890,3539,3334,2537,16162
2023-10-02,8,3194,1086,1843,4242,5234,15599
2023-10-03,8,3179,2705,1690,3121,3397,14092
2023-10-04,8,3698,1715,3614,3112,5892,18031
2023-10-05,8,2214,2990,2931,2921,3916,14972
2023-10-06,8,3932,1267,3941,4036,2994,16170
2023-10-07,8,2997,1142,2803,3158,5631,15731
2023-10-08,8,3270,2479,1660,3032,5837,16278
2023-10-09,8,3934,1524,2029,3270,2848,13605
2023-10-10,8,1962,1940,2269,1913,3631,11715
2023-10-11,8,2123,2174,1974,1889,4965,13125
2023-10-12,8,4285,2826,3306,2253,3318,15988
2023-10-13,8,4620,2691,3567,2766,5020,18664
2023-10-14,8,3344,1771,2781,3990,4820,16706
2023-10-15,8,2710,2090,3674,3055,4859,16388
2023-10-16,8,1943,2108,2031,2288,4544,12914
2023-10-17,8,4468,1769,3553,1835,3757,15382
2023-10-18,8,2645,1693,3662,2790,3523,14313
2023-10-19,8,4580,926,3138,3207,5417,17268
2023-10-20,8,3066,1279,1478,4433,2907,13163
2023-10-21,8,4620,2924,2098,1770,3442,14854
2023-10-22,8,1811,1646,1916,4442,5612,15427
2023-10-23,8,1639,1343,2316,3002,2338,10638
2023-10-24,8,2910,2642,3934,4252,3023,16761
2023-10-25,8,3539,1981,3100,2370,4352,15342
2023-10-26,8,4128,1077,2097,3255,4449,15006
2023-10-27,8,2372,917,2023,1836,3975,11123
2023-10-28,8,4166,2426,3152,4261,2450,16455
2023-10-29,8,2181,1393,2621,3605,5504,15304
2023-10-30,8,2744,2879,1414,2979,3860,13876
2023-10-31,8,4591,2175,3823,3237,5461,19287
2023-11-01,8,4520,2082,2031,3795,5643,18071
2023-11-02,8,2109,2250,2170,3390,4393,14312
2023-11-03,8,4248,1799,3416,3203,5418,18084
2023-11-04,8,2346,2564,3219,2138,3785,14052
2023-11-05,8,2194,1619,3837,2408,4240,14298
2023-11-06,8,2689,2637,1687,3740,3476,14229
2023-11-07,8,3826,1687,1900,1607,5645,14665
2023-11-08,8,3640,1148,2172,3606,4682,15248
2023-11-09,8,4585,2880,2055,2337,2961,14818
2023-11-10,8,4343,2537,2920,2997,3309,16106
2023-11-11,8,3675,1446,2443,2081,5380,15025
2023-11-12,8,1377,927,1286,4472,4564,12626
2023-11-13,8,2486,2417,3831,3596,3961,16291
2023-11-14,8,1675,2854,3972,3064,2338,13903
2023-11-15,8,1456,2615,2360,3075,5706,15212
2023-11-16,8,4876,2199,1537,1596,3899,14107
2023-11-17,8,1733,863,1871,4146,2680,11293
2023-11-18,8,3354,2404,2106,2297,2858,13019
2023-11-19,8,3703,2056,1915,4071,4750,16495
2023-11-20,8,4334,2119,1942,3609,3844,15848
2023-11-21,8,4161,1536,1733,2504,2028,11962
2023-11-22,8,3606,1272,2604,2241,3236,12959
2023-11-23,8,2333,2578,3395,1832,4991,15129
2023-11-24,8,3918,2165,2694,3092,5634,17503
2023-11-25,8,4046,2796,2425,4062,5774,19103
2023-11-26,8,1060,2420,3372,3720,3158,13730
2023-11-27,8,1473,2297,1299,1911,3340,10320
2023-11-28,8,3620,2432,3881,2973,4338,17244
2023-11-29,8,3476,939,3607,3258,4282,15562
2023-11-30,8,2595,1174,3325,2294,4478,13866
2023-12-01,8,2795,1248,1674,3861,2146,11724
2023-12-02,8,3520,2965,2058,3727,4854,17124
2023-12-03,8,4828,2627,2758,4032,3956,18201
2023-12-04,8,2273,1989,2914,3787,5829,16792
2023-12-05,8,3272,1736,3262,3536,5450,17256
2023-12-06,8,1078,2056,3746,4163,2760,13803
2023-12-07,8,2209,2276,1287,1769,3516,11057
2023-12-08,8,1871,1994,2480,2493,2562,11400
2023-12-09,8,2840,1830,2653,2016,5368,14707
2023-12-10,8,4298,2403,3781,2915,2325,15722
2023-12-11,8,3545,2137,2162,2214,2622,12680
2023-12-12,8,3235,1798,2906,3495,3250,14684
2023-12-13,8,1084,1061,3249,3104,2357,10855
2023-12-14,8,1944,1726,2910,3494,4836,14910
2023-12-15,8,1059,1073,3654,3236,2899,11921
2023-12-16,8,1215,2360,1801,2083,5660,13119
2023-12-17,8,1174,1629,2340,1876,2302,9321
2023-12-18,8,4350,2714,1800,3119,3241,15224
2023-12-19,8,2096,1010,1272,2939,2710,10027
2023-12-20,8,2194,888,2512,4449,5288,15331
2023-12-21,8,2210,2368,1862,2597,3741,12778
2023-12-22,8,4760,1592,1572,2943,4890,15757
2023-12-23,8,2909,1843,3767,2106,2990,13615
2023-12-24,8,2004,1193,2094,1594,3942,10827
2023-12-25,8,2895,1726,1469,2768,4086,12944
2023-12-26,8,3327,932,3934,1912,3704,13809
2023-12-27,8,2431,2774,3209,2549,4737,15700
2023-12-28,8,4955,1435,2685,1974,5292,16341
2023-12-29,8,1016,1730,3845,4482,4837,15910
2023-12-30,8,3523,2415,1536,3427,4306,15207
2023-12-31,8,1519,1593,3827,1531,2563,11033
2022-01-01,9,2864,2989,1702,3294,2153,13002
2022-01-02,9,1409,1565,1525,3637,2163,10299
2022-01-03,9,4529,2793,2049,3908,4158,17437
2022-01-04,9,1710,1161,1255,3911,5247,13284
2022-01-05,9,4419,1393,2159,3896,4123,15990
2022-01-06,9,1754,1324,3207,2023,5993,14301
2022-01-07,9,2935,1271,1720,2318,2905,11149
2022-01-08,9,3605,1893,3178,2488,3058,14222
2022-01-09,9,1005,1127,3308,1985,3773,11198
2022-01-10,9,3489,809,3440,1943,2568,12249
2022-01-11,9,2562,1054,1287,2963,4019,11885
2022-01-12,9,2385,1342,3702,2460,2621,12510
2022-01-13,9,1714,2584,3123,3822,2408,13651
2022-01-14,9,4552,1026,2222,3757,3181,14738
2022-01-15,9,4855,972,3095,2744,4985,16651
2022-01-16,9,2338,1927,2736,1823,5276,14100
2022-01-17,9,4237,2011,2485,3581,2019,14333
2022-01-18,9,1853,1567,3500,2400,3004,12324
2022-01-19,9,4120,2780,1275,4446,3805,16426
2022-01-20,9,1899,2102,2547,3077,2528,12153
2022-01-21,9,4783,1512,2919,4221,5386,18821
2022-01-22,9,4014,2243,1223,1591,4976,14047
2022-01-23,9,2464,2927,1730,2260,3501,12882
2022-01-24,9,1360,888,2023,2729,2784,9784
2022-01-25,9,3621,2992,3908,3430,5037,18988
2022-01-26,9,1023,1304,3309,1702,2338,9676
2022-01-27,9,2087,2207,2091,2511,5241,14137
2022-01-28,9,2927,2625,2325,3096,2200,13173
2022-01-29,9,3385,2801,2113,4465,4930,17694
2022-01-30,9,4316,1541,2241,2038,4655,14791
2022-01-31,9,3979,2444,1829,3697,2999,14948
2022-02-01,9,3774,1420,1972,2217,4259,13642
2022-02-02,9,3801,1859,1724,3874,3235,14493
2022-02-03,9,1670,2730,3943,2586,4520,15449
2022-02-04,9,1130,2946,1284,3191,4816,13367
2022-02-05,9,1159,949,3050,4447,5727,15332
2022-02-06,9,4922,1843,3189,3417,3608,16979
2022-02-07,9,1278,2587,3623,4439,5767,17694
2022-02-08,9,2483,2550,2408,1510,4335,13286
2022-02-09,9,2403,2025,3863,4302,3279,15872
2022-02-10,9,3018,2856,2527,4300,2985,15686
2022-02-11,9,3313,2745,2030,2061,3143,13292
2022-02-12,9,2333,1212,2247,2312,4136,12240
2022-02-13,9,1130,1905,2176,1796,4693,11700
2022-02-14,9,3169,2874,2713,2255,3609,14620
2022-02-15,9,4597,1805,1637,1741,2461,12241
2022-02-16,9,2704,890,1535,4405,3342,12876
2022-02-17,9,3117,1709,2140,4072,3013,14051
2022-02-18,9,4091,1501,3623,3278,4341,16834
2022-02-19,9,2939,2337,3241,1639,5479,15635
2022-02-20,9,3415,2501,2167,3406,2060,13549
2022-02-21,9,3572,2358,1369,2214,3882,13395
2022-02-22,9,3800,1291,3928,3135,3630,15784
2022-02-23,9,4226,1708,3460,1759,2396,13549
2022-02-24,9,3321,865,3091,3726,4623,15626
2022-02-25,9,3956,1253,2664,1750,5361,14984
2022-02-26,9,1088,1637,3934,4107,2245,13011
2022-02-27,9,3789,2820,2902,2476,5013,17000
2022-02-28,9,1451,1548,3656,2108,5451,14214
2022-03-01,9,3000,2324,2115,4457,3887,15783
2022-03-02,9,4266,1785,2676,1518,2494,12739
2022-03-03,9,4617,2920,1761,4099,5589,18986
2022-03-04,9,3984,1761,3717,3101,4062,16625
2022-03-05,9,2888,2790,1673,1712,4059,13122
2022-03-06,9,4271,1151,2867,2100,4459,14848
2022-03-07,9,3519,1030,2960,2600,4647,14756
2022-03-08,9,1119,1764,1408,1532,2933,8756
2022-03-09,9,4125,2958,1608,2181,3306,14178
2022-03-10,9,3898,2497,3494,3954,5970,19813
2022-03-11,9,1850,1607,2992,2257,2523,11229
2022-03-12,9,1218,2615,2245,3428,4032,13538
2022-03-13,9,4635,2348,3768,1576,3456,15783
2022-03-14,9,4663,1950,1860,3928,3655,16056
2022-03-15,9,4609,2651,2770,2086,4445,16561
2022-03-16,9,2968,1937,2848,3056,4069,14878
2022-03-17,9,4914,906,1203,4123,5352,16498
2022-03-18,9,3680,1619,3689,3648,4350,16986
2022-03-19,9,3885,2680,2829,2318,5912,17624
2022-03-20,9,1800,2011,3586,3164,5666,16227
2022-03-21,9,2164,2147,2969,4212,2823,14315
2022-03-22,9,2020,1351,2835,2981,4737,13924
2022-03-23,9,4716,1483,3135,3474,4442,17250
2022-03-24,9,2835,935,1843,2749,3386,11748
2022-03-25,9,2278,1713,3555,2984,5796,16326
2022-03-26,9,2568,1862,3495,3113,2957,13995
2022-03-27,9,2069,2954,2296,1964,3579,12862
2022-03-28,9,1881,1636,2801,1869,3075,11262
2022-03-29,9,2037,986,3472,2709,2116,11320
2022-03-30,9,3029,2503,3119,3541,3517,15709
2022-03-31,9,3207,2599,2840,3607,4969,17222
2022-04-01,9,2775,1351,3872,2402,2093,12493
2022-04-02,9,3231,1598,3171,1586,3599,13185
2022-04-03,9,1470,2866,2077,3975,2978,13366
2022-04-04,9,4572,1369,3789,3985,3798,17513
2022-04-05,9,2609,1162,1658,4275,2855,12559
2022-04-06,9,1637,2989,3717,4021,5404,17768
2022-04-07,9,4404,1367,1674,3822,5613,16880
2022-04-08,9,3020,841,2727,1992,2596,11176
2022-04-09,9,3068,1691,3706,1896,5871,16232
2022-04-10,9,1207,1005,2755,1544,2960,9471
2022-04-11,9,1515,2488,1676,1679,2920,10278
2022-04-12,9,4060,2080,3332,2301,4842,16615
2022-04-13,9,2495,2511,1740,2970,2463,12179
2022-04-14,9,3835,1685,3616,2729,3864,15729
2022-04-15,9,1484,2988,3057,4235,5575,17339
2022-04-16,9,4701,2585,1917,1782,5950,16935
2022-04-17,9,2282,1073,1705,4293,4036,13389
2022-04-18,9,3551,1950,1899,2174,2050,11624
2022-04-19,9,1739,2962,1599,2372,5776,14448
2022-04-20,9,3915,2722,3277,4117,3056,17087
2022-04-21,9,2460,1154,1216,2902,4298,12030
2022-04-22,9,1187,2659,1541,3378,2017,10782
2022-04-23,9,1803,2716,1743,3176,5485,14923
2022-04-24,9,4887,1589,2802,4042,4929,18249
2022-04-25,9,4808,2011,3951,3824,5978,20572
2022-04-26,9,4514,2937,1297,4182,2425,15355
2022-04-27,9,3950,2746,1407,2162,2187,12452
2022-04-28,9,1690,2202,1928,1563,3657,11040
2022-04-29,9,1983,1627,2181,4122,5543,15456
2022-04-30,9,4533,2587,3563,2374,2199,15256
2022-05-01,9,4526,1562,1504,3962,4402,15956
2022-05-02,9,2904,2163,3532,1530,3841,13970
2022-05-03,9,1654,2658,3967,4163,4973,17415
2022-05-04,9,3122,2451,3391,4364,5353,18681
2022-05-05,9,4547,1052,2800,3874,3296,15569
2022-05-06,9,4389,2281,3577,2707,3730,16684
2022-05-07,9,3550,2087,1807,4286,3302,15032
2022-05-08,9,1974,953,3365,3191,3543,13026
2022-05-09,9,1417,2909,2737,3294,2632,12989
2022-05-10,9,3071,901,2639,1605,3694,11910
2022-05-11,9,4123,2788,1949,2325,2202,13387
2022-05-12,9,3001,2334,2179,2702,4783,14999
2022-05-13,9,4434,2950,3846,1628,4131,16989
2022-05-14,9,3857,1649,3832,4352,3748,17438
2022-05-15,9,1658,980,2268,3948,2223,11077
2022-05-16,9,3607,2028,2271,3184,4043,15133
2022-05-17,9,1369,909,2293,2902,4772,12245
2022-05-18,9,1178,1076,2091,4237,3303,11885
2022-05-19,9,3920,1556,3681,2397,2041,13595
2022-05-20,9,2083,1266,1294,2181,4569,11393
2022-05-21,9,4595,1533,2889,4010,5194,18221
2022-05-22,9,3505,1536,3547,3263,3299,15150
2022-05-23,9,3507,2411,2918,3602,5384,17822
2022-05-24,9,1902,1963,2993,2278,4372,13508
2022-05-25,9,1980,1273,3890,3612,3447,14202
2022-05-26,9,4362,2696,2634,3916,4867,18475
2022-05-27,9,4326,1920,1852,3648,5329,17075
2022-05-28,9,4920,2438,2296,2395,4712,16761
2022-05-29,9,4399,1927,2046,3275,4882,16529
2022-05-30,9,3057,2099,2687,2490,5283,15616
2022-05-31,9,3886,1706,1968,3940,4856,16356
2022-06-01,9,4975,1777,2762,3995,2278,15787
2022-06-02,9,4825,1848,2404,3354,2113,14544
2022-06-03,9,4668,997,1267,4302,2237,13471
2022-06-04,9,2406,1907,1990,3733,4683,14719
2022-06-05,9,1838,1722,1723,1737,4696,11716
2022-06-06,9,3938,1336,2654,2344,4549,14821
2022-06-07,9,4955,2495,2052,3433,3071,16006
2022-06-08,9,3061,2553,1691,3865,2365,13535
2022-06-09,9,1528,1848,2090,1552,4769,11787
2022-06-10,9,3784,910,2138,3644,5344,15820
2022-06-11,9,3225,1979,3996,3454,5117,17771
2022-06-12,9,5000,2643,3935,1783,2903,16264
2022-06-13,9,2924,1447,1838,2171,4912,13292
2022-06-14,9,2808,2507,2757,3722,3226,15020
2022-06-15,9,1409,849,3189,1929,4636,12012
2022-06-16,9,3377,1932,2967,3863,5923,18062
2022-06-17,9,3218,2111,3443,2824,3803,15399
2022-06-18,9,1838,2772,3593,2348,5866,16417
2022-06-19,9,1998,971,3472,2622,4009,13072
2022-06-20,9,1722,2564,1548,1808,3905,11547
2022-06-21,9,4101,961,2707,2600,5331,15700
2022-06-22,9,1657,2765,3170,2384,5287,15263
2022-06-23,9,1224,2218,1269,2580,5049,12340
2022-06-24,9,2550,1575,3852,3085,2969,14031
2022-06-25,9,1592,2232,3598,3389,4846,15657
2022-06-26,9,1676,2269,1392,4183,3908,13428
2022-06-27,9,4954,1461,1793,2307,4914,15429
2022-06-28,9,2026,1349,3259,2595,4483,13712
2022-06-29,9,1161,1789,2861,1859,2863,10533
2022-06-30,9,4740,2384,2027,4466,3946,17563
2022-07-01,9,4661,1639,3748,2573,5038,17659
2022-07-02,9,1439,2095,2192,2751,5791,14268
2022-07-03,9,1964,1563,2712,2631,3180,12050
2022-07-04,9,1686,2449,3070,3343,2805,13353
2022-07-05,9,3832,1419,3259,1888,5469,15867
2022-07-06,9,4805,1791,1325,2064,5625,15610
2022-07-07,9,3445,2669,3704,1588,3980,15386
2022-07-08,9,1498,2204,2176,1930,3095,10903
2022-07-09,9,4785,2356,2630,1919,4383,16073
2022-07-10,9,2438,1318,3736,3598,4834,15924
2022-07-11,9,2480,1340,2087,1865,5867,13639
2022-07-12,9,3620,2313,2228,3518,4604,16283
2022-07-13,9,1218,1955,2937,2779,5084,13973
2022-07-14,9,4862,1533,3579,1760,5236,16970
2022-07-15,9,2125,2213,3406,1611,5841,15196
2022-07-16,9,3924,1934,2711,3145,3906,15620
2022-07-17,9,1164,1292,2469,3318,4052,12295
2022-07-18,9,2337,1699,2088,4016,2134,12274
2022-07-19,9,1235,953,2110,2899,3214,10411
2022-07-20,9,3829,1732,2744,2726,2209,13240
2022-07-21,9,4816,2850,2170,3685,5922,19443
2022-07-22,9,3256,2330,2828,1768,2429,12611
2022-07-23,9,2523,2838,2715,4432,5569,18077
2022-07-24,9,1626,2281,3536,1866,5302,14611
2022-07-25,9,4730,1635,3264,3790,5649,19068
2022-07-26,9,4205,2360,3871,1637,3605,15678
2022-07-27,9,3344,1065,3918,3726,2112,14165
2022-07-28,9,3558,2671,3403,2103,4027,15762
2022-07-29,9,2954,2917,2962,2599,4119,15551
2022-07-30,9,2228,861,1416,1777,3677,9959
2022-07-31,9,3454,1893,1784,1684,5624,14439
2022-08-01,9,3571,2602,1988,3529,3492,15182
2022-08-02,9,4603,2979,2697,3256,2647,16182
2022-08-03,9,2953,1785,1831,3169,5587,15325
2022-08-04,9,4084,1356,3644,2732,5673,17489
2022-08-05,9,1797,2085,2729,4059,5858,16528
2022-08-06,9,4299,1094,1821,1694,2981,11889
2022-08-07,9,3046,1386,1637,2546,2516,11131
2022-08-08,9,1584,870,2674,3017,3961,12106
2022-08-09,9,4604,2264,3249,3365,3790,17272
2022-08-10,9,3548,2352,2112,3251,5843,17106
2022-08-11,9,3328,1285,3135,3779,2193,13720
2022-08-12,9,3350,1168,1596,4319,4986,15419
2022-08-13,9,3169,2326,1473,4166,4786,15920
2022-08-14,9,1972,2052,1500,2322,2076,9922
2022-08-15,9,2256,2906,1967,3725,5181,16035
2022-08-16,9,2653,1317,3181,4102,5902,17155
2022-08-17,9,4278,1958,1437,2466,2807,12946
2022-08-18,9,1491,1828,1200,1852,3365,9736
2022-08-19,9,1743,2436,3484,3097,5509,16269
2022-08-20,9,1632,1505,3665,2614,3707,13123
2022-08-21,9,4949,903,3708,2892,3916,16368
2022-08-22,9,3547,2530,2432,3455,5568,17532
2022-08-23,9,1833,1241,2357,3437,5280,14148
2022-08-24,9,3235,1772,2831,3770,5739,17347
2022-08-25,9,3834,2888,3499,3094,5441,18756
2022-08-26,9,3165,1798,1557,1762,5781,14063
2022-08-27,9,1847,2027,1573,4306,2528,12281
2022-08-28,9,3480,1588,1580,3905,3509,14062
2022-08-29,9,1970,954,3868,1938,3146,11876
2022-08-30,9,1693,2009,1524,3939,3973,13138
2022-08-31,9,3958,2280,2419,2594,4512,15763
2022-09-01,9,1249,2986,2900,3657,2900,13692
2022-09-02,9,4541,2260,1706,2630,5936,17073
2022-09-03,9,1357,1480,1477,4257,4881,13452
2022-09-04,9,1679,1337,3261,3967,2124,12368
2022-09-05,9,3657,1451,2322,3196,3109,13735
2022-09-06,9,3463,1243,3114,2998,4060,14878
2022-09-07,9,2156,2808,2143,4331,5016,16454
2022-09-08,9,3420,1590,1404,1541,5380,13335
2022-09-09,9,3913,1472,1790,2984,3505,13664
2022-09-10,9,1978,2800,1667,4101,3494,14040
2022-09-11,9,2267,2268,1744,3694,4346,14319
2022-09-12,9,1971,2155,1692,2182,2549,10549
2022-09-13,9,1122,864,3771,2368,4545,12670
2022-09-14,9,2432,2779,2339,2331,2591,12472
2022-09-15,9,4097,1207,2924,3721,2632,14581
2022-09-16,9,3503,1305,3721,2915,5907,17351
2022-09-17,9,4487,2429,2321,3700,3125,16062
2022-09-18,9,1520,2298,3125,2957,2668,12568
2022-09-19,9,4295,2748,1982,1663,3849,14537
2022-09-20,9,3970,1278,2907,1537,3441,13133
2022-09-21,9,3345,1614,2348,2572,4566,14445
2022-09-22,9,1533,2235,1658,3893,3299,12618
2022-09-23,9,2714,2548,2555,2977,3346,14140
2022-09-24,9,2527,1158,2423,4133,2960,13201
2022-09-25,9,3648,2583,2314,4338,3839,16722
2022-09-26,9,3377,2067,2241,2143,4753,14581
2022-09-27,9,4889,2427,3915,2118,2151,15500
2022-09-28,9,4402,839,3144,3789,3604,15778
2022-09-29,9,4898,922,1900,4389,2027,14136
2022-09-30,9,3531,2499,2061,3638,5480,17209
2022-10-01,9,1545,2914,3768,3597,3413,15237
2022-10-02,9,1784,1820,1561,1546,3590,10301
2022-10-03,9,4333,1612,3663,2566,4755,16929
2022-10-04,9,2006,1168,1212,3950,3166,11502
2022-10-05,9,4165,2691,3558,1638,2671,14723
2022-10-06,9,4692,1486,3210,3003,3527,15918
2022-10-07,9,2972,1287,1983,3444,5408,15094
2022-10-08,9,2346,1522,3192,3440,5172,15672
2022-10-09,9,3559,1322,3153,3618,2963,14615
2022-10-10,9,3735,1221,1576,3118,5351,15001
2022-10-11,9,2358,1051,1894,3521,5369,14193
2022-10-12,9,3540,2000,2947,2663,5797,16947
2022-10-13,9,2044,1666,1453,2975,2101,10239
2022-10-14,9,4111,1594,3841,1793,4298,15637
2022-10-15,9,4988,2400,3255,3357,3798,17798
2022-10-16,9,2158,2160,2501,4337,3029,14185
2022-10-17,9,1650,1996,3432,2070,3413,12561
2022-10-18,9,2700,938,1262,2157,2056,9113
2022-10-19,9,1635,2496,1296,2647,4781,12855
2022-10-20,9,1135,832,3792,3275,2334,11368
2022-10-21,9,4799,2879,1552,3002,3734,15966
2022-10-22,9,4120,2375,3049,1890,3153,14587
2022-10-23,9,2528,1324,1322,2972,4718,12864
2022-10-24,9,3714,984,1870,2375,5734,14677
2022-10-25,9,1429,2357,3942,3368,4267,15363
2022-10-26,9,2145,1941,2599,3708,5791,16184
2022-10-27,9,1502,2919,1406,3446,3703,12976
2022-10-28,9,2633,2194,1712,4433,5486,16458
2022-10-29,9,3996,1321,2866,2597,5962,16742
2022-10-30,9,2764,2380,1479,1631,3495,11749
2022-10-31,9,2680,2076,3718,2493,2321,13288
2022-11-01,9,3091,931,3807,2464,5255,15548
2022-11-02,9,1037,2659,1676,3819,2280,11471
2022-11-03,9,4046,2828,3937,2977,5518,19306
2022-11-04,9,1447,2199,1469,2475,3623,11213
2022-11-05,9,2865,1189,2513,2728,5039,14334
2022-11-06,9,4328,2836,1978,3409,3062,15613
2022-11-07,9,4836,2335,3698,2765,3795,17429
2022-11-08,9,1839,1801,3665,2786,2882,12973
2022-11-09,9,4705,2499,1780,2892,5675,17551
2022-11-10,9,1678,1119,1468,3622,5363,13250
2022-11-11,9,1766,2880,1963,3286,5912,15807
2022-11-12,9,1233,2579,2168,1948,3810,11738
2022-11-13,9,2700,2253,1638,3544,2042,12177
2022-11-14,9,1416,1388,3253,4064,2866,12987
2022-11-15,9,1676,1430,2716,2749,2008,10579
2022-11-16,9,1370,883,2065,4080,5128,13526
2022-11-17,9,4985,2667,2766,2270,2178,14866
2022-11-18,9,1614,2396,3158,4363,5316,16847
2022-11-19,9,2338,2799,2621,2280,2974,13012
2022-11-20,9,4913,1853,3224,3002,3236,16228
2022-11-21,9,1589,1994,3770,1821,4082,13256
2022-11-22,9,3032,2740,3173,1617,2903,13465
2022-11-23,9,4429,2494,3533,3448,4532,18436
2022-11-24,9,3948,2867,3537,3014,5294,18660
2022-11-25,9,4246,1254,1637,1568,2021,10726
2022-11-26,9,2677,2399,2130,1786,4039,13031
2022-11-27,9,4154,2029,3857,2006,2926,14972
2022-11-28,9,4297,835,3664,3143,2775,14714
2022-11-29,9,1009,876,3960,1937,4670,12452
2022-11-30,9,3061,1519,3062,2943,4053,14638
2022-12-01,9,2053,2583,1283,2874,2395,11188
2022-12-02,9,1339,1565,2304,3289,4976,13473
2022-12-03,9,1979,1846,3759,2736,2159,12479
2022-12-04,9,3383,2253,1631,3589,2430,13286
2022-12-05,9,4400,2799,1695,2480,4868,16242
2022-12-06,9,4928,2952,1333,3822,4564,17599
2022-12-07,9,3041,1112,2292,1817,2297,10559
2022-12-08,9,4767,941,2164,3055,2699,13626
2022-12-09,9,1943,1393,3542,1562,5652,14092
2022-12-10,9,1459,1811,2241,4132,5180,14823
2022-12-11,9,4764,2235,2182,2916,5696,17793
2022-12-12,9,1233,2845,3745,3481,4091,15395
2022-12-13,9,1402,1169,3850,1521,3416,11358
2022-12-14,9,1224,2432,2778,2924,2748,12106
2022-12-15,9,2363,2633,1604,3768,2412,12780
2022-12-16,9,2863,1305,3857,3957,2675,14657
2022-12-17,9,4669,1448,1376,3593,4452,15538
2022-12-18,9,2793,2999,3221,4470,4429,17912
2022-12-19,9,2519,2082,2441,3121,2453,12616
2022-12-20,9,1940,885,3548,4343,3336,14052
2022-12-21,9,2448,2338,2788,1993,3599,13166
2022-12-22,9,1230,2171,2905,1645,5707,13658
2022-12-23,9,2700,1401,1466,2382,5165,13114
2022-12-24,9,4560,2298,2399,2600,5298,17155
2022-12-25,9,2633,2384,2945,4279,5605,17846
2022-12-26,9,1404,2308,2439,3634,2004,11789
2022-12-27,9,2123,1080,2758,3007,5918,14886
2022-12-28,9,2993,1029,1343,2530,3001,10896
2022-12-29,9,4163,1226,3523,2297,4995,16204
2022-12-30,9,4368,1364,3731,3843,4553,17859
2022-12-31,9,4279,1395,1873,3636,4596,15779
2023-01-01,9,4464,1072,1707,3010,5043,15296
2023-01-02,9,2303,2084,3198,2177,2297,12059
2023-01-03,9,4465,2670,2155,3263,5201,17754
2023-01-04,9,3784,2363,4000,3861,3892,17900
2023-01-05,9,4200,2948,1822,1848,4987,15805
2023-01-06,9,4637,1235,1941,2447,3271,13531
2023-01-07,9,1019,2610,3053,2680,3825,13187
2023-01-08,9,3575,851,3768,3867,4005,16066
2023-01-09,9,4882,1429,3658,3229,5376,18574
2023-01-10,9,2388,859,1994,4276,2901,12418
2023-01-11,9,3823,884,1948,3300,3238,13193
2023-01-12,9,3493,1866,2971,2458,4742,15530
2023-01-13,9,1774,1597,3868,2337,4320,13896
2023-01-14,9,3179,1458,3063,1882,3273,12855
2023-01-15,9,1434,2008,3692,3636,5818,16588
2023-01-16,9,2469,2288,2799,4407,2108,14071
2023-01-17,9,3647,1560,2628,3471,3553,14859
2023-01-18,9,2797,1814,2585,2342,4171,13709
2023-01-19,9,2997,2241,2807,2249,5171,15465
2023-01-20,9,4197,2887,1872,3184,3104,15244
2023-01-21,9,3562,1997,1581,2807,4993,14940
2023-01-22,9,3621,1191,3196,2158,5994,16160
2023-01-23,9,1303,2489,3264,2624,3039,12719
2023-01-24,9,3770,1853,3888,2937,2395,14843
2023-01-25,9,3506,1826,1765,1713,5275,14085
2023-01-26,9,3487,1769,1498,2768,5825,15347
2023-01-27,9,4954,2070,2734,1698,5650,17106
2023-01-28,9,4951,1293,3584,2606,4157,16591
2023-01-29,9,1336,2744,3204,1724,3677,12685
2023-01-30,9,1027,1808,3946,2309,3387,12477
2023-01-31,9,3273,1919,3367,3153,2985,14697
2023-02-01,9,1673,949,1587,1692,3012,8913
2023-02-02,9,4922,1023,2821,2675,5237,16678
2023-02-03,9,4614,1365,3118,2130,3393,14620
2023-02-04,9,4557,1087,3173,2685,4724,16226
2023-02-05,9,1632,1639,2798,3863,5231,15163
2023-02-06,9,3705,2351,2554,4422,4597,17629
2023-02-07,9,2405,1325,1373,2092,5414,12609
2023-02-08,9,1822,2083,1315,2052,3960,11232
2023-02-09,9,1524,1977,3735,3469,5557,16262
2023-02-10,9,4254,2307,3590,2631,3304,16086
2023-02-11,9,1431,2210,2191,3746,5673,15251
2023-02-12,9,4792,1083,2866,1936,2269,12946
2023-02-13,9,2096,2324,3933,3693,2723,14769
2023-02-14,9,3538,2337,1952,4341,5505,17673
2023-02-15,9,1971,2074,1878,4082,5770,15775
2023-02-16,9,2207,3000,3445,2303,4505,15460
2023-02-17,9,3278,1232,1529,3161,2624,11824
2023-02-18,9,1340,2755,1770,2411,3847,12123
2023-02-19,9,1541,2116,3370,3812,2440,13279
2023-02-20,9,2515,2846,3081,3644,5977,18063
2023-02-21,9,1518,2771,3921,3334,3419,14963
2023-02-22,9,1748,1194,1544,3520,3218,11224
2023-02-23,9,2471,2977,1300,2162,5212,14122
2023-02-24,9,2459,2171,2109,1558,5538,13835
2023-02-25,9,2918,1060,1294,4210,5509,14991
2023-02-26,9,4332,2395,2978,2336,3224,15265
2023-02-27,9,2158,1630,2212,1501,4460,11961
2023-02-28,9,3134,1808,2595,4493,4724,16754
2023-03-01,9,1860,1790,1203,2820,3709,11382
2023-03-02,9,3203,1899,3830,2264,2524,13720
2023-03-03,9,2267,1348,2244,3980,5102,14941
2023-03-04,9,4550,1085,3933,3326,2405,15299
2023-03-05,9,1748,1595,2594,2598,3761,12296
2023-03-06,9,4958,2994,3053,2157,2374,15536
2023-03-07,9,3270,1129,1366,3499,3894,13158
2023-03-08,9,2531,2265,1770,1713,2539,10818
2023-03-09,9,4413,2249,2000,1540,4241,14443
2023-03-10,9,2716,2114,2723,1759,4802,14114
2023-03-11,9,2710,1051,3336,2237,3213,12547
2023-03-12,9,1144,2286,3594,3846,4944,15814
2023-03-13,9,4183,2958,1462,3387,5835,17825
2023-03-14,9,4832,2881,2136,2862,2048,14759
2023-03-15,9,4744,842,1457,3284,3375,13702
2023-03-16,9,3280,1569,3059,1816,3900,13624
2023-03-17,9,1993,2266,2968,2600,4245,14072
2023-03-18,9,1036,1791,2824,4481,2710,12842
2023-03-19,9,1626,1769,3288,2057,2945,11685
2023-03-20,9,3371,1778,3157,2419,4733,15458
2023-03-21,9,4566,2503,1742,2196,4792,15799
2023-03-22,9,3629,1279,2151,3027,3036,13122
2023-03-23,9,1745,1269,1486,3316,5466,13282
2023-03-24,9,3151,1381,2241,1646,4005,12424
2023-03-25,9,3197,1134,2638,2926,2413,12308
2023-03-26,9,2280,1878,3822,1608,3198,12786
2023-03-27,9,3734,2369,1783,2915,4197,14998
2023-03-28,9,2625,2821,3555,4184,4909,18094
2023-03-29,9,4869,1388,2937,3081,3519,15794
2023-03-30,9,4885,1610,1461,3935,4723,16614
2023-03-31,9,1375,973,2510,2422,3967,11247
2023-04-01,9,1231,1275,3940,2881,5162,14489
2023-04-02,9,1498,1831,2552,4284,2519,12684
2023-04-03,9,3688,1964,3996,1665,4412,15725
2023-04-04,9,4471,2648,3188,2347,2733,15387
2023-04-05,9,2241,1292,1230,2180,4121,11064
2023-04-06,9,2009,1456,3892,4136,4817,16310
2023-04-07,9,1934,1746,3355,2094,5669,14798
2023-04-08,9,2360,1478,2727,2365,5596,14526
2023-04-09,9,3023,1212,1414,3587,3558,12794
2023-04-10,9,3236,1013,3221,2666,4003,14139
2023-04-11,9,2710,1737,2966,3369,2464,13246
2023-04-12,9,1104,2859,1445,1888,3070,10366
2023-04-13,9,1914,2641,2313,2240,3500,12608
2023-04-14,9,1384,2491,1700,1963,2211,9749
2023-04-15,9,4323,1621,2220,1891,5577,15632
2023-04-16,9,3315,1282,2769,2922,2445,12733
2023-04-17,9,1828,2827,3371,2383,5623,16032
2023-04-18,9,1569,2607,3634,3110,2605,13525
2023-04-19,9,3641,1399,1504,3077,2654,12275
2023-04-20,9,2717,903,2644,1753,4249,12266
2023-04-21,9,1691,1920,2669,3198,3969,13447
2023-04-22,9,4438,1025,3392,2972,3853,15680
2023-04-23,9,1944,2016,3963,3592,2934,14449
2023-04-24,9,1275,2098,3373,2888,4646,14280
2023-04-25,9,3904,2222,1587,1950,4756,14419
2023-04-26,9,2331,1684,1218,3025,5038,13296
2023-04-27,9,1024,945,2324,2494,2831,9618
2023-04-28,9,4741,1820,2486,2959,2296,14302
2023-04-29,9,1875,1084,2759,4330,2144,12192
2023-04-30,9,4802,2797,2104,3782,5090,18575
2023-05-01,9,4689,1125,3938,4378,4960,19090
2023-05-02,9,2885,2599,3889,1571,2819,13763
2023-05-03,9,1339,1183,1486,2707,3039,9754
2023-05-04,9,1475,2474,1554,1582,5441,12526
2023-05-05,9,3935,872,1907,1838,3509,12061
2023-05-06,9,4594,1762,2001,1759,5569,15685
2023-05-07,9,1209,1760,3803,3937,2578,13287
2023-05-08,9,4684,1689,3538,1898,2031,13840
2023-05-09,9,3354,2143,3350,3593,5133,17573
2023-05-10,9,4022,2906,2586,1904,5165,16583
2023-05-11,9,3427,1555,1611,4167,2631,13391
2023-05-12,9,4524,895,3056,4110,3166,15751
2023-05-13,9,2175,2910,1282,3140,2838,12345
2023-05-14,9,1529,1512,1428,4033,4205,12707
2023-05-15,9,4157,1925,2965,1941,3353,14341
2023-05-16,9,3184,2221,2624,1848,5218,15095
2023-05-17,9,1319,2793,1450,4120,4473,14155
2023-05-18,9,4926,2374,2626,2083,5513,17522
2023-05-19,9,4260,1484,1225,4193,4816,15978
2023-05-20,9,4144,2605,2980,3750,3747,17226
2023-05-21,9,2769,2907,3403,2542,5709,17330
2023-05-22,9,3501,2509,2222,4294,2302,14828
2023-05-23,9,3125,1644,2530,3333,4399,15031
2023-05-24,9,1930,2218,3842,4018,5956,17964
2023-05-25,9,2065,2223,3565,3585,4839,16277
2023-05-26,9,2274,1378,2823,2882,4787,14144
2023-05-27,9,2489,886,3137,2357,2770,11639
2023-05-28,9,1245,1023,2935,2026,5860,13089
2023-05-29,9,3767,1104,2174,1940,2876,11861
2023-05-30,9,2702,2240,2679,3931,2715,14267
2023-05-31,9,3294,2064,3765,4344,5854,19321
2023-06-01,9,2117,1550,2314,3342,2197,11520
2023-06-02,9,3470,2489,2213,1966,3823,13961
2023-06-03,9,3280,2901,1495,2836,4253,14765
2023-06-04,9,4259,2020,3191,3463,2783,15716
2023-06-05,9,3362,1985,3031,4016,3953,16347
2023-06-06,9,4000,1112,2831,3027,2048,13018
2023-06-07,9,2577,1114,1478,3256,2239,10664
2023-06-08,9,4380,2676,1657,3323,2616,14652
2023-06-09,9,3644,1872,2036,2798,4378,14728
2023-06-10,9,3949,2462,1737,3605,4717,16470
2023-06-11,9,4618,1243,1653,4490,4877,16881
2023-06-12,9,4187,925,1981,1997,2378,11468
2023-06-13,9,4669,2624,1911,2778,2517,14499
2023-06-14,9,2695,2108,1788,3347,3814,13752
2023-06-15,9,4091,946,2095,3771,4144,15047
2023-06-16,9,4133,1674,2779,3396,2914,14896
2023-06-17,9,4769,901,2173,2274,4643,14760
2023-06-18,9,2928,1373,3738,2720,3100,13859
2023-06-19,9,1438,2392,1702,4482,2888,12902
2023-06-20,9,1202,2802,1275,2523,5504,13306
2023-06-21,9,4557,1887,2013,3864,3899,16220
2023-06-22,9,4297,2711,1748,4257,3750,16763
2023-06-23,9,3821,2011,3875,1785,3473,14965
2023-06-24,9,3322,2509,2990,1552,2720,13093
2023-06-25,9,2144,2707,2394,4203,4613,16061
2023-06-26,9,2865,824,3483,1519,4126,12817
2023-06-27,9,1984,1694,1934,2655,2835,11102
2023-06-28,9,2635,2526,2345,2983,2892,13381
2023-06-29,9,4700,1988,2699,1605,5148,16140
2023-06-30,9,4343,1823,3892,1953,3688,15699
2023-07-01,9,2051,2911,2995,4184,5492,17633
2023-07-02,9,2931,1124,2615,2801,5821,15292
2023-07-03,9,1147,963,1325,3337,3565,10337
2023-07-04,9,3975,1009,2107,2728,2923,12742
2023-07-05,9,1639,2680,2344,1576,2794,11033
2023-07-06,9,2238,2759,2638,2786,3216,13637
2023-07-07,9,4758,839,3135,3742,2651,15125
2023-07-08,9,4240,1801,2560,3507,5098,17206
2023-07-09,9,1137,1399,1981,3978,5200,13695
2023-07-10,9,2746,2054,2257,1624,2383,11064
2023-07-11,9,2628,1306,1211,3664,2666,11475
2023-07-12,9,2922,2575,3797,4093,5525,18912
2023-07-13,9,2253,2404,2304,2366,5422,14749
2023-07-14,9,1360,2547,2294,2032,2324,10557
2023-07-15,9,2766,2834,3002,2770,2831,14203
2023-07-16,9,2898,1853,3368,1797,4269,14185
2023-07-17,9,2616,1431,2407,4339,4284,15077
2023-07-18,9,3868,2366,1314,2082,5193,14823
2023-07-19,9,3863,2514,2293,2772,2201,13643
2023-07-20,9,4097,2712,3543,2336,3180,15868
2023-07-21,9,3182,2301,1887,3979,3561,14910
2023-07-22,9,3017,2000,3131,3763,4103,16014
2023-07-23,9,2480,911,2347,2102,2228,10068
2023-07-24,9,3098,2007,2794,3784,5092,16775
2023-07-25,9,3259,2986,3235,3997,3453,16930
2023-07-26,9,3531,1667,2081,3514,3187,13980
2023-07-27,9,1387,1059,3545,2356,2282,10629
2023-07-28,9,1093,2181,3764,4066,5741,16845
2023-07-29,9,1507,2544,3930,4443,4430,16854
2023-07-30,9,2642,2016,1262,1653,3898,11471
2023-07-31,9,2094,1367,1307,2394,3683,10845
2023-08-01,9,1152,1595,3821,2189,5063,13820
2023-08-02,9,1333,918,3253,2809,5702,14015
2023-08-03,9,3882,1049,2305,2739,2808,12783
2023-08-04,9,2563,2617,3789,3671,5170,17810
2023-08-05,9,1749,1011,3218,1537,2102,9617
2023-08-06,9,4757,1326,3074,4105,5642,18904
2023-08-07,9,4026,1591,2102,1749,5255,14723
2023-08-08,9,2315,1068,3469,1770,4326,12948
2023-08-09,9,4617,1634,3578,3449,4585,17863
2023-08-10,9,3583,2743,3016,2687,5469,17498
2023-08-11,9,3292,2514,2183,4157,4112,16258
2023-08-12,9,4320,2868,2450,4083,5331,19052
2023-08-13,9,4361,1711,3022,2928,5536,17558
2023-08-14,9,2722,1629,2928,1780,4208,13267
2023-08-15,9,4770,2759,3668,3617,4953,19767
2023-08-16,9,1857,1377,2978,4383,3591,14186
2023-08-17,9,3596,2182,3592,1531,2113,13014
2023-08-18,9,1776,1672,1596,3973,2151,11168
2023-08-19,9,1378,1839,1962,3211,2274,10664
2023-08-20,9,4681,2321,3081,2696,4723,17502
2023-08-21,9,3143,1942,2380,1693,4440,13598
2023-08-22,9,1534,1929,3216,2012,4333,13024
2023-08-23,9,4375,818,1987,1642,5101,13923
2023-08-24,9,4126,1240,1504,2802,2848,12520
2023-08-25,9,4204,1518,2946,2865,4547,16080
2023-08-26,9,4403,1585,1369,3072,4682,15111
2023-08-27,9,3935,1168,3055,1551,3711,13420
2023-08-28,9,1767,2858,1668,4064,2780,13137
2023-08-29,9,4036,1450,1534,4460,4140,15620
2023-08-30,9,2118,2187,1714,1633,3707,11359
2023-08-31,9,1813,2938,2156,2949,3608,13464
2023-09-01,9,4697,1162,3234,3907,4378,17378
2023-09-02,9,3660,1592,2084,2437,4713,14486
2023-09-03,9,4844,2584,3081,2179,4898,17586
2023-09-04,9,1167,952,1680,3419,3190,10408
2023-09-05,9,3470,1142,2385,3488,5852,16337
2023-09-06,9,3484,953,2118,2839,2690,12084
2023-09-07,9,4203,1509,1591,3933,4667,15903
2023-09-08,9,4027,2079,1951,1596,2439,12092
2023-09-09,9,4308,2578,3553,1689,3109,15237
2023-09-10,9,3804,1587,1369,3934,3294,13988
2023-09-11,9,3397,2687,2529,2641,5749,17003
2023-09-12,9,2889,1408,2665,3078,4202,14242
2023-09-13,9,4858,943,1956,3228,3973,14958
2023-09-14,9,2217,1182,1281,3188,3730,11598
2023-09-15,9,4514,2044,2424,1821,4516,15319
2023-09-16,9,2575,1431,3150,3468,4217,14841
2023-09-17,9,1805,1485,1367,4258,2355,11270
2023-09-18,9,3038,2343,3407,3564,2257,14609
2023-09-19,9,3163,2457,3156,3342,3219,15337
2023-09-20,9,4545,2509,1861,3708,3430,16053
2023-09-21,9,4139,1017,2438,3484,5668,16746
2023-09-22,9,4995,1903,3354,2578,4312,17142
2023-09-23,9,4827,2807,3745,3675,5946,21000
2023-09-24,9,2528,933,3978,3623,4210,15272
2023-09-25,9,3967,853,1941,3146,5070,14977
2023-09-26,9,3949,2983,1276,2075,5427,15710
2023-09-27,9,4769,1025,3569,3477,5907,18747
2023-09-28,9,1134,1197,2639,1759,4174,10903
2023-09-29,9,4084,2625,1302,1802,5692,15505
2023-09-30,9,2384,2039,2128,2132,2112,10795
2023-10-01,9,3494,1510,2616,1943,4581,14144
2023-10-02,9,4849,1236,3378,4000,3957,17420
2023-10-03,9,3907,2762,2621,3534,4589,17413
2023-10-04,9,2191,2226,3358,2019,4998,14792
2023-10-05,9,4343,2702,3278,2588,2353,15264
2023-10-06,9,4745,1744,1405,3587,2523,14004
2023-10-07,9,4695,2328,2666,3523,3503,16715
2023-10-08,9,3734,1983,2234,4291,4392,16634
2023-10-09,9,2812,2450,1724,2598,3060,12644
2023-10-10,9,4814,2845,2871,3100,4495,18125
2023-10-11,9,3050,2107,3417,1726,3918,14218
2023-10-12,9,2478,2564,1992,3413,5936,16383
2023-10-13,9,1729,1014,2394,1562,3676,10375
2023-10-14,9,2842,978,3188,2787,5031,14826
2023-10-15,9,1466,2008,3691,4497,2389,14051
2023-10-16,9,1026,2784,2497,3795,4099,14201
2023-10-17,9,3274,2607,3180,1662,3106,13829
2023-10-18,9,3610,2592,2631,1774,3041,13648
2023-10-19,9,3967,850,3447,2093,2035,12392
2023-10-20,9,3578,2632,3334,4015,3224,16783
2023-10-21,9,1432,2839,1520,4076,2317,12184
2023-10-22,9,1250,2122,3584,2676,2359,11991
2023-10-23,9,2614,2992,2395,4051,2298,14350
2023-10-24,9,1792,2503,3983,2859,2915,14052
2023-10-25,9,2066,1200,1236,1598,5318,11418
2023-10-26,9,2466,995,3052,3792,4540,14845
2023-10-27,9,2344,2237,2620,3066,5599,15866
2023-10-28,9,3279,2489,3957,2565,4555,16845
2023-10-29,9,1826,1093,1406,1948,3558,9831
2023-10-30,9,2999,1675,3337,1898,4895,14804
2023-10-31,9,4076,1048,1333,3439,3909,13805
2023-11-01,9,4045,2001,2506,3902,2808,15262
2023-11-02,9,4412,2573,3787,2193,5763,18728
2023-11-03,9,2840,2669,2015,1701,2818,12043
2023-11-04,9,2380,2197,3759,2570,2980,13886
2023-11-05,9,2446,1406,2754,2027,2868,11501
2023-11-06,9,1428,894,3279,3462,4615,13678
2023-11-07,9,4881,1285,2757,2658,4475,16056
2023-11-08,9,4697,2587,1781,3313,2996,15374
2023-11-09,9,4510,1650,2051,3025,3879,15115
2023-11-10,9,4970,2277,2597,4293,2388,16525
2023-11-11,9,2049,1196,2242,2594,4362,12443
2023-11-12,9,4618,827,3586,1819,5955,16805
2023-11-13,9,4521,1961,1849,2329,2925,13585
2023-11-14,9,2817,1968,2630,1791,3012,12218
2023-11-15,9,3895,2053,2995,2061,3778,14782
2023-11-16,9,4168,2702,2103,3763,5552,18288
2023-11-17,9,1467,2227,2692,3139,4809,14334
2023-11-18,9,3695,2164,3261,2083,2107,13310
2023-11-19,9,1302,1311,1368,3438,3915,11334
2023-11-20,9,3996,1873,2262,3592,2032,13755
2023-11-21,9,4330,2191,3077,1850,3888,15336
2023-11-22,9,2777,1666,1903,3224,2832,12402
2023-11-23,9,3156,2593,2677,4416,3400,16242
2023-11-24,9,4485,1797,1247,4203,2724,14456
2023-11-25,9,2418,1424,2601,3318,2473,12234
2023-11-26,9,3609,2797,1562,3826,5457,17251
2023-11-27,9,1172,871,3955,2577,3823,12398
2023-11-28,9,3296,2761,2183,2005,4812,15057
2023-11-29,9,1307,2328,3998,1989,4339,13961
2023-11-30,9,2520,1929,1511,3499,2905,12364
2023-12-01,9,4463,2842,1283,3014,5602,17204
2023-12-02,9,1218,1940,1967,3256,5296,13677
2023-12-03,9,3280,1862,1647,3035,2887,12711
2023-12-04,9,2124,1340,1252,3097,4658,12471
2023-12-05,9,3565,2514,3636,3866,4409,17990
2023-12-06,9,2492,1811,3488,2710,4914,15415
2023-12-07,9,4200,2907,3591,2229,3400,16327
2023-12-08,9,1414,2670,3532,2697,3651,13964
2023-12-09,9,4634,2650,1803,3205,4115,16407
2023-12-10,9,1701,2834,3817,2022,4729,15103
2023-12-11,9,4560,1079,2476,3665,3402,15182
2023-12-12,9,4447,1180,1448,2095,3461,12631
2023-12-13,9,3666,2020,3002,3903,5731,18322
2023-12-14,9,2763,2379,2450,3635,5561,16788
2023-12-15,9,1154,1701,3931,3437,5024,15247
2023-12-16,9,3369,1259,2576,2204,3086,12494
2023-12-17,9,4931,903,2860,2400,5108,16202
2023-12-18,9,2788,1040,1365,2707,2172,10072
2023-12-19,9,1979,1353,3573,2385,5837,15127
2023-12-20,9,2449,2402,3955,2846,3934,15586
2023-12-21,9,4994,2444,3227,3773,5656,20094
2023-12-22,9,4564,1685,3891,2248,5291,17679
2023-12-23,9,4083,2046,2126,2885,4425,15565
2023-12-24,9,2208,2312,2597,2029,4456,13602
2023-12-25,9,4785,969,3854,2764,3240,15612
2023-12-26,9,3394,866,3244,2901,5268,15673
2023-12-27,9,2102,1910,3583,2442,4351,14388
2023-12-28,9,3830,2662,2439,3044,3573,15548
2023-12-29,9,2252,1643,2658,4126,4246,14925
2023-12-30,9,3678,1738,3934,1884,3105,14339
2023-12-31,9,4882,2247,1440,2230,5862,16661
2022-01-01,10,3012,2818,1351,4154,4817,16152
2022-01-02,10,4707,1283,1484,1917,4467,13858
2022-01-03,10,1121,2865,2654,2022,5074,13736
2022-01-04,10,4972,1997,1778,3473,4677,16897
2022-01-05,10,3267,2622,2461,3410,3213,14973
2022-01-06,10,1967,2587,2273,2177,3210,12214
2022-01-07,10,2413,2773,3278,3166,4798,16428
2022-01-08,10,1939,1836,3908,4378,3532,15593
2022-01-09,10,3802,2581,2148,1652,5921,16104
2022-01-10,10,2371,1484,1524,1561,2425,9365
2022-01-11,10,2636,2928,3812,3823,4858,18057
2022-01-12,10,2884,2683,1238,1927,3265,11997
2022-01-13,10,3356,1138,1789,4449,4679,15411
2022-01-14,10,4804,1527,1751,3293,2711,14086
2022-01-15,10,1649,1509,2219,3010,4378,12765
2022-01-16,10,3366,2704,1920,4049,2995,15034
2022-01-17,10,2600,2455,3917,4115,5354,18441
2022-01-18,10,3477,932,1552,2653,5749,14363
2022-01-19,10,4335,2228,3452,3135,5193,18343
2022-01-20,10,1869,2824,1780,4322,3447,14242
2022-01-21,10,4665,2672,2266,2757,3195,15555
2022-01-22,10,2070,2800,2834,3854,2226,13784
2022-01-23,10,4001,2431,1590,3550,4474,16046
2022-01-24,10,1274,957,1769,2828,3079,9907
2022-01-25,10,3756,1442,2205,2989,5722,16114
2022-01-26,10,4783,1320,1412,2120,3619,13254
2022-01-27,10,2127,2844,3200,3129,4535,15835
2022-01-28,10,2556,1203,2456,1543,4347,12105
2022-01-29,10,1286,2138,1253,3177,4879,12733
2022-01-30,10,2926,2881,1377,3691,2614,13489
2022-01-31,10,3384,2218,3122,2247,2156,13127
2022-02-01,10,1598,2388,1955,2619,3560,12120
2022-02-02,10,3776,2283,1645,3919,5920,17543
2022-02-03,10,1816,1444,2554,3706,3145,12665
2022-02-04,10,3994,1670,3505,2900,2513,14582
2022-02-05,10,2181,2375,3874,3615,4422,16467
2022-02-06,10,4043,2358,3646,3735,5868,19650
2022-02-07,10,2493,1356,1285,3959,2167,11260
2022-02-08,10,3678,2167,3807,3669,3083,16404
2022-02-09,10,2515,1600,1541,1755,5105,12516
2022-02-10,10,2113,912,2227,2601,5012,12865
2022-02-11,10,3054,1246,3366,4383,5110,17159
2022-02-12,10,1401,1182,3819,3535,2649,12586
2022-02-13,10,4415,2140,3410,4361,4689,19015
2022-02-14,10,4081,1151,3831,3854,5833,18750
2022-02-15,10,4754,2739,1927,1758,2157,13335
2022-02-16,10,2448,1078,1367,2204,3134,10231
2022-02-17,10,3497,884,2022,1966,3270,11639
2022-02-18,10,2360,1813,3381,3592,5425,16571
2022-02-19,10,3827,2983,3900,4028,5112,19850
2022-02-20,10,3420,2228,2066,1926,4273,13913
2022-02-21,10,2039,1849,2440,3364,3298,12990
2022-02-22,10,2475,2628,2807,2253,4168,14331
2022-02-23,10,2894,1920,2223,2739,3412,13188
2022-02-24,10,2704,2297,1210,2865,2737,11813
2022-02-25,10,2395,1134,1655,3779,2376,11339
2022-02-26,10,3666,2729,3056,1707,5937,17095
2022-02-27,10,2487,2205,2894,3267,4808,15661
2022-02-28,10,3060,1410,3320,2375,2986,13151
2022-03-01,10,1612,2239,3010,3156,4312,14329
2022-03-02,10,3389,1076,2593,3360,3948,14366
2022-03-03,10,3425,1405,2392,2535,3155,12912
2022-03-04,10,1077,1270,1540,3578,2555,10020
2022-03-05,10,2189,874,1766,3462,4508,12799
2022-03-06,10,2742,2963,1506,2606,3063,12880
2022-03-07,10,3723,1229,2882,2846,4649,15329
2022-03-08,10,2266,2797,3324,1911,2519,12817
2022-03-09,10,1131,2590,2108,3489,3849,13167
2022-03-10,10,3409,2900,2633,3017,4484,16443
2022-03-11,10,4407,1538,3040,1915,5033,15933
2022-03-12,10,1534,2602,2134,2118,5924,14312
2022-03-13,10,4910,911,3995,3679,2343,15838
2022-03-14,10,3705,2835,2496,2414,3298,14748
2022-03-15,10,4560,2850,2798,3784,2576,16568
2022-03-16,10,2623,2868,3795,2775,4991,17052
2022-03-17,10,2825,1557,1657,2115,2881,11035
2022-03-18,10,3192,2483,1706,1647,4340,13368
2022-03-19,10,4457,2068,1818,2577,4329,15249
2022-03-20,10,4551,2972,2657,4051,3294,17525
2022-03-21,10,4386,2133,1293,2307,2499,12618
2022-03-22,10,3537,2409,1363,4149,3079,14537
2022-03-23,10,1765,1555,2568,2929,2952,11769
2022-03-24,10,1406,1120,2493,1637,4827,11483
2022-03-25,10,2370,1671,2179,3295,5057,14572
2022-03-26,10,1538,2448,1934,2028,3304,11252
2022-03-27,10,1986,1952,2888,2615,3160,12601
2022-03-28,10,3229,2600,3679,2113,4213,15834
2022-03-29,10,3632,1861,2274,3634,3096,14497
2022-03-30,10,1440,1459,2458,2458,3628,11443
2022-03-31,10,4079,995,3621,3207,3830,15732
2022-04-01,10,3427,1430,3276,3004,3541,14678
2022-04-02,10,4521,1680,3935,4173,3838,18147
2022-04-03,10,4923,2752,3157,2925,4676,18433
2022-04-04,10,3962,2323,2729,3052,3062,15128
2022-04-05,10,4148,1894,3752,3681,4422,17897
2022-04-06,10,3421,2919,2617,3096,4731,16784
2022-04-07,10,1353,1654,3841,2264,2312,11424
2022-04-08,10,1192,2509,3540,2331,3577,13149
2022-04-09,10,2718,2750,2821,3595,4644,16528
2022-04-10,10,4602,2092,2806,2747,4783,17030
2022-04-11,10,3109,2636,3049,3629,5144,17567
2022-04-12,10,4559,2562,1543,2287,4478,15429
2022-04-13,10,2901,2605,3771,3233,4872,17382
2022-04-14,10,2556,2813,1527,3640,4554,15090
2022-04-15,10,4944,2195,2473,4223,5496,19331
2022-04-16,10,4562,2939,3115,3752,5357,19725
2022-04-17,10,1882,835,1427,3735,5718,13597
2022-04-18,10,1827,2510,1480,3825,4917,14559
2022-04-19,10,3852,1705,1496,2145,5297,14495
2022-04-20,10,3613,2246,2479,4470,2284,15092
2022-04-21,10,1716,2923,1230,1876,5870,13615
2022-04-22,10,2515,2872,3923,3260,3346,15916
2022-04-23,10,3286,1875,3315,1838,5424,15738
2022-04-24,10,3698,1364,2471,1991,3413,12937
2022-04-25,10,1626,2526,2380,3689,3737,13958
2022-04-26,10,3186,1846,3095,2958,4011,15096
2022-04-27,10,1089,2722,3360,2225,3493,12889
2022-04-28,10,4502,2809,3083,3437,5114,18945
2022-04-29,10,3878,2714,3159,4241,3388,17380
2022-04-30,10,1645,1943,3653,2456,2977,12674
2022-05-01,10,2846,2606,2893,3528,3122,14995
2022-05-02,10,3925,1467,1860,2782,3649,13683
2022-05-03,10,4506,1278,2454,4059,2184,14481
2022-05-04,10,4475,1360,1599,4065,4901,16400
2022-05-05,10,1279,1366,3841,2030,5906,14422
2022-05-06,10,2693,1767,2566,4178,2818,14022
2022-05-07,10,2511,2958,3701,4403,2859,16432
2022-05-08,10,1215,2013,2662,3018,4972,13880
2022-05-09,10,4889,1176,2666,2788,4801,16320
2022-05-10,10,2573,1226,1892,2057,3524,11272
2022-05-11,10,4150,2646,1804,4027,5957,18584
2022-05-12,10,4286,1264,3517,1825,3968,14860
2022-05-13,10,1349,2509,2020,3996,3783,13657
2022-05-14,10,1890,805,2199,3979,4468,13341
2022-05-15,10,2327,982,3980,1797,4799,13885
2022-05-16,10,4555,1030,2076,4020,2859,14540
2022-05-17,10,3409,1141,3204,4199,3670,15623
2022-05-18,10,2627,1833,3010,4037,4209,15716
2022-05-19,10,4796,2989,1565,2056,5794,17200
2022-05-20,10,1854,1386,1877,4266,2039,11422
2022-05-21,10,1171,1432,3653,2725,5060,14041
2022-05-22,10,2667,867,3726,3630,2437,13327
2022-05-23,10,3968,2622,2494,3599,5629,18312
2022-05-24,10,3722,1101,1977,2170,2428,11398
2022-05-25,10,4157,1232,2588,2998,4091,15066
2022-05-26,10,3830,1509,1964,2417,5264,14984
2022-05-27,10,4369,1688,1656,4174,5082,16969
2022-05-28,10,3322,1998,2700,2286,4524,14830
2022-05-29,10,2766,2950,2791,2164,2522,13193
2022-05-30,10,4791,2425,1741,4250,5841,19048
2022-05-31,10,3967,1010,2515,3663,2938,14093
2022-06-01,10,3217,1135,2911,4448,2903,14614
2022-06-02,10,1786,1092,1223,1537,2818,8456
2022-06-03,10,3842,1722,3474,2413,4640,16091
2022-06-04,10,3817,2346,1625,2807,2842,13437
2022-06-05,10,1996,1508,2927,2382,3805,12618
2022-06-06,10,4905,1778,1702,4158,4830,17373
2022-06-07,10,4945,2049,1729,1664,5161,15548
2022-06-08,10,4933,1492,2102,3784,2843,15154
2022-06-09,10,3039,2620,3547,2865,5583,17654
2022-06-10,10,4841,2846,1340,2488,4547,16062
2022-06-11,10,1235,2051,2516,3197,5782,14781
2022-06-12,10,3763,2011,2023,1956,4456,14209
2022-06-13,10,1101,1904,3814,3682,5912,16413
2022-06-14,10,2784,2899,3828,4433,4950,18894
2022-06-15,10,3134,2500,2274,4229,3018,15155
2022-06-16,10,2694,980,2261,3334,3356,12625
2022-06-17,10,1776,2250,2162,3933,3292,13413
2022-06-18,10,1117,2659,2301,4017,3371,13465
2022-06-19,10,2208,1526,2070,3768,2528,12100
2022-06-20,10,3619,1558,2985,3728,2883,14773
2022-06-21,10,3837,826,3060,4383,3659,15765
2022-06-22,10,1486,2610,1651,4389,3096,13232
2022-06-23,10,2891,2546,3760,4076,4812,18085
2022-06-24,10,4203,2001,2278,1848,5815,16145
2022-06-25,10,2081,1602,2351,3886,5921,15841
2022-06-26,10,4640,2701,1940,3982,3413,16676
2022-06-27,10,4306,2893,2472,2619,2988,15278
2022-06-28,10,2220,1259,3569,2912,3122,13082
2022-06-29,10,2899,2842,3981,2740,5970,18432
2022-06-30,10,1726,2138,1440,4182,2511,11997
2022-07-01,10,3147,2433,2974,1611,4952,15117
2022-07-02,10,1974,1129,1463,1779,3111,9456
2022-07-03,10,2640,2505,2291,3977,2474,13887
2022-07-04,10,3596,1127,2645,3085,3044,13497
2022-07-05,10,2175,2565,3659,1878,5562,15839
2022-07-06,10,3559,2987,3020,2649,5570,17785
2022-07-07,10,3020,882,2213,2548,4850,13513
2022-07-08,10,2163,1568,2184,2882,5960,14757
2022-07-09,10,4183,2743,3454,3393,3476,17249
2022-07-10,10,4515,1558,2068,3698,4823,16662
2022-07-11,10,2469,2226,3995,4280,4651,17621
2022-07-12,10,2086,2824,2820,3026,2858,13614
2022-07-13,10,3787,1712,2520,3715,5887,17621
2022-07-14,10,4368,872,3511,2445,4851,16047
2022-07-15,10,1860,1359,1689,1837,3806,10551
2022-07-16,10,4427,1153,3853,1753,2811,13997
2022-07-17,10,4180,1866,2909,3244,4021,16220
2022-07-18,10,1821,2697,3163,3327,3277,14285
2022-07-19,10,2931,1651,1423,4233,2955,13193
2022-07-20,10,4315,1348,1907,2190,3826,13586
2022-07-21,10,2372,1276,3311,1640,5067,13666
2022-07-22,10,4848,2366,2379,2089,2161,13843
2022-07-23,10,4153,1546,3771,1622,2413,13505
2022-07-24,10,2918,1067,1271,2201,4890,12347
2022-07-25,10,3765,886,2824,3651,3190,14316
2022-07-26,10,2745,2440,2566,3481,2135,13367
2022-07-27,10,1638,1687,1514,2458,3226,10523
2022-07-28,10,4960,2734,1613,1705,2344,13356
2022-07-29,10,2506,2248,1586,3293,2761,12394
2022-07-30,10,2223,2203,3997,3300,2800,14523
2022-07-31,10,4140,1025,2050,3291,3954,14460
2022-08-01,10,2410,2436,1761,1763,5046,13416
2022-08-02,10,4161,1875,2664,2550,2227,13477
2022-08-03,10,1103,1607,2464,3023,5927,14124
2022-08-04,10,4593,1400,2703,2867,5296,16859
2022-08-05,10,1864,1642,2176,2642,5096,13420
2022-08-06,10,4767,806,1241,4092,4490,15396
2022-08-07,10,4289,1591,2844,1607,4552,14883
2022-08-08,10,4620,2251,1386,4224,5571,18052
2022-08-09,10,2282,2548,1308,2562,4403,13103
2022-08-10,10,1655,1378,3817,2126,2760,11736
2022-08-11,10,2561,2352,3218,3910,2976,15017
2022-08-12,10,2017,881,1723,1522,3372,9515
2022-08-13,10,1262,835,3395,1969,2098,9559
2022-08-14,10,1946,2605,1893,2559,5983,14986
2022-08-15,10,2749,2773,2230,2706,2717,13175
2022-08-16,10,2201,2684,1745,2653,3346,12629
2022-08-17,10,1447,2646,3953,4001,2110,14157
2022-08-18,10,2932,2303,3515,3001,4967,16718
2022-08-19,10,4687,1501,2970,3622,4051,16831
2022-08-20,10,4804,1802,2273,2259,2137,13275
2022-08-21,10,2003,1394,2789,3819,5820,15825
2022-08-22,10,2483,2712,3317,1968,2306,12786
2022-08-23,10,1857,2576,2866,3532,5830,16661
2022-08-24,10,3018,2851,3115,3014,4125,16123
2022-08-25,10,2138,2369,1399,1593,5948,13447
2022-08-26,10,1797,1847,2068,4058,2228,11998
2022-08-27,10,1137,1339,3383,2849,5246,13954
2022-08-28,10,4964,1859,3993,2425,5115,18356
2022-08-29,10,4660,1409,3904,2277,3489,15739
2022-08-30,10,2078,2965,3030,4334,4395,16802
2022-08-31,10,1372,1135,3602,4493,3789,14391
2022-09-01,10,1676,846,3179,2586,2135,10422
2022-09-02,10,3811,1524,1285,1827,5797,14244
2022-09-03,10,2580,1792,1944,4317,5978,16611
2022-09-04,10,1819,2298,1375,3072,5526,14090
2022-09-05,10,3223,1415,3747,4114,5801,18300
2022-09-06,10,2405,867,1220,2848,3360,10700
2022-09-07,10,1261,1320,2860,2989,4795,13225
2022-09-08,10,2778,1080,2639,1650,5601,13748
2022-09-09,10,2328,2784,3473,3388,4057,16030
2022-09-10,10,4233,1133,2553,3704,2276,13899
2022-09-11,10,1445,832,3339,4141,2814,12571
2022-09-12,10,2282,1568,3412,4033,3192,14487
2022-09-13,10,1447,1589,2959,1638,5460,13093
2022-09-14,10,2062,1286,2306,4059,4687,14400
2022-09-15,10,1517,2860,2551,1698,4735,13361
2022-09-16,10,3968,2553,1579,2754,2709,13563
2022-09-17,10,4680,2634,1594,3687,4265,16860
2022-09-18,10,4424,1243,3241,2980,3047,14935
2022-09-19,10,3489,806,2793,3665,5100,15853
2022-09-20,10,4122,2014,2551,4399,4111,17197
2022-09-21,10,2617,1275,1332,3773,5932,14929
2022-09-22,10,4821,2413,2621,2976,5887,18718
2022-09-23,10,1806,1226,3177,3818,3401,13428
2022-09-24,10,3691,1065,2258,1734,5795,14543
2022-09-25,10,4986,1963,1914,2705,3525,15093
2022-09-26,10,2045,1584,3910,3061,3843,14443
2022-09-27,10,1360,1773,2030,2711,5214,13088
2022-09-28,10,2721,1474,2624,2608,3767,13194
2022-09-29,10,1794,1649,3418,1961,5021,13843
2022-09-30,10,1964,936,3546,3129,5540,15115
2022-10-01,10,4422,2017,1271,3377,4906,15993
2022-10-02,10,4080,2388,2643,2132,5176,16419
2022-10-03,10,3618,1665,3154,1716,3953,14106
2022-10-04,10,2210,1293,2984,3833,2324,12644
2022-10-05,10,2052,1679,2248,3304,4325,13608
2022-10-06,10,4590,1980,2892,4211,5844,19517
2022-10-07,10,2831,1213,2120,4146,4103,14413
2022-10-08,10,2767,2520,3208,3943,2221,14659
2022-10-09,10,1618,2396,1386,3747,5728,14875
2022-10-10,10,4452,1950,3291,1976,5198,16867
2022-10-11,10,4128,1800,3043,3364,5724,18059
2022-10-12,10,4110,2389,3002,3180,3365,16046
2022-10-13,10,4943,1895,2104,2374,4231,15547
2022-10-14,10,4310,1083,3132,2106,2585,13216
2022-10-15,10,1121,934,3345,2217,3950,11567
2022-10-16,10,2304,953,2203,4209,5216,14885
2022-10-17,10,1768,1407,1390,3431,5078,13074
2022-10-18,10,4479,1684,2377,1752,3483,13775
2022-10-19,10,4392,936,2610,1878,2079,11895
2022-10-20,10,2118,1789,2998,3609,5353,15867
2022-10-21,10,4615,1247,2722,4499,5115,18198
2022-10-22,10,3151,2918,3093,2833,3768,15763
2022-10-23,10,2191,1380,3694,3472,4762,15499
2022-10-24,10,2325,1338,2581,2580,2381,11205
2022-10-25,10,2210,2770,2451,4008,5458,16897
2022-10-26,10,2503,2698,3402,3064,3480,15147
2022-10-27,10,3926,1907,2158,3371,4082,15444
2022-10-28,10,3942,1221,1397,4070,4128,14758
2022-10-29,10,1113,1607,3382,2165,3479,11746
2022-10-30,10,3866,2841,2513,3722,3758,16700
2022-10-31,10,4455,1402,2627,3662,2864,15010
2022-11-01,10,3274,893,1314,3316,3209,12006
2022-11-02,10,2346,1782,3821,1813,4102,13864
2022-11-03,10,1159,1816,3520,3667,3137,13299
2022-11-04,10,4035,2857,3214,2889,4739,17734
2022-11-05,10,2330,2251,2823,3448,4197,15049
2022-11-06,10,1651,2023,3432,4390,3338,14834
2022-11-07,10,4931,2334,3697,4483,5050,20495
2022-11-08,10,1797,2964,1575,2298,5892,14526
2022-11-09,10,4213,813,3966,4319,5216,18527
2022-11-10,10,3946,955,2636,3727,3972,15236
2022-11-11,10,1720,2553,2653,2146,4283,13355
2022-11-12,10,2156,2244,2389,3303,4374,14466
2022-11-13,10,4818,2198,1705,3787,3251,15759
2022-11-14,10,2680,1041,2916,1879,5960,14476
2022-11-15,10,2577,1298,1934,4347,5722,15878
2022-11-16,10,2184,1726,1494,4250,3007,12661
2022-11-17,10,1201,2331,2325,1640,4350,11847
2022-11-18,10,1076,1061,2003,3663,4413,12216
2022-11-19,10,4620,1983,3349,2915,5796,18663
2022-11-20,10,3614,1140,3908,2656,4968,16286
2022-11-21,10,4865,1405,2190,4005,4226,16691
2022-11-22,10,2147,2056,1293,3714,4137,13347
2022-11-23,10,3522,1323,1237,2386,2549,11017
2022-11-24,10,3734,2312,3661,3996,3312,17015
2022-11-25,10,4545,1794,3769,3963,2315,16386
2022-11-26,10,4327,2973,3903,2798,3532,17533
2022-11-27,10,2399,2553,2960,4242,2065,14219
2022-11-28,10,3106,2481,2218,4410,2068,14283
2022-11-29,10,2316,1929,2303,1920,4490,12958
2022-11-30,10,1984,2488,3519,2340,3368,13699
2022-12-01,10,3225,1499,2942,1785,3282,12733
2022-12-02,10,1104,1967,3551,2379,2326,11327
2022-12-03,10,3870,1749,2427,1919,3217,13182
2022-12-04,10,3266,2746,3318,1929,5142,16401
2022-12-05,10,2812,1309,2020,1881,3947,11969
2022-12-06,10,2865,2501,1571,2733,3396,13066
2022-12-07,10,1419,2582,2242,4272,4328,14843
2022-12-08,10,2843,2230,1601,2167,2945,11786
2022-12-09,10,1660,1723,2420,3872,4914,14589
2022-12-10,10,2822,1653,3269,3787,4691,16222
2022-12-11,10,1835,1118,1511,3900,2842,11206
2022-12-12,10,1486,2657,3499,3025,3203,13870
2022-12-13,10,4688,2034,2956,2040,5615,17333
2022-12-14,10,1852,2106,1229,2106,5929,13222
2022-12-15,10,3273,2463,3519,2835,5861,17951
2022-12-16,10,4743,1468,3966,2100,4664,16941
2022-12-17,10,2164,1796,1417,4488,2920,12785
2022-12-18,10,2744,1034,2769,2414,4893,13854
2022-12-19,10,4504,2129,3810,4455,3659,18557
2022-12-20,10,2921,1267,2804,4059,4331,15382
2022-12-21,10,4466,942,1556,3566,4801,15331
2022-12-22,10,2368,1823,3769,4277,4510,16747
2022-12-23,10,2818,2271,1533,3668,3325,13615
2022-12-24,10,4289,849,3086,4233,3364,15821
2022-12-25,10,2625,2450,3583,3530,2770,14958
2022-12-26,10,4312,1673,3118,3133,5955,18191
2022-12-27,10,4815,2904,2220,1655,2949,14543
2022-12-28,10,1549,889,2102,3299,4418,12257
2022-12-29,10,1660,2338,1873,4205,4769,14845
2022-12-30,10,4882,2481,2368,3032,4271,17034
2022-12-31,10,3228,2677,3177,1921,4750,15753
2023-01-01,10,3325,1723,2075,2537,3309,12969
2023-01-02,10,3817,1282,3263,3909,2075,14346
2023-01-03,10,1344,1477,3864,4467,3430,14582
2023-01-04,10,1690,880,2398,2722,3283,10973
2023-01-05,10,2518,1651,3600,3668,2146,13583
2023-01-06,10,1817,935,2897,3501,4810,13960
2023-01-07,10,4864,2688,2535,3901,2864,16852
2023-01-08,10,1956,2382,2621,2663,5619,15241
2023-01-09,10,2551,1652,2260,3513,3073,13049
2023-01-10,10,1400,1081,3118,3254,2957,11810
2023-01-11,10,2004,1590,1749,2960,2989,11292
2023-01-12,10,3341,2689,1258,3806,5294,16388
2023-01-13,10,1700,1746,3748,2990,3273,13457
2023-01-14,10,1212,1622,3280,4135,3111,13360
2023-01-15,10,1738,2536,1725,1559,3151,10709
2023-01-16,10,3301,2783,2934,4426,3301,16745
2023-01-17,10,2107,1734,2379,2492,3920,12632
2023-01-18,10,4617,1295,1924,4402,5252,17490
2023-01-19,10,2343,1965,1683,4191,2635,12817
2023-01-20,10,4851,982,1250,2531,4842,14456
2023-01-21,10,3457,2394,1586,2856,3253,13546
2023-01-22,10,3749,1724,2416,3147,5906,16942
2023-01-23,10,1041,2087,2711,3285,5349,14473
2023-01-24,10,3702,2128,2066,3414,5897,17207
2023-01-25,10,3813,900,3696,1631,2871,12911
2023-01-26,10,3533,2057,1938,2616,4172,14316
2023-01-27,10,4758,2601,2502,2943,5404,18208
2023-01-28,10,3084,1036,2806,4183,3865,14974
2023-01-29,10,4345,2338,1811,2467,3329,14290
2023-01-30,10,1052,2947,3047,2692,5080,14818
2023-01-31,10,3379,1919,3210,2171,4320,14999
2023-02-01,10,4222,1642,2809,2379,2887,13939
2023-02-02,10,3920,1694,2842,4350,2482,15288
2023-02-03,10,3717,2665,3566,3425,5071,18444
2023-02-04,10,4050,1062,2687,1634,5697,15130
2023-02-05,10,4054,942,1934,2830,2733,12493
2023-02-06,10,4095,2746,3810,4057,5454,20162
2023-02-07,10,4931,891,1506,2244,3438,13010
2023-02-08,10,3119,2270,1708,4100,4369,15566
2023-02-09,10,2330,1015,3928,2404,3614,13291
2023-02-10,10,1905,2347,2046,3117,5111,14526
2023-02-11,10,2604,1856,3172,2119,2812,12563
2023-02-12,10,1037,2366,3740,2343,3910,13396
2023-02-13,10,1750,2702,1716,2155,2893,11216
2023-02-14,10,2387,900,2653,4350,3495,13785
2023-02-15,10,3852,2657,2718,1803,3520,14550
2023-02-16,10,1975,924,1680,2229,5093,11901
2023-02-17,10,2109,2097,3495,2479,3673,13853
2023-02-18,10,2451,871,2420,4160,5744,15646
2023-02-19,10,4911,1404,2957,2574,2117,13963
2023-02-20,10,4605,2078,2878,4483,4852,18896
2023-02-21,10,2329,2841,3684,1637,4425,14916
2023-02-22,10,1893,2334,3897,3515,5462,17101
2023-02-23,10,1013,2392,3240,2561,4766,13972
2023-02-24,10,1696,1116,2834,4219,3235,13100
2023-02-25,10,2648,2437,2925,2662,5303,15975
2023-02-26,10,2217,1977,2679,4309,4911,16093
2023-02-27,10,1964,1456,3966,2381,4446,14213
2023-02-28,10,3575,1627,1296,1830,4819,13147
2023-03-01,10,3629,1299,3511,3428,5714,17581
2023-03-02,10,1696,2287,2050,2500,5492,14025
2023-03-03,10,1639,1968,2961,2193,2884,11645
2023-03-04,10,2006,1446,2823,3648,3258,13181
2023-03-05,10,3717,2301,2071,4087,5797,17973
2023-03-06,10,3179,2196,1451,2138,3215,12179
2023-03-07,10,1738,1807,3201,2997,2292,12035
2023-03-08,10,2315,1614,3778,3804,4244,15755
2023-03-09,10,3633,1130,1738,3759,2125,12385
2023-03-10,10,1357,1662,3304,2842,4319,13484
2023-03-11,10,2584,883,3781,2600,2177,12025
2023-03-12,10,3371,2329,2504,2691,2411,13306
2023-03-13,10,2790,1904,3797,2892,4452,15835
2023-03-14,10,3911,1518,3631,3150,5725,17935
2023-03-15,10,4586,1535,3976,3105,4316,17518
2023-03-16,10,1361,2513,2567,3559,3246,13246
2023-03-17,10,1830,2686,1337,3570,3994,13417
2023-03-18,10,1056,2150,3163,3920,2023,12312
2023-03-19,10,4921,2967,3435,3295,5778,20396
2023-03-20,10,3052,2947,3532,4312,3797,17640
2023-03-21,10,3543,2937,3697,1760,4677,16614
2023-03-22,10,3380,2947,2791,1982,3952,15052
2023-03-23,10,4026,1469,1601,2347,2926,12369
2023-03-24,10,4816,2211,2340,3319,5276,17962
2023-03-25,10,1424,878,3495,4039,2310,12146
2023-03-26,10,4091,2505,3498,4188,5276,19558
2023-03-27,10,2998,1926,1303,1839,3745,11811
2023-03-28,10,2067,2052,1690,3678,2418,11905
2023-03-29,10,2955,1036,3386,3156,5061,15594
2023-03-30,10,1469,885,1993,2701,5987,13035
2023-03-31,10,2114,2025,3145,3056,3931,14271
2023-04-01,10,3799,1620,2682,4087,2598,14786
2023-04-02,10,2382,1023,2780,3711,2160,12056
2023-04-03,10,4407,2652,2004,1902,2339,13304
2023-04-04,10,2411,2261,3658,3418,5984,17732
2023-04-05,10,1400,2398,2059,3284,4230,13371
2023-04-06,10,4429,1481,3406,2507,3921,15744
2023-04-07,10,4555,1566,2378,3377,2346,14222
2023-04-08,10,3170,2933,2187,3321,2647,14258
2023-04-09,10,3734,2300,3333,4353,2141,15861
2023-04-10,10,1741,1330,2478,2674,4895,13118
2023-04-11,10,3043,998,3040,2303,2003,11387
2023-04-12,10,4628,1156,3937,4034,4625,18380
2023-04-13,10,2342,1410,1506,2562,5041,12861
2023-04-14,10,2144,948,1540,2524,5702,12858
2023-04-15,10,3844,2194,3001,3056,4405,16500
2023-04-16,10,4913,1950,2189,3898,3221,16171
2023-04-17,10,3017,2065,1808,1830,4150,12870
2023-04-18,10,1603,2984,2284,3516,3816,14203
2023-04-19,10,4367,2553,2976,1737,2979,14612
2023-04-20,10,2924,2568,2633,2453,4252,14830
2023-04-21,10,3430,994,2848,3469,2405,13146
2023-04-22,10,1451,823,2513,2127,5016,11930
2023-04-23,10,2578,2650,3011,4230,2181,14650
2023-04-24,10,2150,1798,1638,3711,3074,12371
2023-04-25,10,4411,2414,3686,3134,4240,17885
2023-04-26,10,3644,2813,1311,4137,2855,14760
2023-04-27,10,2513,1239,3582,2284,4796,14414
2023-04-28,10,4413,1448,3905,4322,3396,17484
2023-04-29,10,3402,1531,2382,3865,2821,14001
2023-04-30,10,1067,2283,2495,2364,4231,12440
2023-05-01,10,3457,1234,2342,2984,4805,14822
2023-05-02,10,2846,1571,1575,1924,4290,12206
2023-05-03,10,2908,805,3165,3299,2448,12625
2023-05-04,10,3612,2767,3614,3623,3972,17588
2023-05-05,10,3485,2069,2996,1904,5848,16302
2023-05-06,10,1902,1881,1983,3771,3364,12901
2023-05-07,10,1149,2787,4000,1825,2607,12368
2023-05-08,10,1946,2717,2822,3100,2555,13140
2023-05-09,10,1381,2220,3204,2213,2022,11040
2023-05-10,10,1695,2154,3804,3081,3129,13863
2023-05-11,10,1535,2626,3857,3027,5648,16693
2023-05-12,10,3064,2882,3287,2756,2885,14874
2023-05-13,10,1681,1876,3631,2783,4291,14262
2023-05-14,10,4670,2886,2432,2885,2576,15449
2023-05-15,10,4419,837,1236,2986,3694,13172
2023-05-16,10,2659,1292,2825,2530,4727,14033
2023-05-17,10,1256,1556,3039,4397,3915,14163
2023-05-18,10,4954,1031,3890,2994,3407,16276
2023-05-19,10,4058,1288,1776,1727,3078,11927
2023-05-20,10,1731,2977,3030,3699,5382,16819
2023-05-21,10,3441,1563,3548,3173,3324,15049
2023-05-22,10,4291,2205,3733,4443,3863,18535
2023-05-23,10,1695,2340,3364,3746,2677,13822
2023-05-24,10,3751,2785,2717,3327,5719,18299
2023-05-25,10,3486,2145,2321,2940,2164,13056
2023-05-26,10,1244,1241,2303,3196,2158,10142
2023-05-27,10,4876,2586,2333,3190,4024,17009
2023-05-28,10,1115,1472,2240,2498,2511,9836
2023-05-29,10,1547,2027,2967,3398,4015,13954
2023-05-30,10,3748,2039,2133,3786,5804,17510
2023-05-31,10,3883,1812,3422,3697,4330,17144
2023-06-01,10,3324,1539,2341,4073,4871,16148
2023-06-02,10,1521,1980,3607,3288,5840,16236
2023-06-03,10,3101,1561,2232,4399,3940,15233
2023-06-04,10,1886,2632,1323,3195,4226,13262
2023-06-05,10,2272,1060,2244,2248,2698,10522
2023-06-06,10,2742,1579,3209,2775,3640,13945
2023-06-07,10,4299,1896,3522,3991,3766,17474
2023-06-08,10,3143,1781,2724,2620,3397,13665
2023-06-09,10,3022,1512,1818,2756,2746,11854
2023-06-10,10,1779,2404,1539,2065,2856,10643
2023-06-11,10,1416,1758,2672,1538,3973,11357
2023-06-12,10,1733,2110,3111,4017,3500,14471
2023-06-13,10,2828,2626,2858,2811,4479,15602
2023-06-14,10,4584,2455,2081,2803,3500,15423
2023-06-15,10,4908,1429,3478,3437,2866,16118
2023-06-16,10,3321,818,3455,2386,3107,13087
2023-06-17,10,4721,2368,2806,2470,5105,17470
2023-06-18,10,3572,1259,2898,2058,2750,12537
2023-06-19,10,3922,2851,2433,2538,5657,17401
2023-06-20,10,2297,2873,2571,2137,3682,13560
2023-06-21,10,4449,2930,1729,4391,4003,17502
2023-06-22,10,1275,2379,1358,1810,4825,11647
2023-06-23,10,2242,1148,3964,3535,2346,13235
2023-06-24,10,4146,1592,3189,3532,2596,15055
2023-06-25,10,2005,915,2990,4397,5908,16215
2023-06-26,10,1360,1175,1582,4301,3874,12292
2023-06-27,10,1906,2656,1410,3391,5337,14700
2023-06-28,10,2432,1664,3013,2313,3405,12827
2023-06-29,10,4717,1020,1572,1707,3480,12496
2023-06-30,10,4182,1682,2843,3803,3818,16328
2023-07-01,10,4248,2888,2999,4214,5473,19822
2023-07-02,10,2477,2428,3195,3695,3444,15239
2023-07-03,10,4720,1923,2725,3920,3003,16291
2023-07-04,10,1932,1463,2373,3159,4664,13591
2023-07-05,10,4361,949,1723,2557,4658,14248
2023-07-06,10,3941,2762,2998,2492,2156,14349
2023-07-07,10,4850,1034,3143,3099,2965,15091
2023-07-08,10,3926,1967,3832,2477,3042,15244
2023-07-09,10,2659,1603,2053,3116,4077,13508
2023-07-10,10,1126,1143,1572,2582,5073,11496
2023-07-11,10,4115,2203,3962,1832,2278,14390
2023-07-12,10,1767,2561,2286,1715,2072,10401
2023-07-13,10,3634,2137,1407,2821,3232,13231
2023-07-14,10,4271,1808,2475,4469,5746,18769
2023-07-15,10,3247,2958,2137,1898,4010,14250
2023-07-16,10,3812,1614,2515,4168,3818,15927
2023-07-17,10,1020,2236,1286,2744,2087,9373
2023-07-18,10,4100,1853,3632,4127,3361,17073
2023-07-19,10,4268,2576,3145,3148,4113,17250
2023-07-20,10,1086,1261,2773,1954,5273,12347
2023-07-21,10,2207,844,2353,4491,3853,13748
2023-07-22,10,3578,2211,3537,3216,3864,16406
2023-07-23,10,4127,2106,3956,3684,4700,18573
2023-07-24,10,1875,2254,3290,1588,3973,12980
2023-07-25,10,2274,1980,1547,3523,5612,14936
2023-07-26,10,4602,1921,3303,2883,2303,15012
2023-07-27,10,3170,2092,2812,2403,4459,14936
2023-07-28,10,4830,1348,3766,1927,4644,16515
2023-07-29,10,4112,2042,1658,1950,2045,11807
2023-07-30,10,2580,1135,2393,3217,3285,12610
2023-07-31,10,1789,1424,3693,2476,3908,13290
2023-08-01,10,3153,2631,2149,1894,5912,15739
2023-08-02,10,3504,1775,1594,3512,3647,14032
2023-08-03,10,4286,1350,3203,1630,5978,16447
2023-08-04,10,3991,2533,3115,1599,5785,17023
2023-08-05,10,1933,2990,3994,2889,3643,15449
2023-08-06,10,3541,2968,3190,2233,4036,15968
2023-08-07,10,4754,1906,2926,2182,2319,14087
2023-08-08,10,4023,1771,3448,2121,2272,13635
2023-08-09,10,1713,2416,3654,4161,4834,16778
2023-08-10,10,3088,1357,1802,1975,4539,12761
2023-08-11,10,3890,1758,1418,4405,4967,16438
2023-08-12,10,4079,2070,3141,4086,5145,18521
2023-08-13,10,2258,966,1541,3012,4045,11822
2023-08-14,10,3317,933,1930,2369,4152,12701
2023-08-15,10,1489,847,1367,3007,4617,11327
2023-08-16,10,1915,1607,2429,3795,5371,15117
2023-08-17,10,4168,1049,2067,3784,5225,16293
2023-08-18,10,4867,1997,2360,1856,5965,17045
2023-08-19,10,1226,2308,1557,2596,3314,11001
2023-08-20,10,1561,2159,2678,1709,4772,12879
2023-08-21,10,4285,1690,2136,2628,5628,16367
2023-08-22,10,2211,2474,1834,3610,4284,14413
2023-08-23,10,2376,2357,3677,4341,4191,16942
2023-08-24,10,4796,2823,3770,3889,2895,18173
2023-08-25,10,1011,1903,2615,1578,2385,9492
2023-08-26,10,1842,805,3087,3466,2823,12023
2023-08-27,10,1904,2724,3080,1702,4397,13807
2023-08-28,10,4298,2205,3785,3627,3093,17008
2023-08-29,10,1382,2161,3543,3825,3195,14106
2023-08-30,10,3327,1734,1591,3875,4790,15317
2023-08-31,10,2865,2804,2858,4474,4036,17037
2023-09-01,10,2137,2815,2935,2858,2989,13734
2023-09-02,10,2169,877,2299,3812,4161,13318
2023-09-03,10,1473,1721,2471,3877,3477,13019
2023-09-04,10,3156,1503,1728,3554,4538,14479
2023-09-05,10,1994,2518,2860,2866,4644,14882
2023-09-06,10,2641,2272,2625,1674,2399,11611
2023-09-07,10,4218,1055,2501,1882,3889,13545
2023-09-08,10,1331,2415,1489,4281,5181,14697
2023-09-09,10,1548,2501,1430,3374,4271,13124
2023-09-10,10,1402,2586,1542,1852,4241,11623
2023-09-11,10,3889,2882,1657,4113,3361,15902
2023-09-12,10,2185,1695,2158,3648,4337,14023
2023-09-13,10,3285,1160,1345,2390,2062,10242
2023-09-14,10,1130,2501,1397,4083,3836,12947
2023-09-15,10,3296,1900,2255,1813,2402,11666
2023-09-16,10,4495,1102,1732,4263,2141,13733
2023-09-17,10,2209,2396,3543,1666,4057,13871
2023-09-18,10,2383,1932,2365,1925,3235,11840
2023-09-19,10,1460,1825,2112,1908,4224,11529
2023-09-20,10,1330,1364,2748,3360,5522,14324
2023-09-21,10,3312,2829,2555,2464,5163,16323
2023-09-22,10,2504,2536,1429,2624,2796,11889
2023-09-23,10,1373,2628,1345,1746,4352,11444
2023-09-24,10,3149,2722,2515,3562,3718,15666
2023-09-25,10,2073,909,3486,2702,3794,12964
2023-09-26,10,4020,1497,3468,2160,5004,16149
2023-09-27,10,2367,2240,1294,2739,2072,10712
2023-09-28,10,3273,847,1433,1507,3664,10724
2023-09-29,10,4508,2815,3824,3668,2418,17233
2023-09-30,10,4676,1528,2644,1672,5636,16156
2023-10-01,10,1159,2013,2252,4479,4022,13925
2023-10-02,10,2023,1544,3666,4029,5334,16596
2023-10-03,10,3578,1738,3380,1787,4073,14556
2023-10-04,10,4356,2036,2034,3228,4951,16605
2023-10-05,10,1620,1458,2706,3253,4908,13945
2023-10-06,10,3677,1274,1227,4084,2782,13044
2023-10-07,10,4473,2979,1963,2174,3171,14760
2023-10-08,10,4558,2542,3104,2002,4493,16699
2023-10-09,10,3732,1468,3660,3270,5856,17986
2023-10-10,10,1046,1451,3457,3103,4977,14034
2023-10-11,10,4596,2064,3327,3297,4810,18094
2023-10-12,10,4109,1992,1824,2538,4894,15357
2023-10-13,10,2899,1086,1591,1720,3587,10883
2023-10-14,10,2602,2659,3422,1620,3573,13876
2023-10-15,10,4958,941,2043,3608,2769,14319
2023-10-16,10,3725,1284,2940,2442,2319,12710
2023-10-17,10,4259,1548,2937,2502,2733,13979
2023-10-18,10,1731,2016,2234,2296,5490,13767
2023-10-19,10,3630,2346,2224,2934,2820,13954
2023-10-20,10,4697,1612,1282,4447,5085,17123
2023-10-21,10,1452,1273,1704,3776,4308,12513
2023-10-22,10,2667,1242,2725,3104,2240,11978
2023-10-23,10,1035,2599,2319,1826,2043,9822
2023-10-24,10,3852,1896,3574,1802,2808,13932
2023-10-25,10,1592,2224,2193,3431,2685,12125
2023-10-26,10,4423,1317,1339,2958,4554,14591
2023-10-27,10,4610,843,2171,3662,4653,15939
2023-10-28,10,2409,2672,3688,3487,2918,15174
2023-10-29,10,4574,2383,1378,2746,4854,15935
2023-10-30,10,1669,1446,3202,3891,4844,15052
2023-10-31,10,3580,917,1904,3695,4395,14491
2023-11-01,10,2669,2722,3775,3545,2311,15022
2023-11-02,10,1001,2683,3307,2249,4055,13295
2023-11-03,10,1572,883,2805,2793,4049,12102
2023-11-04,10,2754,1754,1372,2101,4760,12741
2023-11-05,10,2593,2928,3833,2210,5168,16732
2023-11-06,10,2468,2038,1702,3438,2966,12612
2023-11-07,10,2953,1551,3477,1825,4123,13929
2023-11-08,10,2296,2378,1886,3782,3736,14078
2023-11-09,10,4944,2759,2178,3752,5894,19527
2023-11-10,10,4461,1225,1737,2046,2106,11575
2023-11-11,10,3770,1388,1309,3593,4310,14370
2023-11-12,10,1791,1496,3797,3009,3056,13149
2023-11-13,10,4573,855,1665,3892,3368,14353
2023-11-14,10,3391,2402,1239,4006,4909,15947
2023-11-15,10,1397,1542,3515,4247,2223,12924
2023-11-16,10,1381,2922,1908,4185,5421,15817
2023-11-17,10,4727,2451,2865,1840,4557,16440
2023-11-18,10,4443,1435,3691,4151,4776,18496
2023-11-19,10,1026,2293,3402,3729,4036,14486
2023-11-20,10,1376,1844,1364,1778,3266,9628
2023-11-21,10,2305,1037,1410,3054,5257,13063
2023-11-22,10,1464,1724,1229,3492,4675,12584
2023-11-23,10,1445,1198,3912,2724,5488,14767
2023-11-24,10,3694,1783,2248,1831,4732,14288
2023-11-25,10,2615,2851,2352,2167,3577,13562
2023-11-26,10,3019,1994,3951,2875,2487,14326
2023-11-27,10,3153,2759,2126,1646,3212,12896
2023-11-28,10,2300,2761,2703,2442,5378,15584
2023-11-29,10,3482,1787,1719,3452,4766,15206
2023-11-30,10,1491,1634,2527,2363,3486,11501
2023-12-01,10,1029,2796,1661,3160,4675,13321
2023-12-02,10,2455,1664,2138,2810,2120,11187
2023-12-03,10,4718,1080,2792,3972,2597,15159
2023-12-04,10,4468,2506,3568,2700,4319,17561
2023-12-05,10,4953,1955,2709,2581,3549,15747
2023-12-06,10,3011,1906,1853,3614,4894,15278
2023-12-07,10,2891,2720,2696,2256,3524,14087
2023-12-08,10,3063,2689,2982,4064,4365,17163
2023-12-09,10,4283,2907,3752,3747,4863,19552
2023-12-10,10,3635,1288,1298,4106,4901,15228
2023-12-11,10,1954,2401,1226,1604,5687,12872
2023-12-12,10,1680,1488,1764,3976,3451,12359
2023-12-13,10,3633,2219,1547,2600,5448,15447
2023-12-14,10,1656,2935,3651,2211,5005,15458
2023-12-15,10,4547,1467,3983,4042,4630,18669
2023-12-16,10,3388,1601,2998,4294,5302,17583
2023-12-17,10,2366,2853,3303,2553,4713,15788
2023-12-18,10,3029,1520,3286,2421,5918,16174
2023-12-19,10,2452,1966,3992,4040,2525,14975
2023-12-20,10,4470,2438,1493,3350,4567,16318
2023-12-21,10,1510,2028,1940,2691,3121,11290
2023-12-22,10,2218,1400,2050,3708,4289,13665
2023-12-23,10,2045,2622,2146,2211,5885,14909
2023-12-24,10,4904,2986,1222,3542,3783,16437
2023-12-25,10,3881,2611,1953,2246,4263,14954
2023-12-26,10,2378,1656,3433,3018,3571,14056
2023-12-27,10,1752,1298,1994,4416,3360,12820
2023-12-28,10,3444,1999,1698,2891,3337,13369
2023-12-29,10,4528,2067,3469,3075,5754,18893
2023-12-30,10,3233,2314,2478,4184,3777,15986
2023-12-31,10,1916,1260,1307,3212,3304,10999
2022-01-01,11,4648,2729,2104,3714,5141,18336
2022-01-02,11,2417,849,2706,1703,2593,10268
2022-01-03,11,2084,1398,2588,2420,3575,12065
2022-01-04,11,1046,1296,2843,2671,4605,12461
2022-01-05,11,3673,2205,3357,3391,4348,16974
2022-01-06,11,2544,1314,2583,2517,5806,14764
2022-01-07,11,3736,2146,3128,3211,3045,15266
2022-01-08,11,4920,1098,2631,2495,3275,14419
2022-01-09,11,1534,1642,1513,4161,4298,13148
2022-01-10,11,1509,2689,1350,3252,5003,13803
2022-01-11,11,3368,1151,2919,3703,5610,16751
2022-01-12,11,4517,2549,3292,4233,3446,18037
2022-01-13,11,1248,1902,3129,3637,4005,13921
2022-01-14,11,1572,1780,1635,2134,5047,12168
2022-01-15,11,2745,2145,3989,3102,2076,14057
2022-01-16,11,2677,2829,2901,2372,4453,15232
2022-01-17,11,1087,2357,1983,2145,4877,12449
2022-01-18,11,4731,1801,1454,1623,2417,12026
2022-01-19,11,4729,1414,1398,2220,3777,13538
2022-01-20,11,1433,1401,1218,1805,5603,11460
2022-01-21,11,2953,1852,1255,2016,2608,10684
2022-01-22,11,3392,1140,2097,2743,4688,14060
2022-01-23,11,1150,2521,2693,3437,4239,14040
2022-01-24,11,4532,2434,2037,1699,5968,16670
2022-01-25,11,1241,1892,3591,4300,4356,15380
2022-01-26,11,4562,1700,1815,3577,4843,16497
2022-01-27,11,2218,2246,3568,3169,3732,14933
2022-01-28,11,4262,1933,1297,1904,5025,14421
2022-01-29,11,3146,2845,2706,2588,3151,14436
2022-01-30,11,1068,2907,3639,3205,3918,14737
2022-01-31,11,4841,2774,1251,1991,2435,13292
2022-02-01,11,3841,1814,2419,2262,2500,12836
2022-02-02,11,4528,2387,3807,3873,2077,16672
2022-02-03,11,4604,2344,3315,2683,3011,15957
2022-02-04,11,3275,1063,2365,2575,2462,11740
2022-02-05,11,2330,1680,3251,2384,2761,12406
2022-02-06,11,3848,2217,3651,2526,2752,14994
2022-02-07,11,2178,1877,2282,2215,2949,11501
2022-02-08,11,1754,2568,2761,2029,5575,14687
2022-02-09,11,2602,1382,3146,2725,2582,12437
2022-02-10,11,4179,2263,1294,3580,2914,14230
2022-02-11,11,3738,910,2049,3510,2567,12774
2022-02-12,11,3010,1564,2912,3603,5228,16317
2022-02-13,11,1342,2162,2939,2073,5769,14285
2022-02-14,11,4153,919,2922,2178,4857,15029
2022-02-15,11,3576,2369,2908,2496,3727,15076
2022-02-16,11,1244,1428,3867,4468,4926,15933
2022-02-17,11,3244,2089,3829,4389,5288,18839
2022-02-18,11,4019,1295,2739,4069,4632,16754
2022-02-19,11,2175,2236,2420,2988,4880,14699
2022-02-20,11,4394,2864,1698,2648,3743,15347
2022-02-21,11,3425,1588,1495,2534,2419,11461
2022-02-22,11,4964,2092,3887,3240,4143,18326
2022-02-23,11,4475,2757,2478,3959,5328,18997
2022-02-24,11,3283,2007,3218,3053,4983,16544
2022-02-25,11,3115,2041,1912,4173,4743,15984
2022-02-26,11,3368,2486,2633,3498,3109,15094
2022-02-27,11,4167,2700,3680,2921,4480,17948
2022-02-28,11,1674,2425,1288,1846,5337,12570
2022-03-01,11,2786,2226,3107,2566,4371,15056
2022-03-02,11,3030,1985,3426,1848,2652,12941
2022-03-03,11,2327,1853,3398,1686,4228,13492
2022-03-04,11,3764,2105,3614,3437,2342,15262
2022-03-05,11,3667,2888,3377,1826,3646,15404
2022-03-06,11,4532,1966,2094,2425,4538,15555
2022-03-07,11,1551,2200,1341,2860,3768,11720
2022-03-08,11,4390,2120,1966,3698,5235,17409
2022-03-09,11,1842,2434,2998,4398,2447,14119
2022-03-10,11,1160,1833,2156,4481,2291,11921
2022-03-11,11,4859,2146,1473,3105,3556,15139
2022-03-12,11,4877,2503,3087,3199,2367,16033
2022-03-13,11,2986,1627,1254,2249,2435,10551
2022-03-14,11,1858,2864,2454,3314,2044,12534
2022-03-15,11,2383,1542,2247,3752,3350,13274
2022-03-16,11,2685,1305,1847,2313,4367,12517
2022-03-17,11,2320,2397,3333,4378,2957,15385
2022-03-18,11,3020,2140,3588,3897,4593,17238
2022-03-19,11,3734,1281,2988,2795,5862,16660
2022-03-20,11,2083,2145,1856,3959,5932,15975
2022-03-21,11,2467,1123,3568,1943,2059,11160
2022-03-22,11,2716,2661,2214,2651,4548,14790
2022-03-23,11,2865,1154,1678,3951,2658,12306
2022-03-24,11,1447,879,2385,4286,4864,13861
2022-03-25,11,2175,1203,3388,2470,4201,13437
2022-03-26,11,1653,887,3263,2207,3200,11210
2022-03-27,11,1064,2825,1487,1934,5518,12828
2022-03-28,11,4538,2060,1566,4492,3793,16449
2022-03-29,11,2788,1345,3818,3170,3236,14357
2022-03-30,11,2863,1215,3251,2267,4130,13726
2022-03-31,11,4015,1328,3965,2907,4556,16771
2022-04-01,11,3096,2164,1733,3515,5027,15535
2022-04-02,11,1548,1106,1405,3324,5925,13308
2022-04-03,11,1050,2193,1383,2593,5593,12812
2022-04-04,11,2724,2265,2498,2078,2331,11896
2022-04-05,11,4254,935,1832,4384,5058,16463
2022-04-06,11,3561,1718,1376,4151,5833,16639
2022-04-07,11,4750,2997,3419,3171,5162,19499
2022-04-08,11,2341,1567,1451,2957,5366,13682
2022-04-09,11,2138,1344,1351,1763,4010,10606
2022-04-10,11,1109,1137,1766,2535,2783,9330
2022-04-11,11,2449,1785,2025,1730,5665,13654
2022-04-12,11,4528,1582,3601,4417,2703,16831
2022-04-13,11,3376,1660,2184,4475,2633,14328
2022-04-14,11,3102,1563,2274,3131,3313,13383
2022-04-15,11,3005,2490,2317,3994,5457,17263
2022-04-16,11,1286,1097,2132,2192,5961,12668
2022-04-17,11,2634,1495,2906,2357,3553,12945
2022-04-18,11,2868,2826,1736,2142,5723,15295
2022-04-19,11,3057,2101,1962,4150,5053,16323
2022-04-20,11,1645,2177,2768,2469,4322,13381
2022-04-21,11,1752,1869,1436,3585,3300,11942
2022-04-22,11,4846,1302,1232,1506,4927,13813
2022-04-23,11,1410,964,3542,4164,5808,15888
2022-04-24,11,2930,1246,2394,2241,4523,13334
2022-04-25,11,1437,802,2846,4154,4470,13709
2022-04-26,11,3372,2792,3397,3193,4729,17483
2022-04-27,11,3981,839,2639,2859,4181,14499
2022-04-28,11,2758,2711,1902,1767,2517,11655
2022-04-29,11,2002,2312,2145,2161,4704,13324
2022-04-30,11,2791,2796,1598,2875,3781,13841
2022-05-01,11,4257,2818,3611,3447,5423,19556
2022-05-02,11,4319,1454,3521,3768,2888,15950
2022-05-03,11,4510,1870,1350,3899,5120,16749
2022-05-04,11,3984,2468,2703,2266,5781,17202
2022-05-05,11,4264,2304,3958,3183,5403,19112
2022-05-06,11,2497,1850,2028,2500,3531,12406
2022-05-07,11,1407,2647,3073,2326,3541,12994
2022-05-08,11,1934,2642,2367,2272,2113,11328
2022-05-09,11,3628,1566,2052,3563,4735,15544
2022-05-10,11,1223,2324,1657,2647,2526,10377
2022-05-11,11,1011,1527,3550,1971,4742,12801
2022-05-12,11,2998,2650,1512,3280,3835,14275
2022-05-13,11,2161,1885,3145,3760,3202,14153
2022-05-14,11,1010,1011,1487,2264,3345,9117
2022-05-15,11,4582,1393,2567,1901,3002,13445
2022-05-16,11,1397,1646,1860,2374,4203,11480
2022-05-17,11,4276,2780,2183,2730,4139,16108
2022-05-18,11,2762,2353,2884,3247,2850,14096
2022-05-19,11,4477,2582,3866,3913,3664,18502
2022-05-20,11,2766,2829,2502,2317,2807,13221
2022-05-21,11,3061,2179,3510,3626,4576,16952
2022-05-22,11,4692,2210,2018,1543,4750,15213
2022-05-23,11,4312,2388,2487,1903,3334,14424
2022-05-24,11,4418,1697,3888,2276,4679,16958
2022-05-25,11,1036,2274,2161,4473,5946,15890
2022-05-26,11,1293,930,1360,1606,3229,8418
2022-05-27,11,1933,1027,2805,3232,4279,13276
2022-05-28,11,3658,1716,3018,1598,5049,15039
2022-05-29,11,2042,2806,2848,3717,5089,16502
2022-05-30,11,1813,2790,1794,3183,2767,12347
2022-05-31,11,4286,2520,3401,3883,5895,19985
2022-06-01,11,3577,2913,1445,2877,5495,16307
2022-06-02,11,2815,1287,2347,2626,2488,11563
2022-06-03,11,3705,2139,3501,4432,3215,16992
2022-06-04,11,2707,1282,3338,2385,3582,13294
2022-06-05,11,2974,2926,1569,4253,4942,16664
2022-06-06,11,4623,2911,3994,3841,5457,20826
2022-06-07,11,3947,2490,1624,1786,2527,12374
2022-06-08,11,3531,1188,2785,3680,5639,16823
2022-06-09,11,2245,1158,3058,2665,2376,11502
2022-06-10,11,3508,1954,3029,3376,3319,15186
2022-06-11,11,2271,2503,2173,1950,5148,14045
2022-06-12,11,1311,2769,1290,3520,4044,12934
2022-06-13,11,4334,1879,1866,4138,3071,15288
2022-06-14,11,2678,981,3865,2749,4050,14323
2022-06-15,11,3317,896,1490,3063,2460,11226
2022-06-16,11,2906,1071,2340,2741,2102,11160
2022-06-17,11,2469,1306,3391,1654,4434,13254
2022-06-18,11,3879,1164,3470,4222,3495,16230
2022-06-19,11,1145,2308,3120,2442,5759,14774
2022-06-20,11,4004,931,2327,3200,3161,13623
2022-06-21,11,1991,989,2955,4260,4615,14810
2022-06-22,11,4625,1852,1252,3362,5527,16618
2022-06-23,11,2506,1496,1810,2728,2872,11412
2022-06-24,11,2476,2955,2329,2934,5996,16690
2022-06-25,11,1362,2367,2880,2248,4528,13385
2022-06-26,11,1847,2309,3711,2336,5908,16111
2022-06-27,11,1511,1176,3482,4190,3910,14269
2022-06-28,11,2778,982,1644,3365,3015,11784
2022-06-29,11,3474,861,1203,1818,3266,10622
2022-06-30,11,3036,1269,2593,2550,3657,13105
2022-07-01,11,3840,2681,2881,2852,4736,16990
2022-07-02,11,1053,2241,3865,1716,3140,12015
2022-07-03,11,2600,2222,2456,3552,4319,15149
2022-07-04,11,4108,958,2675,2061,5745,15547
2022-07-05,11,3975,1058,2505,1675,2347,11560
2022-07-06,11,1967,1165,2939,3668,5398,15137
2022-07-07,11,1878,2985,2379,2324,2492,12058
2022-07-08,11,4714,2223,2839,3059,5856,18691
2022-07-09,11,3677,1995,3975,1594,2191,13432
2022-07-10,11,2283,1922,3813,2066,3366,13450
2022-07-11,11,4086,1021,1411,3288,3771,13577
2022-07-12,11,3021,985,2180,1971,2804,10961
2022-07-13,11,4675,2886,1917,2498,4586,16562
2022-07-14,11,1158,1768,3259,2606,2631,11422
2022-07-15,11,2114,1995,3800,2365,2639,12913
2022-07-16,11,2975,1062,1814,3974,2648,12473
2022-07-17,11,2820,1417,2858,4467,3741,15303
2022-07-18,11,2649,1107,3916,4283,3063,15018
2022-07-19,11,3957,1701,1432,3179,3181,13450
2022-07-20,11,3872,1207,1434,1728,4376,12617
2022-07-21,11,3399,1574,2514,4454,4052,15993
2022-07-22,11,3987,1064,2242,3058,5186,15537
2022-07-23,11,1829,2080,3703,3038,4701,15351
2022-07-24,11,1571,800,2794,2193,4429,11787
2022-07-25,11,1847,1069,2507,3815,3628,12866
2022-07-26,11,4661,2129,2929,2471,2413,14603
2022-07-27,11,3228,2034,1803,1925,2881,11871
2022-07-28,11,3887,1760,2021,1895,2593,12156
2022-07-29,11,3557,2074,1457,3983,5591,16662
2022-07-30,11,3011,2005,3141,1838,4877,14872
2022-07-31,11,1270,2028,3161,2939,3272,12670
2022-08-01,11,1828,987,3307,3777,2090,11989
2022-08-02,11,2144,2394,2261,3205,4980,14984
2022-08-03,11,3797,1734,1847,1945,4568,13891
2022-08-04,11,3690,2428,1798,1969,4717,14602
2022-08-05,11,3238,2755,3061,3901,5536,18491
2022-08-06,11,4751,2996,2349,3266,3538,16900
2022-08-07,11,4229,1250,2136,2835,5875,16325
2022-08-08,11,4164,997,2381,3706,5243,16491
2022-08-09,11,1710,2947,2155,2408,2170,11390
2022-08-10,11,1015,2888,1888,4496,2409,12696
2022-08-11,11,1063,2266,1570,3307,3288,11494
2022-08-12,11,3751,2910,3993,1879,4079,16612
2022-08-13,11,1442,2640,2678,2358,2471,11589
2022-08-14,11,2658,1769,3631,3871,3212,15141
2022-08-15,11,4997,2753,1683,2851,2380,14664
2022-08-16,11,3292,1255,2686,2981,3563,13777
2022-08-17,11,3270,2014,3276,4243,4930,17733
2022-08-18,11,2936,2253,3227,2582,2289,13287
2022-08-19,11,4004,1375,1881,3124,3310,13694
2022-08-20,11,2855,942,2335,2094,4135,12361
2022-08-21,11,4609,1219,1496,2179,4737,14240
2022-08-22,11,1964,1225,1437,3054,4479,12159
2022-08-23,11,3195,2255,2209,4311,4962,16932
2022-08-24,11,2449,832,2169,4072,2280,11802
2022-08-25,11,1723,1408,1770,2855,3449,11205
2022-08-26,11,1031,2382,3219,3932,5267,15831
2022-08-27,11,1456,2454,2088,1745,3089,10832
2022-08-28,11,3087,2881,2567,3277,5510,17322
2022-08-29,11,3796,1979,3137,4358,2945,16215
2022-08-30,11,4664,1430,3232,1940,4612,15878
2022-08-31,11,1595,1989,2060,1539,4002,11185
2022-09-01,11,2550,1200,3352,3541,4089,14732
2022-09-02,11,4543,2268,3599,1994,5583,17987
2022-09-03,11,2770,2667,2449,3935,5421,17242
2022-09-04,11,4796,2720,1438,2524,3428,14906
2022-09-05,11,2307,1755,3727,2840,2146,12775
2022-09-06,11,1618,2108,3072,2849,4695,14342
2022-09-07,11,3788,1286,1444,4435,2227,13180
2022-09-08,11,2471,2630,3861,4090,5397,18449
2022-09-09,11,2018,1032,3876,3609,5417,15952
2022-09-10,11,4116,1422,1605,3524,4942,15609
2022-09-11,11,1565,1985,3231,4281,5781,16843
2022-09-12,11,1413,1191,1718,4256,3866,12444
2022-09-13,11,3521,1545,2779,1843,3066,12754
2022-09-14,11,4779,1063,2812,2049,4165,14868
2022-09-15,11,3499,1764,3222,3169,3644,15298
2022-09-16,11,4962,2189,3233,2778,4773,17935
2022-09-17,11,2392,2058,3530,3478,3572,15030
2022-09-18,11,2812,2836,3387,1704,4267,15006
2022-09-19,11,1550,2438,2269,4300,2780,13337
2022-09-20,11,4823,1262,3457,2677,3437,15656
2022-09-21,11,3467,1354,2748,1895,2231,11695
2022-09-22,11,2975,942,2707,3452,2363,12439
2022-09-23,11,2704,1363,2282,2092,4241,12682
2022-09-24,11,4214,2327,3077,2584,5898,18100
2022-09-25,11,1128,1241,3285,4162,2597,12413
2022-09-26,11,1740,1263,2459,3505,3592,12559
2022-09-27,11,2943,1458,2658,2072,5948,15079
2022-09-28,11,1806,1986,1260,2715,4896,12663
2022-09-29,11,2966,2499,2475,3626,3656,15222
2022-09-30,11,4577,2643,2830,1677,4140,15867
2022-10-01,11,2722,1526,2332,4091,3184,13855
2022-10-02,11,2365,2619,3619,3396,4483,16482
2022-10-03,11,3848,2947,3491,3276,2048,15610
2022-10-04,11,1829,1706,2052,3304,4775,13666
2022-10-05,11,2250,2705,3205,2349,4993,15502
2022-10-06,11,4671,2184,1342,4476,3961,16634
2022-10-07,11,4425,1947,1595,2646,5819,16432
2022-10-08,11,2136,2094,1564,3690,4915,14399
2022-10-09,11,3913,1226,2159,2801,2983,13082
2022-10-10,11,2685,2178,1690,3735,3911,14199
2022-10-11,11,4899,2343,1555,2576,5539,16912
2022-10-12,11,3328,1850,1788,3356,4007,14329
2022-10-13,11,3849,1321,3159,4465,3938,16732
2022-10-14,11,2688,1084,2948,3373,5506,15599
2022-10-15,11,3263,966,3060,3096,4180,14565
2022-10-16,11,2426,2002,2070,1533,4938,12969
2022-10-17,11,3616,1072,3748,2387,3617,14440
2022-10-18,11,4175,2611,3289,3290,2273,15638
2022-10-19,11,2770,1111,2640,4441,3847,14809
2022-10-20,11,3477,1256,1764,3364,2340,12201
2022-10-21,11,4494,1586,3743,1748,2932,14503
2022-10-22,11,1180,2119,2242,2045,4578,12164
2022-10-23,11,3130,2646,1871,3001,2997,13645
2022-10-24,11,4153,2322,2957,2360,5301,17093
2022-10-25,11,1147,897,3957,1692,2194,9887
2022-10-26,11,1790,1819,1502,3688,5695,14494
2022-10-27,11,3251,1396,1399,4414,5481,15941
2022-10-28,11,3437,1059,2817,3625,5322,16260
2022-10-29,11,2734,2442,2949,1855,5576,15556
2022-10-30,11,1496,1467,1659,2070,3929,10621
2022-10-31,11,2748,2879,1484,3997,3831,14939
2022-11-01,11,3712,2262,3212,3699,4413,17298
2022-11-02,11,3724,2671,3162,1878,3598,15033
2022-11-03,11,4441,2698,3587,2513,3418,16657
2022-11-04,11,3198,1985,1920,3543,4874,15520
2022-11-05,11,4908,1374,3048,1856,4242,15428
2022-11-06,11,4290,2853,2056,1846,2157,13202
2022-11-07,11,3533,1767,2078,3993,4655,16026
2022-11-08,11,3397,1609,3731,2085,5158,15980
2022-11-09,11,4933,1383,2492,2890,3739,15437
2022-11-10,11,4954,2195,3907,4380,3247,18683
2022-11-11,11,4617,1804,1302,1627,3150,12500
2022-11-12,11,2385,2680,1613,3132,4346,14156
2022-11-13,11,1527,1818,2494,3092,4708,13639
2022-11-14,11,2552,863,1328,3444,2838,11025
2022-11-15,11,2336,1773,3629,2736,3856,14330
2022-11-16,11,3718,1118,2975,3361,2949,14121
2022-11-17,11,1402,2655,3814,3137,4177,15185
2022-11-18,11,4738,1403,1894,3279,2231,13545
2022-11-19,11,3000,2605,1853,2583,4750,14791
2022-11-20,11,3480,2610,3744,2693,2069,14596
2022-11-21,11,4689,1480,2909,3944,2896,15918
2022-11-22,11,1975,2783,2140,1800,5548,14246
2022-11-23,11,3917,1103,1632,2407,3053,12112
2022-11-24,11,1019,2544,3156,3378,5046,15143
2022-11-25,11,4059,1034,1963,1926,3386,12368
2022-11-26,11,3291,2981,2240,3588,5582,17682
2022-11-27,11,1628,827,3365,4458,5364,15642
2022-11-28,11,4774,1412,3830,3821,4681,18518
2022-11-29,11,3626,1126,3046,2222,4511,14531
2022-11-30,11,3085,2985,1955,1698,4838,14561
2022-12-01,11,3731,1314,2699,2656,4780,15180
2022-12-02,11,1281,2801,2721,2357,3812,12972
2022-12-03,11,4821,2260,1270,2044,2390,12785
2022-12-04,11,4651,1265,2267,3261,4018,15462
2022-12-05,11,2403,2218,3586,3492,3892,15591
2022-12-06,11,2447,2505,2692,2459,4319,14422
2022-12-07,11,2698,983,3105,1796,2470,11052
2022-12-08,11,1716,2867,2437,1858,4470,13348
2022-12-09,11,4348,2099,1343,3669,3946,15405
2022-12-10,11,1510,2349,1540,4235,4208,13842
2022-12-11,11,1144,2024,2736,4334,4107,14345
2022-12-12,11,2346,889,3457,3139,5512,15343
2022-12-13,11,1287,1780,3798,3921,2126,12912
2022-12-14,11,4613,1884,1543,1583,5980,15603
2022-12-15,11,1353,2053,2400,3150,5767,14723
2022-12-16,11,1933,1537,3163,2117,2813,11563
2022-12-17,11,3079,2553,1836,4303,5952,17723
2022-12-18,11,1075,2802,1699,2869,4275,12720
2022-12-19,11,3674,2518,1659,2596,2616,13063
2022-12-20,11,2591,1957,2892,2847,3990,14277
2022-12-21,11,1561,1032,2694,2351,4509,12147
2022-12-22,11,1899,1750,1815,1576,5820,12860
2022-12-23,11,4406,1651,2773,3208,2328,14366
2022-12-24,11,4146,1366,2254,3496,3568,14830
2022-12-25,11,2465,824,3928,1500,2023,10740
2022-12-26,11,1387,1556,3991,1695,2691,11320
2022-12-27,11,1526,1269,1541,3023,3610,10969
2022-12-28,11,2097,1719,3708,3946,5077,16547
2022-12-29,11,1473,2872,3489,1936,5743,15513
2022-12-30,11,4690,2735,3236,1946,5789,18396
2022-12-31,11,4411,1219,2049,3899,4543,16121
2023-01-01,11,4913,2988,3286,4138,4748,20073
2023-01-02,11,1549,1378,3868,1692,2618,11105
2023-01-03,11,2416,1095,3718,3200,2226,12655
2023-01-04,11,1875,881,1237,2967,4148,11108
2023-01-05,11,3965,2568,2696,3949,3282,16460
2023-01-06,11,4893,1158,1833,3618,4852,16354
2023-01-07,11,3054,1858,2185,1925,2737,11759
2023-01-08,11,1334,2184,1436,3799,3616,12369
2023-01-09,11,4582,887,3829,4357,4342,17997
2023-01-10,11,1604,2785,2776,3128,2018,12311
2023-01-11,11,1062,1495,2208,1920,3138,9823
2023-01-12,11,1790,2193,2211,4173,2358,12725
2023-01-13,11,4193,2699,3931,4006,4490,19319
2023-01-14,11,2685,1120,1536,4466,2015,11822
2023-01-15,11,1940,2092,2527,2509,3901,12969
2023-01-16,11,2203,2129,1482,4127,5425,15366
2023-01-17,11,4810,1793,2155,2649,4850,16257
2023-01-18,11,3712,2360,1851,3262,2724,13909
2023-01-19,11,1069,2357,3500,2276,3778,12980
2023-01-20,11,1849,2779,2253,3352,4419,14652
2023-01-21,11,4416,2171,2436,4045,5879,18947
2023-01-22,11,4153,2621,3662,3918,2131,16485
2023-01-23,11,1402,812,2268,1652,2518,8652
2023-01-24,11,1943,905,2369,1576,3343,10136
2023-01-25,11,3768,2831,2462,3257,5906,18224
2023-01-26,11,2174,2150,3431,3010,4291,15056
2023-01-27,11,3353,1748,2358,2599,5625,15683
2023-01-28,11,2819,2067,2672,2756,2231,12545
2023-01-29,11,4126,1187,3154,2136,3581,14184
2023-01-30,11,3232,1363,1318,1571,3152,10636
2023-01-31,11,4240,1824,2864,3634,3122,15684
2023-02-01,11,4780,842,2437,3136,3399,14594
2023-02-02,11,3840,1281,1351,1547,2922,10941
2023-02-03,11,1426,2325,2380,3718,5410,15259
2023-02-04,11,4502,2228,3025,2973,3122,15850
2023-02-05,11,3235,1950,2324,3702,3500,14711
2023-02-06,11,4806,1996,1582,1989,2542,12915
2023-02-07,11,4556,2924,1999,4097,2058,15634
2023-02-08,11,4922,1540,3742,2855,5016,18075
2023-02-09,11,2230,1561,3536,2410,4222,13959
2023-02-10,11,1119,2941,1722,2538,5886,14206
2023-02-11,11,1552,1227,3702,1720,5801,14002
2023-02-12,11,3569,1702,2628,2246,5625,15770
2023-02-13,11,2456,1731,2936,1526,2149,10798
2023-02-14,11,3942,1572,1288,3344,2252,12398
2023-02-15,11,2540,1622,3551,1585,2813,12111
2023-02-16,11,3878,2144,2253,2953,2153,13381
2023-02-17,11,1399,1119,2861,3279,4184,12842
2023-02-18,11,3323,1615,3577,3073,2074,13662
2023-02-19,11,4019,1987,1620,2385,3771,13782
2023-02-20,11,4930,2400,3345,2086,4995,17756
2023-02-21,11,2715,1259,3906,3049,3191,14120
2023-02-22,11,3393,1486,3782,2617,3381,14659
2023-02-23,11,1773,2338,1269,3030,4015,12425
2023-02-24,11,2956,2891,1279,4341,5225,16692
2023-02-25,11,4845,1700,2642,3257,5591,18035
2023-02-26,11,4239,2996,2008,2030,2232,13505
2023-02-27,11,2512,1492,3523,2228,5526,15281
2023-02-28,11,3250,1416,1927,3752,5250,15595
2023-03-01,11,2978,2741,2465,4279,4835,17298
2023-03-02,11,4155,2548,3609,3268,5507,19087
2023-03-03,11,4360,2083,2001,4043,5005,17492
2023-03-04,11,2118,2652,1452,3784,2709,12715
2023-03-05,11,4105,2690,2927,1604,4730,16056
2023-03-06,11,4204,1201,2517,2248,2685,12855
2023-03-07,11,3555,2103,2514,3745,2170,14087
2023-03-08,11,2139,2260,1992,3828,2890,13109
2023-03-09,11,3763,1677,2309,3440,2885,14074
2023-03-10,11,3692,1616,2816,2729,4482,15335
2023-03-11,11,2799,2696,2986,2096,4630,15207
2023-03-12,11,3148,2310,2618,4303,4825,17204
2023-03-13,11,3140,1575,2577,2158,3348,12798
2023-03-14,11,1495,2269,1951,3132,4476,13323
2023-03-15,11,1286,2038,1309,3885,2450,10968
2023-03-16,11,4381,1498,2964,3208,2498,14549
2023-03-17,11,2364,2089,3347,2976,2237,13013
2023-03-18,11,2077,1615,1266,1796,5429,12183
2023-03-19,11,4584,1232,1684,4263,2288,14051
2023-03-20,11,2967,1504,3565,2331,3409,13776
2023-03-21,11,4321,2811,3319,2189,4507,17147
2023-03-22,11,4448,2461,1561,3189,4975,16634
2023-03-23,11,1059,2284,2894,2844,4437,13518
2023-03-24,11,4929,1796,3343,2407,4467,16942
2023-03-25,11,2531,890,1986,4471,5830,15708
2023-03-26,11,4505,2074,1667,2842,3304,14392
2023-03-27,11,2915,1792,3317,2246,2490,12760
2023-03-28,11,1293,1136,3127,2111,3198,10865
2023-03-29,11,1659,1634,2879,1661,2968,10801
2023-03-30,11,4188,1434,1461,3467,2079,12629
2023-03-31,11,1539,1723,2474,2844,3760,12340
2023-04-01,11,3900,1474,3469,3123,3072,15038
2023-04-02,11,2899,940,2909,1872,5333,13953
2023-04-03,11,2131,984,3908,2330,4308,13661
2023-04-04,11,3655,2379,1200,2412,5890,15536
2023-04-05,11,3854,910,1940,1834,4706,13244
2023-04-06,11,4804,1613,3292,3918,3124,16751
2023-04-07,11,4648,2148,3101,3411,4554,17862
2023-04-08,11,1732,2569,3215,3872,3781,15169
2023-04-09,11,3767,1285,2953,2428,4827,15260
2023-04-10,11,2800,927,2491,2901,4420,13539
2023-04-11,11,1307,1925,2295,2130,3557,11214
2023-04-12,11,2918,916,3902,4001,2819,14556
2023-04-13,11,1504,1395,3836,2969,4753,14457
2023-04-14,11,2394,2047,1963,4035,4664,15103
2023-04-15,11,1345,1443,1870,3402,5409,13469
2023-04-16,11,3465,1810,3822,3457,2471,15025
2023-04-17,11,3126,1681,1593,3999,3272,13671
2023-04-18,11,2291,2444,1711,1903,5137,13486
2023-04-19,11,1170,965,3771,3333,5019,14258
2023-04-20,11,3102,1057,1949,4474,3953,14535
2023-04-21,11,4030,1442,2666,3780,5756,17674
2023-04-22,11,1458,1342,3151,1696,3615,11262
2023-04-23,11,2399,1401,1688,3049,2245,10782
2023-04-24,11,1037,1019,2701,3717,3564,12038
2023-04-25,11,2892,857,2670,1779,4207,12405
2023-04-26,11,1617,1979,1533,3383,3590,12102
2023-04-27,11,1508,2680,3912,3949,4909,16958
2023-04-28,11,4318,1963,2540,1754,3432,14007
2023-04-29,11,4112,2081,3030,3339,3617,16179
2023-04-30,11,2019,1983,3406,2425,5287,15120
2023-05-01,11,1903,940,1671,2727,4889,12130
2023-05-02,11,2128,2417,3454,2147,3369,13515
2023-05-03,11,2198,2758,1923,2095,2960,11934
2023-05-04,11,2787,1379,2098,2969,5094,14327
2023-05-05,11,3046,1453,2440,2127,2298,11364
2023-05-06,11,3411,2543,1367,3694,2291,13306
2023-05-07,11,1800,1820,3777,3384,4046,14827
2023-05-08,11,4490,1871,1824,2535,5605,16325
2023-05-09,11,2981,1541,3451,1523,4951,14447
2023-05-10,11,4409,2669,3700,3938,3942,18658
2023-05-11,11,1519,2244,1709,1999,5757,13228
2023-05-12,11,1598,1368,2101,3340,3773,12180
2023-05-13,11,3333,2569,2771,2397,2567,13637
2023-05-14,11,1326,960,1854,1845,2715,8700
2023-05-15,11,3160,1700,2847,3376,3536,14619
2023-05-16,11,2058,1441,1743,2373,2982,10597
2023-05-17,11,2310,2027,1942,1581,3087,10947
2023-05-18,11,3408,2301,2203,1500,3882,13294
2023-05-19,11,2236,2619,2802,2945,4932,15534
2023-05-20,11,3393,2121,2339,1688,3043,12584
2023-05-21,11,4404,1170,2631,1790,5093,15088
2023-05-22,11,4968,834,1290,1519,4618,13229
2023-05-23,11,2921,2380,2572,1906,4549,14328
2023-05-24,11,2281,2851,1423,2955,2645,12155
2023-05-25,11,4241,2485,2337,3638,2892,15593
2023-05-26,11,1866,2014,2300,3597,5767,15544
2023-05-27,11,3240,2646,2643,3846,4870,17245
2023-05-28,11,4396,1985,2431,2355,5772,16939
2023-05-29,11,2778,2453,3094,2422,5240,15987
2023-05-30,11,1376,1337,2265,3544,2633,11155
2023-05-31,11,2239,972,3896,3631,5713,16451
2023-06-01,11,2396,1442,2558,3909,2768,13073
2023-06-02,11,3286,990,2731,2572,4064,13643
2023-06-03,11,1498,1240,3394,4424,5868,16424
2023-06-04,11,1588,1324,3088,2675,3819,12494
2023-06-05,11,2554,1571,2813,4342,3510,14790
2023-06-06,11,2634,2876,3088,2994,3090,14682
2023-06-07,11,2053,2229,3025,1605,2436,11348
2023-06-08,11,4128,864,2121,3380,2903,13396
2023-06-09,11,4993,2280,2094,3852,5451,18670
2023-06-10,11,2462,2872,3746,3208,3386,15674
2023-06-11,11,4810,2505,1773,4186,5191,18465
2023-06-12,11,4283,2538,1913,3245,2985,14964
2023-06-13,11,4439,2152,2913,1618,3745,14867
2023-06-14,11,2109,2908,1912,3834,4837,15600
2023-06-15,11,1409,2003,2029,2773,5812,14026
2023-06-16,11,2288,1599,1325,2067,4553,11832
2023-06-17,11,4563,1428,1251,2318,2265,11825
2023-06-18,11,1393,1910,2863,3241,2695,12102
2023-06-19,11,2054,1420,1909,3956,3414,12753
2023-06-20,11,4167,2223,2680,4088,5253,18411
2023-06-21,11,3447,906,1400,3372,3717,12842
2023-06-22,11,4290,1295,3581,3755,4221,17142
2023-06-23,11,3839,1544,2118,3163,2116,12780
2023-06-24,11,3351,2407,2873,2586,2457,13674
2023-06-25,11,3959,2937,3732,2254,3503,16385
2023-06-26,11,1928,2136,3165,1700,4109,13038
2023-06-27,11,4996,1140,1671,1553,5920,15280
2023-06-28,11,4941,1244,3037,2815,5070,17107
2023-06-29,11,1199,2221,3632,2021,2276,11349
2023-06-30,11,2085,1639,1610,3099,3984,12417
2023-07-01,11,3360,2311,3396,2821,4283,16171
2023-07-02,11,3663,2910,1965,2160,2524,13222
2023-07-03,11,4781,2395,3555,2883,3887,17501
2023-07-04,11,4193,910,1710,2395,5531,14739
2023-07-05,11,1887,2975,2723,2407,3274,13266
2023-07-06,11,1105,2499,2506,2191,4897,13198
2023-07-07,11,3727,819,1729,4428,3925,14628
2023-07-08,11,3134,1810,2132,4355,5734,17165
2023-07-09,11,3190,1472,2581,3907,5069,16219
2023-07-10,11,3048,2640,1299,3580,2600,13167
2023-07-11,11,2845,1411,3620,1772,2320,11968
2023-07-12,11,4444,1039,1528,4486,4975,16472
2023-07-13,11,1246,2649,2077,1924,2766,10662
2023-07-14,11,2815,2232,3151,2060,5258,15516
2023-07-15,11,3927,1862,3010,1556,3248,13603
2023-07-16,11,2799,2022,1252,4311,2553,12937
2023-07-17,11,3662,1343,2305,3977,3215,14502
2023-07-18,11,4329,1764,3131,1801,5628,16653
2023-07-19,11,4613,2865,1681,2230,3500,14889
2023-07-20,11,4934,2594,2826,3899,4730,18983
2023-07-21,11,2342,2260,2296,3143,2807,12848
2023-07-22,11,1520,2327,1965,2122,5016,12950
2023-07-23,11,4855,805,1520,4146,3319,14645
2023-07-24,11,1989,2051,1534,2099,2255,9928
2023-07-25,11,3350,1293,2671,1733,5187,14234
2023-07-26,11,1197,944,3626,2085,4641,12493
2023-07-27,11,4646,2334,2866,3170,4131,17147
2023-07-28,11,2645,1188,3411,4148,3161,14553
2023-07-29,11,1730,2482,2495,3465,5427,15599
2023-07-30,11,1778,2284,2379,3989,2534,12964
2023-07-31,11,4342,2007,2630,2159,4956,16094
2023-08-01,11,2686,1984,3269,2306,4692,14937
2023-08-02,11,1505,1526,2701,2925,2044,10701
2023-08-03,11,3193,2094,2131,3109,4467,14994
2023-08-04,11,3949,2369,3346,3222,5174,18060
2023-08-05,11,4908,2398,1592,1879,5966,16743
2023-08-06,11,1324,2101,3925,3068,3195,13613
2023-08-07,11,1835,1291,3214,3434,5011,14785
2023-08-08,11,1330,2593,2684,1707,2576,10890
2023-08-09,11,2532,854,3395,3622,4548,14951
2023-08-10,11,1893,2696,2018,2719,4339,13665
2023-08-11,11,4594,977,3908,3801,4476,17756
2023-08-12,11,3816,1686,1499,3571,3245,13817
2023-08-13,11,1909,1406,1721,4309,4419,13764
2023-08-14,11,4789,2012,2122,2094,2262,13279
2023-08-15,11,4602,2013,2010,1625,2332,12582
2023-08-16,11,2263,1410,1637,4017,5449,14776
2023-08-17,11,3643,2799,2136,2161,5108,15847
2023-08-18,11,1865,1597,3253,2778,4041,13534
2023-08-19,11,4014,1290,2647,2161,5316,15428
2023-08-20,11,2891,1056,2655,4390,3584,14576
2023-08-21,11,2758,1581,3895,1860,5716,15810
2023-08-22,11,4417,2556,1606,3575,4443,16597
2023-08-23,11,2831,1251,3186,3501,5189,15958
2023-08-24,11,1109,2459,2383,2880,5450,14281
2023-08-25,11,3485,2273,3960,2960,4551,17229
2023-08-26,11,3648,941,2046,3106,2845,12586
2023-08-27,11,3066,815,1206,4303,2232,11622
2023-08-28,11,1339,970,1532,2130,5536,11507
2023-08-29,11,1952,2334,1542,1674,3117,10619
2023-08-30,11,2742,2546,2709,3040,5365,16402
2023-08-31,11,2415,1085,2375,3168,4123,13166
2023-09-01,11,2155,2818,2921,3673,2179,13746
2023-09-02,11,1750,2792,3555,4072,2962,15131
2023-09-03,11,3999,1617,1598,2904,2702,12820
2023-09-04,11,2008,1072,1469,2763,4013,11325
2023-09-05,11,2421,2353,1912,2573,3987,13246
2023-09-06,11,4789,1378,3838,2050,3017,15072
2023-09-07,11,2308,2525,1610,3601,3420,13464
2023-09-08,11,1416,1948,3648,3565,2958,13535
2023-09-09,11,2888,2843,2728,2757,4215,15431
2023-09-10,11,1242,2737,2638,3064,4679,14360
2023-09-11,11,2300,2323,1664,3613,5926,15826
2023-09-12,11,2309,1182,2768,3208,5963,15430
2023-09-13,11,1415,2095,3318,2775,3320,12923
2023-09-14,11,2753,1727,2280,1683,4278,12721
2023-09-15,11,1278,2105,1270,3710,2697,11060
2023-09-16,11,2194,2452,3237,4481,4878,17242
2023-09-17,11,1049,1936,3670,2843,5189,14687
2023-09-18,11,2521,2114,2067,1836,4291,12829
2023-09-19,11,1168,815,3096,3494,4134,12707
2023-09-20,11,3614,966,1400,1722,5861,13563
2023-09-21,11,4634,2295,3516,3725,4787,18957
2023-09-22,11,3900,1375,1229,3040,2515,12059
2023-09-23,11,4292,2232,2999,2616,5655,17794
2023-09-24,11,2109,2483,2339,3809,4702,15442
2023-09-25,11,3871,2416,2903,4407,3456,17053
2023-09-26,11,2721,1796,2494,2880,3136,13027
2023-09-27,11,1927,2656,3262,2228,4272,14345
2023-09-28,11,1158,2240,3308,1878,5682,14266
2023-09-29,11,2841,1879,3279,3990,5376,17365
2023-09-30,11,4818,2072,3195,3099,3068,16252
2023-10-01,11,2450,957,1271,1835,2633,9146
2023-10-02,11,1547,2396,3163,2496,4927,14529
2023-10-03,11,2545,1038,3273,3146,4956,14958
2023-10-04,11,4333,2044,1409,2841,3604,14231
2023-10-05,11,1818,2170,2909,3464,4404,14765
2023-10-06,11,3466,1844,3600,3602,3390,15902
2023-10-07,11,3840,1175,3526,2259,5547,16347
2023-10-08,11,3583,1663,2786,3886,3734,15652
2023-10-09,11,4533,2208,3646,3992,3403,17782
2023-10-10,11,3437,1872,2812,3634,3114,14869
2023-10-11,11,2408,1318,1418,2817,2559,10520
2023-10-12,11,2867,941,3300,3456,5294,15858
2023-10-13,11,2475,2514,3074,2856,3432,14351
2023-10-14,11,3973,1809,1956,1834,2103,11675
2023-10-15,11,3623,969,2885,4115,4997,16589
2023-10-16,11,3883,1730,2674,4018,5779,18084
2023-10-17,11,3898,1339,3734,1722,3472,14165
2023-10-18,11,3245,2151,2311,2781,4841,15329
2023-10-19,11,2438,1168,3813,2821,4485,14725
2023-10-20,11,2305,1170,1260,1849,4467,11051
2023-10-21,11,2436,1247,2464,3773,5441,15361
2023-10-22,11,3863,2476,3096,2634,2611,14680
2023-10-23,11,3172,2561,3308,3426,5246,17713
2023-10-24,11,4207,2230,2506,4101,5450,18494
2023-10-25,11,3148,2034,2299,3074,3640,14195
2023-10-26,11,2209,2264,1492,2982,2035,10982
2023-10-27,11,2461,828,3247,2550,5168,14254
2023-10-28,11,2445,2371,1397,3043,2357,11613
2023-10-29,11,2007,2314,1807,3268,2156,11552
2023-10-30,11,3216,1019,3679,2127,5152,15193
2023-10-31,11,3186,2385,2842,3811,2559,14783
2023-11-01,11,4130,1507,2866,3046,5570,17119
2023-11-02,11,1752,2545,2327,1778,2195,10597
2023-11-03,11,3394,2310,3258,1505,4188,14655
2023-11-04,11,2555,2158,3567,3195,4022,15497
2023-11-05,11,2677,1926,2066,2963,2073,11705
2023-11-06,11,1158,2080,3994,4275,5694,17201
2023-11-07,11,3254,2703,2484,3558,4656,16655
2023-11-08,11,4850,2476,1980,1739,2658,13703
2023-11-09,11,2948,2507,3488,2336,2990,14269
2023-11-10,11,1402,2430,2742,4355,4973,15902
2023-11-11,11,4494,2287,2956,1681,2380,13798
2023-11-12,11,4610,1204,1530,2178,2485,12007
2023-11-13,11,3005,2445,1353,3381,2924,13108
2023-11-14,11,3071,2270,2010,3986,4623,15960
2023-11-15,11,4264,1800,1573,4091,2311,14039
2023-11-16,11,1253,2611,1505,3693,3318,12380
2023-11-17,11,2325,1959,1545,4434,3356,13619
2023-11-18,11,3965,836,3577,4475,4363,17216
2023-11-19,11,4125,2504,3336,2045,4569,16579
2023-11-20,11,4555,1244,3710,3347,3428,16284
2023-11-21,11,2281,1271,2193,1924,3896,11565
2023-11-22,11,2860,2962,3567,3381,3667,16437
2023-11-23,11,4074,1645,3294,3933,3991,16937
2023-11-24,11,4727,1805,3753,2551,3695,16531
2023-11-25,11,4916,1531,2582,2032,3253,14314
2023-11-26,11,4392,1024,2065,3924,3876,15281
2023-11-27,11,4675,2608,3757,2866,3653,17559
2023-11-28,11,2786,2443,3402,2072,3743,14446
2023-11-29,11,3460,2523,2482,4031,2035,14531
2023-11-30,11,4448,1606,2609,2916,4976,16555
2023-12-01,11,3867,1853,1412,2227,5468,14827
2023-12-02,11,3882,812,1589,2688,4012,12983
2023-12-03,11,3550,2801,3608,1665,2449,14073
2023-12-04,11,1149,1837,1731,3052,3625,11394
2023-12-05,11,1489,2400,2796,2836,4238,13759
2023-12-06,11,4269,1700,1702,2739,2888,13298
2023-12-07,11,2694,2359,3051,3293,2234,13631
2023-12-08,11,2232,1160,2141,2384,5546,13463
2023-12-09,11,4740,2892,2530,3355,5149,18666
2023-12-10,11,2430,2205,2228,4186,2365,13414
2023-12-11,11,3586,2149,1685,4041,5131,16592
2023-12-12,11,4588,939,2149,3489,3735,14900
2023-12-13,11,1121,2305,1973,2842,5083,13324
2023-12-14,11,3179,2012,2415,3919,2812,14337
2023-12-15,11,1372,1883,1693,3018,5030,12996
2023-12-16,11,4657,2423,2402,3551,3312,16345
2023-12-17,11,1891,1138,3011,1921,4041,12002
2023-12-18,11,3453,1518,3030,3362,5948,17311
2023-12-19,11,1391,2343,3310,4002,4423,15469
2023-12-20,11,4077,2928,2418,3323,5821,18567
2023-12-21,11,3849,1473,3860,3537,2115,14834
2023-12-22,11,3314,1938,2888,2159,3993,14292
2023-12-23,11,4572,2187,3163,3736,5195,18853
2023-12-24,11,4292,2963,1483,2433,5910,17081
2023-12-25,11,1337,1993,1772,2500,2980,10582
2023-12-26,11,3071,2565,3277,2537,3695,15145
2023-12-27,11,2320,1510,3642,2092,4086,13650
2023-12-28,11,3055,1931,1724,4460,3410,14580
2023-12-29,11,1096,2792,1444,1657,4516,11505
2023-12-30,11,2063,1977,3330,3575,3148,14093
2023-12-31,11,1872,1878,2744,4152,5554,16200
2022-01-01,12,3152,1911,2143,2639,4569,14414
2022-01-02,12,3322,2786,2220,3395,3497,15220
2022-01-03,12,4140,989,3521,2063,5504,16217
2022-01-04,12,1722,1154,2589,1785,5015,12265
2022-01-05,12,2980,2801,1596,2252,2837,12466
2022-01-06,12,2345,1500,1833,3684,5222,14584
2022-01-07,12,4159,2673,1982,3555,5454,17823
2022-01-08,12,1486,1043,2516,2299,4262,11606
2022-01-09,12,4515,1538,3339,3516,3113,16021
2022-01-10,12,2015,2420,3651,3440,3804,15330
2022-01-11,12,1182,2089,2956,2857,4642,13726
2022-01-12,12,4438,2371,3650,1550,3114,15123
2022-01-13,12,2879,1569,1429,4481,4423,14781
2022-01-14,12,2251,1947,1767,3205,2926,12096
2022-01-15,12,4262,2389,3724,2608,3229,16212
2022-01-16,12,1200,2179,2789,4048,4523,14739
2022-01-17,12,4606,1304,1241,3636,2300,13087
2022-01-18,12,3083,2080,2801,2877,3426,14267
2022-01-19,12,3862,1821,1649,3195,4523,15050
2022-01-20,12,3053,1072,1569,1587,2866,10147
2022-01-21,12,2203,992,3841,2240,3439,12715
2022-01-22,12,3009,1493,3292,2208,4930,14932
2022-01-23,12,4181,1009,2424,3615,4811,16040
2022-01-24,12,1588,2154,1859,4371,2875,12847
2022-01-25,12,1660,2986,2939,4237,4376,16198
2022-01-26,12,2878,1862,1607,2685,3410,12442
2022-01-27,12,4657,2266,1829,1913,5113,15778
2022-01-28,12,2084,1121,1816,2777,2325,10123
2022-01-29,12,2473,2438,3849,3054,3502,15316
2022-01-30,12,2842,1909,1696,2196,3913,12556
2022-01-31,12,3645,2241,2726,1702,5963,16277
2022-02-01,12,2865,1132,3935,2224,4443,14599
2022-02-02,12,1230,2122,1837,1541,2473,9203
2022-02-03,12,4029,1872,3297,2083,4672,15953
2022-02-04,12,4762,2286,1521,3816,5589,17974
2022-02-05,12,4722,2009,1627,4355,3774,16487
2022-02-06,12,3633,2252,3178,4396,3651,17110
2022-02-07,12,1775,1328,2750,2785,5155,13793
2022-02-08,12,4342,1522,3978,3757,2452,16051
2022-02-09,12,1403,1678,2892,4380,5985,16338
2022-02-10,12,2368,1550,3303,2224,4699,14144
2022-02-11,12,3084,1710,1446,4331,4714,15285
2022-02-12,12,2539,900,3866,2937,4918,15160
2022-02-13,12,1812,1434,2885,1751,3838,11720
2022-02-14,12,1863,2621,3229,3923,5617,17253
2022-02-15,12,1153,853,1562,3003,3183,9754
2022-02-16,12,2661,1365,2546,1531,2742,10845
2022-02-17,12,1072,1741,3604,2330,5709,14456
2022-02-18,12,3148,2645,2415,4487,2067,14762
2022-02-19,12,4346,2432,1788,3315,3100,14981
2022-02-20,12,3656,1248,1779,2371,2956,12010
2022-02-21,12,2200,1685,1464,3541,2303,11193
2022-02-22,12,2884,1066,2294,2781,4592,13617
2022-02-23,12,1583,2570,3356,2844,3275,13628
2022-02-24,12,2817,1862,1398,3215,3768,13060
2022-02-25,12,2745,2319,2510,3666,5010,16250
2022-02-26,12,2805,2795,3555,2697,4011,15863
2022-02-27,12,1460,1679,1915,2908,5606,13568
2022-02-28,12,1496,2500,2456,4035,2389,12876
2022-03-01,12,4956,1143,3177,4440,5327,19043
2022-03-02,12,1414,1370,3079,2728,2683,11274
2022-03-03,12,1526,2142,2683,4273,5604,16228
2022-03-04,12,3143,1329,2139,2709,5830,15150
2022-03-05,12,3076,2863,2047,3203,5230,16419
2022-03-06,12,1554,2136,1400,3433,3711,12234
2022-03-07,12,4227,2248,2867,4163,3311,16816
2022-03-08,12,2129,2140,3722,1688,5729,15408
2022-03-09,12,1806,2975,2463,2165,4781,14190
2022-03-10,12,4527,2506,3686,2594,4788,18101
2022-03-11,12,3961,853,2756,3033,5222,15825
2022-03-12,12,2332,1071,2226,1658,5216,12503
2022-03-13,12,4585,1890,3363,2419,4393,16650
2022-03-14,12,1674,2788,3095,3771,4219,15547
2022-03-15,12,2578,2463,3212,3003,3565,14821
2022-03-16,12,4238,1071,1830,3416,3886,14441
2022-03-17,12,3716,1886,2579,2531,3988,14700
2022-03-18,12,1177,1193,3625,1587,4660,12242
2022-03-19,12,2571,953,2048,3836,2957,12365
2022-03-20,12,3205,1826,3185,4271,4883,17370
2022-03-21,12,2978,1477,2240,3856,3379,13930
2022-03-22,12,2744,1457,3460,1954,3640,13255
2022-03-23,12,4604,2885,3535,4479,3124,18627
2022-03-24,12,2252,1803,1319,2498,5356,13228
2022-03-25,12,2123,1997,2136,1766,4972,12994
2022-03-26,12,3509,1875,2390,2539,3936,14249
2022-03-27,12,2517,1230,3534,2360,4778,14419
2022-03-28,12,2194,1462,1838,4209,2060,11763
2022-03-29,12,1894,2474,1819,2887,3997,13071
2022-03-30,12,2686,1004,1998,4479,5854,16021
2022-03-31,12,2474,817,1293,3601,2128,10313
2022-04-01,12,3130,1617,2892,3162,4854,15655
2022-04-02,12,2775,1694,1866,4464,3105,13904
2022-04-03,12,4667,2308,3072,1749,5850,17646
2022-04-04,12,2510,1398,1524,1595,5271,12298
2022-04-05,12,2906,1137,1941,4159,3970,14113
2022-04-06,12,1597,1386,3204,2857,2017,11061
2022-04-07,12,1136,2879,2780,2333,2000,11128
2022-04-08,12,3906,2847,1754,2962,3461,14930
2022-04-09,12,4994,1048,1246,3902,4388,15578
2022-04-10,12,4103,2161,3484,3802,5643,19193
2022-04-11,12,1404,1602,1878,1932,5119,11935
2022-04-12,12,1387,2096,2912,2123,2606,11124
2022-04-13,12,3412,1697,2143,3791,3434,14477
2022-04-14,12,4731,1345,2203,2535,4987,15801
2022-04-15,12,3340,1082,2058,2005,3550,12035
2022-04-16,12,4107,2835,1999,2596,5180,16717
2022-04-17,12,2841,920,1476,2834,4122,12193
2022-04-18,12,1502,1413,3272,1656,3494,11337
2022-04-19,12,3825,2665,1360,4411,2927,15188
2022-04-20,12,4009,2186,2896,1666,2389,13146
2022-04-21,12,3733,2900,1709,3009,5903,17254
2022-04-22,12,3007,2555,3905,1526,2157,13150
2022-04-23,12,1326,2556,3293,2320,5275,14770
2022-04-24,12,3753,1182,3278,1833,4358,14404
2022-04-25,12,1900,2488,2795,1791,4288,13262
2022-04-26,12,3950,2649,1842,2710,4817,15968
2022-04-27,12,4489,1960,2206,4360,5622,18637
2022-04-28,12,2898,2958,2655,1706,5831,16048
2022-04-29,12,1369,1220,3154,1503,4635,11881
2022-04-30,12,1905,2056,2695,1928,5882,14466
2022-05-01,12,4305,1782,2149,3980,4083,16299
2022-05-02,12,3424,1789,2243,4340,3339,15135
2022-05-03,12,1824,1570,1328,3235,5189,13146
2022-05-04,12,2536,2986,2689,4079,5374,17664
2022-05-05,12,3293,1512,1921,2778,4396,13900
2022-05-06,12,1784,2300,2981,3615,2457,13137
2022-05-07,12,4822,986,3173,3632,2306,14919
2022-05-08,12,1772,2032,2408,4203,2247,12662
2022-05-09,12,4748,1312,2435,1514,2269,12278
2022-05-10,12,4726,1571,1744,2885,3374,14300
2022-05-11,12,1087,2289,3999,3958,2099,13432
2022-05-12,12,4045,979,1806,3952,4042,14824
2022-05-13,12,1886,2254,1980,1528,3820,11468
2022-05-14,12,3428,1658,3576,1558,2646,12866
2022-05-15,12,1140,1958,2454,4079,4613,14244
2022-05-16,12,3661,2761,2514,1661,2565,13162
2022-05-17,12,3217,930,1317,2879,2766,11109
2022-05-18,12,3846,2039,1510,4190,3581,15166
2022-05-19,12,2664,1409,2824,3447,2050,12394
2022-05-20,12,1745,1856,1575,4377,5348,14901
2022-05-21,12,3241,1533,3108,3015,5879,16776
2022-05-22,12,3007,2528,1442,3894,5807,16678
2022-05-23,12,1732,2353,1926,2001,3626,11638
2022-05-24,12,1773,1767,1489,2085,2234,9348
2022-05-25,12,4941,811,3340,2767,5208,17067
2022-05-26,12,2164,1337,2797,2961,4364,13623
2022-05-27,12,1052,2617,3460,3645,2084,12858
2022-05-28,12,1033,1246,2565,1908,3399,10151
2022-05-29,12,1128,2913,3083,2123,5508,14755
2022-05-30,12,1589,2323,1444,4295,5627,15278
2022-05-31,12,1805,937,3920,2403,2962,12027
2022-06-01,12,2414,1015,2199,3207,4418,13253
2022-06-02,12,1002,1297,2621,4306,4571,13797
2022-06-03,12,2223,1750,3050,3757,4341,15121
2022-06-04,12,4230,2968,1318,2074,4041,14631
2022-06-05,12,3483,2750,1286,3674,3533,14726
2022-06-06,12,2134,1369,1911,2411,2870,10695
2022-06-07,12,4316,2713,3748,2253,4179,17209
2022-06-08,12,3780,1023,1722,2546,3870,12941
2022-06-09,12,2240,2071,3717,3404,5774,17206
2022-06-10,12,2648,1467,3156,1529,4777,13577
2022-06-11,12,2010,2882,3764,2614,2493,13763
2022-06-12,12,3666,2429,2383,3795,5237,17510
2022-06-13,12,4842,1848,1428,2488,4490,15096
2022-06-14,12,4930,1118,2669,1564,3026,13307
2022-06-15,12,1905,2398,3508,3735,5257,16803
2022-06-16,12,3783,2708,2445,3955,5985,18876
2022-06-17,12,2871,1960,3836,3093,4396,16156
2022-06-18,12,2837,1880,1518,3728,4003,13966
2022-06-19,12,4402,1554,2515,4074,3119,15664
2022-06-20,12,2204,882,3983,3439,4154,14662
2022-06-21,12,4366,1666,2207,2619,5164,16022
2022-06-22,12,3318,1789,1776,3377,4009,14269
2022-06-23,12,2061,1910,2751,1574,4532,12828
2022-06-24,12,3756,1190,3860,4433,5665,18904
2022-06-25,12,3698,992,3470,2827,3905,14892
2022-06-26,12,1739,1312,1976,3236,4024,12287
2022-06-27,12,3633,1757,2332,2902,3707,14331
2022-06-28,12,2876,1891,1330,3834,3774,13705
2022-06-29,12,4967,2905,3008,3384,5311,19575
2022-06-30,12,4654,1414,2751,3385,5729,17933
2022-07-01,12,2013,1002,1629,2766,2749,10159
2022-07-02,12,1129,2820,2835,1925,2420,11129
2022-07-03,12,4715,1646,2239,1952,2295,12847
2022-07-04,12,4548,2277,3305,2673,3096,15899
2022-07-05,12,3931,1864,1600,3053,4217,14665
2022-07-06,12,2584,2737,3600,4127,3940,16988
2022-07-07,12,2295,2465,2522,4267,5478,17027
2022-07-08,12,1243,2967,3069,2608,3956,13843
2022-07-09,12,3894,2768,1503,4075,3931,16171
2022-07-10,12,4638,1637,1890,3981,4571,16717
2022-07-11,12,1093,2863,2735,3434,4675,14800
2022-07-12,12,3299,2242,2946,3728,5092,17307
2022-07-13,12,3228,1063,3123,1855,3280,12549
2022-07-14,12,1952,2309,1978,3145,5353,14737
2022-07-15,12,1082,1269,3675,4262,3425,13713
2022-07-16,12,1945,2548,2430,1710,4479,13112
2022-07-17,12,4375,2864,3261,3900,4844,19244
2022-07-18,12,2294,1101,2937,3016,4316,13664
2022-07-19,12,1383,2956,3679,2223,3228,13469
2022-07-20,12,3192,1849,2660,3658,3427,14786
2022-07-21,12,4093,1630,3078,2951,3408,15160
2022-07-22,12,4613,2787,3441,4412,5171,20424
2022-07-23,12,3800,867,1774,3274,3417,13132
2022-07-24,12,4857,2304,1347,3985,3904,16397
2022-07-25,12,3119,2912,1351,3287,2268,12937
2022-07-26,12,1805,1601,2871,3960,3744,13981
2022-07-27,12,1795,1920,1218,1672,4446,11051
2022-07-28,12,1539,1433,2217,2936,3952,12077
2022-07-29,12,1855,1762,3050,3156,2882,12705
2022-07-30,12,2716,1997,3629,3308,5245,16895
2022-07-31,12,1254,2198,2205,2200,2215,10072
2022-08-01,12,2848,1295,3694,4031,4215,16083
2022-08-02,12,4230,867,3732,2846,4872,16547
2022-08-03,12,3470,2380,3364,3960,5329,18503
2022-08-04,12,4827,2766,2209,1659,3209,14670
2022-08-05,12,4831,2204,1994,3055,3853,15937
2022-08-06,12,1265,2024,1397,3191,4519,12396
2022-08-07,12,4028,2543,2059,3871,4299,16800
2022-08-08,12,1007,3000,2219,2286,3347,11859
2022-08-09,12,4010,2619,3897,2703,2382,15611
2022-08-10,12,3172,2768,2624,3916,3448,15928
2022-08-11,12,4502,810,3623,1644,2542,13121
2022-08-12,12,3076,1268,2782,1920,5106,14152
2022-08-13,12,3271,853,1418,3755,4346,13643
2022-08-14,12,1019,2811,3621,2328,5695,15474
2022-08-15,12,1814,1227,2764,2116,5701,13622
2022-08-16,12,4844,1178,3996,2210,5506,17734
2022-08-17,12,1952,828,1685,4113,4776,13354
2022-08-18,12,3122,2581,2617,3224,3146,14690
2022-08-19,12,2363,2673,3535,4008,2886,15465
2022-08-20,12,4706,1984,2443,1640,4517,15290
2022-08-21,12,4822,854,1512,3044,5878,16110
2022-08-22,12,3316,1374,3529,3527,2530,14276
2022-08-23,12,3220,2560,2971,3460,4961,17172
2022-08-24,12,4540,1729,2820,1507,3734,14330
2022-08-25,12,3545,1222,3631,3910,5371,17679
2022-08-26,12,4724,2987,1664,2103,5804,17282
2022-08-27,12,3702,2854,3686,3036,3001,16279
2022-08-28,12,4919,1678,1748,3497,5790,17632
2022-08-29,12,4505,2158,3732,4354,5177,19926
2022-08-30,12,4245,844,1387,3610,3899,13985
2022-08-31,12,2945,2309,2242,4050,4076,15622
2022-09-01,12,2734,892,3973,2648,4761,15008
2022-09-02,12,2806,2503,3112,3453,2164,14038
2022-09-03,12,3182,2207,2295,3430,5923,17037
2022-09-04,12,1960,2479,1699,3919,3660,13717
2022-09-05,12,1090,1377,3594,1935,5520,13516
2022-09-06,12,4547,2545,3817,3554,3415,17878
2022-09-07,12,4076,1256,3783,3698,2741,15554
2022-09-08,12,1940,2804,2530,1528,5945,14747
2022-09-09,12,4033,1254,2771,4473,3796,16327
2022-09-10,12,4250,1595,2483,3989,3001,15318
2022-09-11,12,4011,2402,2899,4221,3920,17453
2022-09-12,12,4197,2591,3271,4417,5132,19608
2022-09-13,12,3680,1820,3519,1947,3085,14051
2022-09-14,12,1278,2998,1421,3517,5814,15028
2022-09-15,12,2566,1662,2328,4459,3308,14323
2022-09-16,12,4507,1671,3290,3016,2992,15476
2022-09-17,12,1901,2466,1653,2262,4099,12381
2022-09-18,12,1768,2719,1413,1614,5003,12517
2022-09-19,12,4027,1080,1732,3472,4645,14956
2022-09-20,12,2777,2804,2109,3076,4572,15338
2022-09-21,12,1402,1906,2492,2398,2778,10976
2022-09-22,12,2286,1489,2008,3641,4016,13440
2022-09-23,12,1212,1343,2023,4431,5097,14106
2022-09-24,12,4764,2673,2026,1507,2609,13579
2022-09-25,12,2268,1135,2942,2481,3594,12420
2022-09-26,12,2628,2032,2334,2203,2076,11273
2022-09-27,12,3164,817,3501,2031,5141,14654
2022-09-28,12,3412,951,3320,3465,2693,13841
2022-09-29,12,1670,1680,3641,3286,4108,14385
2022-09-30,12,4566,934,3603,3538,4394,17035
2022-10-01,12,2974,1267,2685,2120,5457,14503
2022-10-02,12,4102,2794,2319,2479,3734,15428
2022-10-03,12,3753,1880,2835,3650,4949,17067
2022-10-04,12,1405,2327,1416,2414,3089,10651
2022-10-05,12,2949,2754,3315,2684,2055,13757
2022-10-06,12,2286,1044,1257,4112,5732,14431
2022-10-07,12,2213,802,3108,2504,3616,12243
2022-10-08,12,2084,1984,2530,2498,4701,13797
2022-10-09,12,4421,1737,3549,1982,4485,16174
2022-10-10,12,2819,2843,2170,3839,3475,15146
2022-10-11,12,3306,2750,1472,2439,3642,13609
2022-10-12,12,4266,1138,3996,2117,4665,16182
2022-10-13,12,3128,2679,3689,2414,4806,16716
2022-10-14,12,3773,1451,1388,2055,2956,11623
2022-10-15,12,1001,1915,2767,2235,3027,10945
2022-10-16,12,2055,1572,1389,2630,3699,11345
2022-10-17,12,2650,2661,2140,1555,5821,14827
2022-10-18,12,1960,1264,3484,3510,4378,14596
2022-10-19,12,1877,1177,1992,2765,5027,12838
2022-10-20,12,2110,2829,3339,2730,3056,14064
2022-10-21,12,2940,1953,3150,4201,2172,14416
2022-10-22,12,4802,1999,1672,2242,3299,14014
2022-10-23,12,1715,1915,3495,3420,2399,12944
2022-10-24,12,1754,1348,2070,4151,5762,15085
2022-10-25,12,3775,1808,1730,4478,5251,17042
2022-10-26,12,4915,2369,1834,2275,2343,13736
2022-10-27,12,3590,1148,1403,2975,4207,13323
2022-10-28,12,3272,921,2953,3010,2884,13040
2022-10-29,12,3763,992,3697,3573,2010,14035
2022-10-30,12,1375,2800,3928,3872,2701,14676
2022-10-31,12,2293,1581,2843,2561,4634,13912
2022-11-01,12,1339,2045,3992,3211,4345,14932
2022-11-02,12,4202,2162,1692,4362,5899,18317
2022-11-03,12,1421,1846,1861,4161,5006,14295
2022-11-04,12,3735,1320,2620,2588,2454,12717
2022-11-05,12,1624,2244,2217,3835,5090,15010
2022-11-06,12,2544,2641,1768,2091,2245,11289
2022-11-07,12,2353,2892,1854,2084,2104,11287
2022-11-08,12,4835,2770,2747,1802,3233,15387
2022-11-09,12,4444,2851,3716,4288,2977,18276
2022-11-10,12,2648,2440,2476,4161,2319,14044
2022-11-11,12,3458,2412,1571,1618,4925,13984
2022-11-12,12,3929,1223,2397,4126,2989,14664
2022-11-13,12,2623,851,2371,1986,3278,11109
2022-11-14,12,4250,852,3442,1534,4286,14364
2022-11-15,12,2225,1320,3403,2969,2376,12293
2022-11-16,12,4553,1544,3988,2938,3579,16602
2022-11-17,12,1013,1367,1828,2909,5282,12399
2022-11-18,12,3543,1139,3633,2789,2253,13357
2022-11-19,12,3717,2177,1515,2790,5478,15677
2022-11-20,12,4298,2080,3190,4198,5224,18990
2022-11-21,12,3756,1350,1303,1970,5939,14318
2022-11-22,12,1148,2590,3853,4410,3775,15776
2022-11-23,12,2701,1080,2658,3865,5434,15738
2022-11-24,12,3766,925,3238,2709,5057,15695
2022-11-25,12,2875,2012,2587,2458,3287,13219
2022-11-26,12,1573,2097,3736,1773,3478,12657
2022-11-27,12,2946,2298,3088,3712,5749,17793
2022-11-28,12,2860,1113,3040,2812,5388,15213
2022-11-29,12,2065,1261,2807,3877,4149,14159
2022-11-30,12,4831,2316,1472,3062,3631,15312
2022-12-01,12,2777,2063,2929,1660,5319,14748
2022-12-02,12,1789,1297,1832,3936,4005,12859
2022-12-03,12,4101,858,2089,1583,4011,12642
2022-12-04,12,2688,2864,1809,2235,3195,12791
2022-12-05,12,1514,2122,2216,1736,4724,12312
2022-12-06,12,4384,1326,1788,2532,2752,12782
2022-12-07,12,1396,1982,2249,3194,5001,13822
2022-12-08,12,2163,1286,3615,3227,3136,13427
2022-12-09,12,1909,2387,3695,2104,3293,13388
2022-12-10,12,1463,2859,2229,2012,2064,10627
2022-12-11,12,3936,1370,3203,4396,2159,15064
2022-12-12,12,4180,1786,3733,4205,4667,18571
2022-12-13,12,4273,1439,2929,1870,5509,16020
2022-12-14,12,2257,1363,2751,4441,2048,12860
2022-12-15,12,1186,2066,3447,4411,4250,15360
2022-12-16,12,2011,1916,3812,1949,5939,15627
2022-12-17,12,3992,2699,1717,3824,4990,17222
2022-12-18,12,4527,1014,3861,1753,3073,14228
2022-12-19,12,2262,956,2022,3910,5080,14230
2022-12-20,12,2573,1998,1556,2690,3180,11997
2022-12-21,12,2045,935,1945,4489,4208,13622
2022-12-22,12,2664,2548,2984,4387,5642,18225
2022-12-23,12,4262,1917,1307,4483,5438,17407
2022-12-24,12,1808,2223,3271,2983,3882,14167
2022-12-25,12,3206,1240,3450,2737,3779,14412
2022-12-26,12,4498,1326,1792,3521,2577,13714
2022-12-27,12,4859,1402,2607,3966,5140,17974
2022-12-28,12,4927,1600,3816,4489,3052,17884
2022-12-29,12,3678,898,2496,3177,2388,12637
2022-12-30,12,3845,2505,3505,2178,3980,16013
2022-12-31,12,3997,2463,2354,3441,2364,14619
2023-01-01,12,2407,1595,3916,3551,3527,14996
2023-01-02,12,1853,2640,2615,1665,3503,12276
2023-01-03,12,2310,1942,3545,1612,3950,13359
2023-01-04,12,4119,2407,2300,1651,4993,15470
2023-01-05,12,4171,1531,3438,3552,5570,18262
2023-01-06,12,1958,2603,2710,4192,5805,17268
2023-01-07,12,4773,2318,2193,3546,2914,15744
2023-01-08,12,2943,1444,1656,1590,3896,11529
2023-01-09,12,4637,821,3921,4488,3888,17755
2023-01-10,12,4477,1622,1681,2632,4097,14509
2023-01-11,12,2559,2457,1802,4447,3070,14335
2023-01-12,12,2406,1847,2962,2716,2226,12157
2023-01-13,12,3615,1298,3990,1960,4537,15400
2023-01-14,12,3029,2049,2012,1558,4563,13211
2023-01-15,12,3195,2552,3352,2546,2837,14482
2023-01-16,12,2246,1386,3442,4448,3860,15382
2023-01-17,12,2178,1316,1277,4273,4632,13676
2023-01-18,12,4509,2921,2679,1750,5077,16936
2023-01-19,12,3930,2277,2844,4257,2808,16116
2023-01-20,12,4282,836,3399,3681,3451,15649
2023-01-21,12,2170,2846,1302,3684,2324,12326
2023-01-22,12,4538,1005,3326,3356,3308,15533
2023-01-23,12,4025,2328,2588,3377,5741,18059
2023-01-24,12,3543,1873,1413,2646,2477,11952
2023-01-25,12,4281,1665,1285,1558,3642,12431
2023-01-26,12,2739,2586,1935,1504,3450,12214
2023-01-27,12,2514,1473,2694,2154,3238,12073
2023-01-28,12,2651,1714,1938,4181,5738,16222
2023-01-29,12,1650,1618,1609,3440,5650,13967
2023-01-30,12,2781,2032,1971,2059,4679,13522
2023-01-31,12,2513,2391,2742,3885,3007,14538
2023-02-01,12,3389,1182,2036,2767,2878,12252
2023-02-02,12,3879,1649,2928,1808,2687,12951
2023-02-03,12,2049,2064,1513,2036,2320,9982
2023-02-04,12,3160,1528,1467,2779,5099,14033
2023-02-05,12,4280,1710,3817,2087,3339,15233
2023-02-06,12,3465,1262,3432,3328,3167,14654
2023-02-07,12,2287,2103,2777,3820,5793,16780
2023-02-08,12,4971,1629,1254,2074,5063,14991
2023-02-09,12,4886,2842,2607,3119,5733,19187
2023-02-10,12,4477,2144,3882,2635,4446,17584
2023-02-11,12,2850,1811,3097,1540,4264,13562
2023-02-12,12,2147,2593,3833,4028,3459,16060
2023-02-13,12,4019,1874,2134,3833,5990,17850
2023-02-14,12,4624,1424,2909,3524,2022,14503
2023-02-15,12,2865,2252,1771,1831,4111,12830
2023-02-16,12,3675,938,2231,2038,2385,11267
2023-02-17,12,1175,1331,3030,4035,5139,14710
2023-02-18,12,3838,2680,3766,3034,3073,16391
2023-02-19,12,2817,1505,1241,2386,2109,10058
2023-02-20,12,4986,2604,1763,2747,4867,16967
2023-02-21,12,1624,1973,2977,4414,5497,16485
2023-02-22,12,3512,1234,3490,4462,2213,14911
2023-02-23,12,1685,1471,1409,4465,3281,12311
2023-02-24,12,3617,1106,1676,2395,4582,13376
2023-02-25,12,2530,2162,2514,3531,5511,16248
2023-02-26,12,4919,1224,1282,3720,2113,13258
2023-02-27,12,4998,2395,1534,3088,3364,15379
2023-02-28,12,1037,1991,2806,2656,5778,14268
2023-03-01,12,3710,1467,2904,3409,4420,15910
2023-03-02,12,1161,2631,3168,2185,5178,14323
2023-03-03,12,2326,2079,2444,3839,5529,16217
2023-03-04,12,3817,844,2979,4352,2399,14391
2023-03-05,12,1668,2674,3350,4032,5521,17245
2023-03-06,12,3581,936,2182,1850,4101,12650
2023-03-07,12,2532,979,1788,3687,2188,11174
2023-03-08,12,2485,2315,2432,3341,4669,15242
2023-03-09,12,4188,1121,3400,3233,5070,17012
2023-03-10,12,1066,2706,1269,2040,3204,10285
2023-03-11,12,1590,1078,3693,1786,2031,10178
2023-03-12,12,1412,1853,3060,2516,3723,12564
2023-03-13,12,2704,2481,1251,3351,3400,13187
2023-03-14,12,2261,2093,1822,3197,2765,12138
2023-03-15,12,3079,1566,2304,2472,2092,11513
2023-03-16,12,1040,1308,2431,4263,4202,13244
2023-03-17,12,1947,1796,1225,4095,4256,13319
2023-03-18,12,3405,2568,2364,3661,4490,16488
2023-03-19,12,4358,1605,3294,1798,5639,16694
2023-03-20,12,4896,2830,2395,4019,2750,16890
2023-03-21,12,2114,1031,1732,4442,4785,14104
2023-03-22,12,4211,2485,1514,3563,2539,14312
2023-03-23,12,4316,1901,1523,2486,5878,16104
2023-03-24,12,2959,1770,3256,2060,2339,12384
2023-03-25,12,2902,1053,1680,2764,2551,10950
2023-03-26,12,4330,2947,3665,2645,2532,16119
2023-03-27,12,2398,2669,3187,2383,5125,15762
2023-03-28,12,3951,1794,3895,2037,3155,14832
2023-03-29,12,3065,1202,3568,2833,4395,15063
2023-03-30,12,4775,2838,1364,2919,2607,14503
2023-03-31,12,3306,2607,1756,1757,3137,12563
2023-04-01,12,3450,1952,3693,3122,4123,16340
2023-04-02,12,4426,1446,2683,2236,3149,13940
2023-04-03,12,4108,1353,1629,3780,2403,13273
2023-04-04,12,2379,1931,3673,1574,5466,15023
2023-04-05,12,2179,844,3919,3530,3514,13986
2023-04-06,12,4520,1377,1832,2885,4848,15462
2023-04-07,12,1779,1061,1678,2987,5550,13055
2023-04-08,12,3694,2142,3709,3002,4173,16720
2023-04-09,12,4199,1347,2138,3163,2879,13726
2023-04-10,12,2263,2317,1439,1933,2144,10096
2023-04-11,12,1232,1703,1385,3462,2228,10010
2023-04-12,12,2665,1228,3249,4165,2902,14209
2023-04-13,12,1144,1630,2103,3574,5632,14083
2023-04-14,12,2313,2485,2704,4346,2634,14482
2023-04-15,12,2159,2030,2497,4212,4661,15559
2023-04-16,12,4481,1988,2551,3147,2113,14280
2023-04-17,12,4709,2703,2707,3799,3860,17778
2023-04-18,12,4487,2505,3495,3167,2945,16599
2023-04-19,12,4812,1589,2843,3355,3036,15635
2023-04-20,12,2195,1419,1658,3080,3263,11615
2023-04-21,12,2261,2938,2906,2087,5515,15707
2023-04-22,12,3326,2358,2362,3966,4961,16973
2023-04-23,12,1744,2744,2802,1532,3373,12195
2023-04-24,12,3677,1753,3117,2438,2835,13820
2023-04-25,12,2649,1007,1451,4247,2567,11921
2023-04-26,12,4058,1286,1617,2033,2862,11856
2023-04-27,12,2948,2789,1830,3578,2343,13488
2023-04-28,12,4932,1245,3885,4236,5822,20120
2023-04-29,12,3253,1943,2119,3535,2015,12865
2023-04-30,12,4598,2832,3389,2494,3532,16845
2023-05-01,12,1934,1993,2707,3854,3648,14136
2023-05-02,12,4586,1809,1597,1977,3813,13782
2023-05-03,12,2506,2909,2959,3984,4401,16759
2023-05-04,12,1066,2877,3042,3286,5566,15837
2023-05-05,12,1071,1050,1394,2689,4164,10368
2023-05-06,12,2254,2637,3984,1762,4997,15634
2023-05-07,12,4246,2851,1969,2931,2406,14403
2023-05-08,12,3020,1048,3500,2435,3791,13794
2023-05-09,12,2560,1757,3405,2146,5520,15388
2023-05-10,12,3758,1454,1777,3976,2428,13393
2023-05-11,12,2533,2549,3206,1739,4558,14585
2023-05-12,12,1528,2444,3487,2119,5945,15523
2023-05-13,12,1356,2762,3556,2159,5858,15691
2023-05-14,12,3436,1064,1831,3834,3452,13617
2023-05-15,12,2999,2976,2328,1916,5070,15289
2023-05-16,12,1372,1523,3352,2692,4186,13125
2023-05-17,12,2546,1528,3975,1800,5534,15383
2023-05-18,12,4779,2497,3604,4025,3173,18078
2023-05-19,12,2687,1399,1611,2025,4560,12282
2023-05-20,12,3041,2608,3093,4183,2830,15755
2023-05-21,12,4300,912,3057,4100,4534,16903
2023-05-22,12,1202,1688,1794,2325,5188,12197
2023-05-23,12,2471,2800,1917,4073,2108,13369
2023-05-24,12,1184,2039,3278,2857,3617,12975
2023-05-25,12,3703,2432,1490,1521,5065,14211
2023-05-26,12,2832,1480,3636,3351,5570,16869
2023-05-27,12,3940,2053,2293,3534,5894,17714
2023-05-28,12,3426,914,1719,1628,2280,9967
2023-05-29,12,2163,2903,2817,1611,4171,13665
2023-05-30,12,4461,1631,2567,1529,2378,12566
2023-05-31,12,4851,1247,1532,1524,3482,12636
2023-06-01,12,1652,1004,3493,1633,3971,11753
2023-06-02,12,1555,1578,3638,2480,4464,13715
2023-06-03,12,2393,1758,1899,3601,3372,13023
2023-06-04,12,3232,2966,3343,2008,5135,16684
2023-06-05,12,2732,2938,3365,2315,3111,14461
2023-06-06,12,3470,1681,3008,1690,4318,14167
2023-06-07,12,2734,2874,3159,3532,4217,16516
2023-06-08,12,1171,1449,1914,4016,4866,13416
2023-06-09,12,3671,1562,2650,2053,4968,14904
2023-06-10,12,2798,2176,2868,3570,4272,15684
2023-06-11,12,4494,920,3296,2906,2611,14227
2023-06-12,12,2724,1602,2703,2615,3596,13240
2023-06-13,12,1254,1945,3017,3212,2317,11745
2023-06-14,12,3668,2377,2472,2297,3316,14130
2023-06-15,12,5000,2052,1487,3265,5929,17733
2023-06-16,12,1993,1634,3603,3406,5756,16392
2023-06-17,12,2462,857,3928,4059,4700,16006
2023-06-18,12,4758,2674,2388,3595,2389,15804
2023-06-19,12,2173,2559,2581,3588,5806,16707
2023-06-20,12,3798,1179,1471,3000,5651,15099
2023-06-21,12,3859,1428,1283,2032,5882,14484
2023-06-22,12,2663,2219,3526,3831,4315,16554
2023-06-23,12,1356,1293,2490,1660,4004,10803
2023-06-24,12,1060,2389,1716,3624,5094,13883
2023-06-25,12,4621,2892,3909,3278,5521,20221
2023-06-26,12,3554,1449,1943,3717,2105,12768
2023-06-27,12,4676,1300,2896,1713,5784,16369
2023-06-28,12,3821,2139,2607,3129,4244,15940
2023-06-29,12,4389,2826,2398,4229,4255,18097
2023-06-30,12,1417,2831,3837,1666,5016,14767
2023-07-01,12,4565,1583,2041,3231,3502,14922
2023-07-02,12,1608,1653,2391,3356,3851,12859
2023-07-03,12,3412,1726,1560,4119,2210,13027
2023-07-04,12,3426,2221,2649,3809,5179,17284
2023-07-05,12,1407,2643,1566,4306,5617,15539
2023-07-06,12,3220,1325,2381,3528,5299,15753
2023-07-07,12,4522,2352,2815,2704,4510,16903
2023-07-08,12,2166,1488,3141,3500,2160,12455
2023-07-09,12,2264,2991,2913,1934,4357,14459
2023-07-10,12,1122,2899,2831,2252,2197,11301
2023-07-11,12,3755,2153,1373,3887,3040,14208
2023-07-12,12,1270,2449,3249,4174,3306,14448
2023-07-13,12,4341,1125,1254,1622,4508,12850
2023-07-14,12,3747,2626,1385,2206,4376,14340
2023-07-15,12,4166,2504,2973,4223,4068,17934
2023-07-16,12,4502,2014,1583,3654,3176,14929
2023-07-17,12,2426,1353,1849,4255,4470,14353
2023-07-18,12,1603,2147,2100,1759,3790,11399
2023-07-19,12,1300,1725,3055,3653,5327,15060
2023-07-20,12,1200,2619,1914,2428,4208,12369
2023-07-21,12,3476,1270,2210,2578,3517,13051
2023-07-22,12,2647,2976,1242,2060,5996,14921
2023-07-23,12,1030,2069,1627,2292,3584,10602
2023-07-24,12,3722,2668,1549,4280,4299,16518
2023-07-25,12,3297,1394,1451,2633,3823,12598
2023-07-26,12,4766,1084,3281,2607,2667,14405
2023-07-27,12,3015,1654,2177,3165,3243,13254
2023-07-28,12,3270,2834,1392,2785,4150,14431
2023-07-29,12,3342,1643,2709,3529,5389,16612
2023-07-30,12,4111,2444,3349,4427,3187,17518
2023-07-31,12,2775,1748,3137,3506,5897,17063
2023-08-01,12,2586,2393,1952,4211,5901,17043
2023-08-02,12,1435,1330,2938,4147,4428,14278
2023-08-03,12,1976,2824,1942,2056,5693,14491
2023-08-04,12,4272,1949,2859,2660,4466,16206
2023-08-05,12,1653,1786,3391,2206,2599,11635
2023-08-06,12,1947,2045,3070,3439,5041,15542
2023-08-07,12,4469,969,3404,2419,3957,15218
2023-08-08,12,1769,2096,2070,3960,3746,13641
2023-08-09,12,3866,2589,3207,3626,3243,16531
2023-08-10,12,3846,1770,3382,1872,4347,15217
2023-08-11,12,1663,1941,1492,1754,4305,11155
2023-08-12,12,1235,1265,1614,2639,3166,9919
2023-08-13,12,1767,2713,2450,3227,5556,15713
2023-08-14,12,3634,1860,2588,4379,5913,18374
2023-08-15,12,4030,1336,1360,4286,2830,13842
2023-08-16,12,4142,2073,3543,3756,4279,17793
2023-08-17,12,2612,1640,3501,3621,4320,15694
2023-08-18,12,4807,1854,1556,2980,5241,16438
2023-08-19,12,3536,2949,1875,3943,3877,16180
2023-08-20,12,2308,1147,3136,3724,3756,14071
2023-08-21,12,3981,2707,3384,2494,5466,18032
2023-08-22,12,1138,2904,2652,3098,5925,15717
2023-08-23,12,2315,2018,2457,1894,2496,11180
2023-08-24,12,4603,2100,2437,3797,5253,18190
2023-08-25,12,1016,1308,2374,3128,3840,11666
2023-08-26,12,4581,1064,3612,3157,2060,14474
2023-08-27,12,3013,1576,2510,3121,4207,14427
2023-08-28,12,1695,1661,1503,3040,4513,12412
2023-08-29,12,2482,2343,3643,1957,4668,15093
2023-08-30,12,2681,1028,3076,4003,2452,13240
2023-08-31,12,1073,2444,3355,2622,4348,13842
2023-09-01,12,2370,1950,1241,3907,5765,15233
2023-09-02,12,1688,2490,2995,2335,4654,14162
2023-09-03,12,4512,914,1433,4021,4983,15863
2023-09-04,12,2164,1669,1228,4035,3139,12235
2023-09-05,12,4891,1942,3355,2631,5994,18813
2023-09-06,12,1870,2384,1779,2234,5454,13721
2023-09-07,12,4020,2930,3996,3229,3925,18100
2023-09-08,12,2865,2618,1869,3597,4400,15349
2023-09-09,12,1148,2698,1261,4362,5804,15273
2023-09-10,12,1727,2149,3226,3559,4952,15613
2023-09-11,12,1780,1810,3366,1985,5203,14144
2023-09-12,12,4695,2216,1913,2048,4261,15133
2023-09-13,12,4585,1945,3613,2974,3028,16145
2023-09-14,12,4303,1998,2329,4463,4402,17495
2023-09-15,12,1662,1723,3836,3637,5864,16722
2023-09-16,12,3699,926,2832,2443,2908,12808
2023-09-17,12,2309,2765,2178,3307,5961,16520
2023-09-18,12,3677,2728,3429,4040,2600,16474
2023-09-19,12,1357,2571,3863,4076,5645,17512
2023-09-20,12,2545,1054,2077,2514,3731,11921
2023-09-21,12,2848,2016,1720,2382,3045,12011
2023-09-22,12,4354,1256,2827,3594,3628,15659
2023-09-23,12,4347,1790,2758,4453,3269,16617
2023-09-24,12,4155,1199,3974,4063,3308,16699
2023-09-25,12,1062,1800,1284,3115,4234,11495
2023-09-26,12,1928,1523,3620,2038,4882,13991
2023-09-27,12,3110,1940,1407,1895,3911,12263
2023-09-28,12,2861,1779,2866,2936,5158,15600
2023-09-29,12,2723,1505,1254,2127,4598,12207
2023-09-30,12,4646,1515,2279,3869,3689,15998
2023-10-01,12,4850,1591,2309,2301,2246,13297
2023-10-02,12,4409,2565,2964,2714,4266,16918
2023-10-03,12,2734,1622,1209,1519,4335,11419
2023-10-04,12,3382,984,2176,4213,4889,15644
2023-10-05,12,4950,1566,1349,1883,5356,15104
2023-10-06,12,2105,2333,2678,2082,2830,12028
2023-10-07,12,3325,908,3278,3156,2247,12914
2023-10-08,12,1684,2564,1871,2045,2894,11058
2023-10-09,12,3065,957,1506,2487,4845,12860
2023-10-10,12,1064,1998,2785,2241,4072,12160
2023-10-11,12,3473,1772,2044,1752,5726,14767
2023-10-12,12,3764,870,3818,4326,2990,15768
2023-10-13,12,2389,2908,2706,3568,4185,15756
2023-10-14,12,4355,2569,1502,3937,5835,18198
2023-10-15,12,4859,1658,3306,1536,5104,16463
2023-10-16,12,3082,1422,2821,3412,2093,12830
2023-10-17,12,2843,1572,3667,2328,3292,13702
2023-10-18,12,3668,1320,1865,3016,2810,12679
2023-10-19,12,1864,2485,2977,4440,3952,15718
2023-10-20,12,2997,2622,1337,4128,3546,14630
2023-10-21,12,3052,2487,3639,2663,5108,16949
2023-10-22,12,3233,1074,2470,2638,5147,14562
2023-10-23,12,1207,2465,3637,4326,2586,14221
2023-10-24,12,1234,1849,3581,2969,4283,13916
2023-10-25,12,4911,1154,2644,2258,5992,16959
2023-10-26,12,4704,1969,2674,3507,5072,17926
2023-10-27,12,4890,2769,1916,3572,4268,17415
2023-10-28,12,2239,998,2040,3235,2323,10835
2023-10-29,12,3355,2300,1691,3203,2590,13139
2023-10-30,12,1842,2424,3811,4262,5205,17544
2023-10-31,12,4229,2768,2365,1986,4282,15630
2023-11-01,12,1805,1084,3808,3525,3138,13360
2023-11-02,12,2996,1416,3644,3529,4103,15688
2023-11-03,12,4918,2142,1930,3321,5092,17403
2023-11-04,12,4753,2009,1508,4170,3722,16162
2023-11-05,12,2245,832,3355,4403,4053,14888
2023-11-06,12,2614,1884,2377,3436,2063,12374
2023-11-07,12,2108,926,1441,3794,4589,12858
2023-11-08,12,2008,2606,3919,4464,2361,15358
2023-11-09,12,4014,2239,3830,4262,3814,18159
2023-11-10,12,3804,2943,3309,2662,5262,17980
2023-11-11,12,1650,1572,2544,3024,4060,12850
2023-11-12,12,3678,2423,1491,4442,5413,17447
2023-11-13,12,3538,1901,2205,4378,2174,14196
2023-11-14,12,1755,2144,2017,3919,3763,13598
2023-11-15,12,2084,2467,2159,1703,3260,11673
2023-11-16,12,4364,2854,1977,3303,4943,17441
2023-11-17,12,3309,1335,2775,1528,5851,14798
2023-11-18,12,4835,2257,3806,1652,3797,16347
2023-11-19,12,3151,2375,2648,3715,5805,17694
2023-11-20,12,4304,1887,2252,2542,2003,12988
2023-11-21,12,1476,2303,1623,2272,3323,10997
2023-11-22,12,1176,1525,2751,4075,4507,14034
2023-11-23,12,2873,1968,3555,3189,4016,15601
2023-11-24,12,3875,1477,2234,3862,3981,15429
2023-11-25,12,2135,1962,1653,3631,2842,12223
2023-11-26,12,3972,2218,3278,3649,2649,15766
2023-11-27,12,1282,2670,2578,2479,3766,12775
2023-11-28,12,3061,2255,2293,3361,4957,15927
2023-11-29,12,4230,2628,3062,3085,2544,15549
2023-11-30,12,4542,1187,2937,2567,3428,14661
2023-12-01,12,1944,1291,2779,2779,5434,14227
2023-12-02,12,3353,1323,2417,3929,2742,13764
2023-12-03,12,2219,2966,2739,2318,4289,14531
2023-12-04,12,3354,2031,3898,2522,5135,16940
2023-12-05,12,3427,1749,1956,1975,3745,12852
2023-12-06,12,1984,907,2654,2904,3683,12132
2023-12-07,12,1999,906,2791,2750,5977,14423
2023-12-08,12,4648,1573,2330,2783,2888,14222
2023-12-09,12,1584,2914,3689,2748,4209,15144
2023-12-10,12,2740,2360,3963,3487,5206,17756
2023-12-11,12,4637,2075,1711,2170,3439,14032
2023-12-12,12,4936,2022,3298,2132,4852,17240
2023-12-13,12,4064,1229,1231,2136,2229,10889
2023-12-14,12,1104,2151,3873,4231,5387,16746
2023-12-15,12,1384,1786,3774,2217,3581,12742
2023-12-16,12,2101,1800,1819,3532,2564,11816
2023-12-17,12,2354,2891,1483,1814,2431,10973
2023-12-18,12,1826,825,3519,4396,4781,15347
2023-12-19,12,2970,1756,2089,1648,2843,11306
2023-12-20,12,1036,1806,3938,2872,4801,14453
2023-12-21,12,1803,2729,1723,4154,4505,14914
2023-12-22,12,3512,1548,3145,4153,2141,14499
2023-12-23,12,2395,1301,2450,2836,4878,13860
2023-12-24,12,2025,2708,3563,2864,4553,15713
2023-12-25,12,3655,2906,2237,2488,3923,15209
2023-12-26,12,1373,2172,3084,4485,4427,15541
2023-12-27,12,3104,2992,3071,2217,5187,16571
2023-12-28,12,3681,2918,1994,3778,5141,17512
2023-12-29,12,3958,1030,2359,3261,4175,14783
2023-12-30,12,2314,2519,3564,2861,4304,15562
2023-12-31,12,2700,2916,3815,2709,3103,15243
2022-01-01,13,1531,2223,2615,1965,2786,11120
2022-01-02,13,2921,2935,3653,4191,4578,18278
2022-01-03,13,3411,2482,3199,2025,2451,13568
2022-01-04,13,2557,1615,3068,4250,5350,16840
2022-01-05,13,2155,992,2695,3131,3574,12547
2022-01-06,13,4102,2792,3762,2804,2940,16400
2022-01-07,13,4978,2695,3254,4474,2272,17673
2022-01-08,13,2771,2206,2511,1948,5265,14701
2022-01-09,13,4539,1676,3808,4239,4713,18975
2022-01-10,13,3055,1100,2354,3061,3399,12969
2022-01-11,13,3735,1760,3345,2036,5840,16716
2022-01-12,13,1585,1156,2382,3319,5190,13632
2022-01-13,13,2202,2568,2872,1576,2646,11864
2022-01-14,13,1825,2381,3029,3626,2255,13116
2022-01-15,13,4996,1470,1782,2284,2069,12601
2022-01-16,13,3433,820,3027,2615,3098,12993
2022-01-17,13,4331,1466,2687,2965,5977,17426
2022-01-18,13,2868,1415,2525,2019,3164,11991
2022-01-19,13,3556,2076,1224,2559,2177,11592
2022-01-20,13,3697,1223,2570,1727,3840,13057
2022-01-21,13,4963,2979,3746,3439,5760,20887
2022-01-22,13,3532,2722,2787,3344,5633,18018
2022-01-23,13,4457,2904,3650,3986,3137,18134
2022-01-24,13,1878,972,1584,4330,3565,12329
2022-01-25,13,2901,2686,1431,1882,3052,11952
2022-01-26,13,1110,1780,3779,3342,3234,13245
2022-01-27,13,3263,1678,2249,3145,4465,14800
2022-01-28,13,4309,2944,3723,3096,5991,20063
2022-01-29,13,2053,1956,3567,4377,5939,17892
2022-01-30,13,2900,2833,3240,2601,5777,17351
2022-01-31,13,4973,1680,3927,2200,3466,16246
2022-02-01,13,4002,2947,3678,1731,3940,16298
2022-02-02,13,3924,1855,1256,1680,4748,13463
2022-02-03,13,3125,1805,3566,2615,5580,16691
2022-02-04,13,2590,2232,1591,3841,2336,12590
2022-02-05,13,3389,2404,2137,3636,2134,13700
2022-02-06,13,2059,1171,2190,4380,3307,13107
2022-02-07,13,2341,2954,1361,2477,5813,14946
2022-02-08,13,4304,1087,2763,2121,5496,15771
2022-02-09,13,2807,833,2170,4301,5230,15341
2022-02-10,13,1972,2386,3498,1972,4849,14677
2022-02-11,13,4623,982,3389,2293,4123,15410
2022-02-12,13,2764,1611,3376,2804,3377,13932
2022-02-13,13,4650,2075,2770,4006,5176,18677
2022-02-14,13,3847,1927,3538,1526,2620,13458
2022-02-15,13,2728,2526,2250,2924,2425,12853
2022-02-16,13,1828,1867,2664,3040,2311,11710
2022-02-17,13,1553,1752,3775,3708,3865,14653
2022-02-18,13,2744,1619,1275,1676,2061,9375
2022-02-19,13,1394,1928,1203,3452,4165,12142
2022-02-20,13,4661,1938,1542,1738,2478,12357
2022-02-21,13,1219,2822,3920,3539,4890,16390
2022-02-22,13,2539,2183,2790,2400,5034,14946
2022-02-23,13,2535,2245,1956,3126,4219,14081
2022-02-24,13,3323,895,1577,2547,2920,11262
2022-02-25,13,1772,2414,3298,4489,4094,16067
2022-02-26,13,2158,2887,2998,3020,4303,15366
2022-02-27,13,4762,1700,2046,1709,5007,15224
2022-02-28,13,3594,1064,1692,2546,3213,12109
2022-03-01,13,3964,2229,3547,3732,4863,18335
2022-03-02,13,2468,1352,3141,1508,2280,10749
2022-03-03,13,4598,2819,3005,4224,5627,20273
2022-03-04,13,1942,1086,2034,2820,4540,12422
2022-03-05,13,2564,2693,1754,3583,2553,13147
2022-03-06,13,3311,1713,3739,3411,4497,16671
2022-03-07,13,2161,1685,3567,2386,3029,12828
2022-03-08,13,2096,1561,3821,2889,2224,12591
2022-03-09,13,4751,803,1354,3333,2694,12935
2022-03-10,13,1506,2402,3641,1958,4729,14236
2022-03-11,13,1627,2684,3406,2120,4817,14654
2022-03-12,13,1608,1214,1828,4150,4429,13229
2022-03-13,13,2421,2649,2135,3874,3008,14087
2022-03-14,13,3018,1314,2051,1768,4858,13009
2022-03-15,13,1087,2432,3292,2180,4174,13165
2022-03-16,13,4554,1778,2299,3694,5874,18199
2022-03-17,13,4708,1425,3436,3880,4828,18277
2022-03-18,13,3482,2741,2107,4284,5060,17674
2022-03-19,13,3850,1342,2451,1908,2277,11828
2022-03-20,13,3119,2319,2402,3871,5476,17187
2022-03-21,13,2804,1174,3735,4346,5544,17603
2022-03-22,13,1505,967,3804,2049,2822,11147
2022-03-23,13,3002,1373,3164,3316,3105,13960
2022-03-24,13,2770,1321,1550,2677,3986,12304
2022-03-25,13,1618,2346,2138,3834,3493,13429
2022-03-26,13,3726,1929,3329,1628,2127,12739
2022-03-27,13,3298,1056,2647,3818,5247,16066
2022-03-28,13,3409,1895,1405,1637,4476,12822
2022-03-29,13,4002,1161,1372,3573,2267,12375
2022-03-30,13,4608,2292,3029,2544,4443,16916
2022-03-31,13,3108,1856,3195,3516,5632,17307
2022-04-01,13,2757,904,2184,2356,2142,10343
2022-04-02,13,4176,2083,1331,3668,5228,16486
2022-04-03,13,4219,2107,2515,2794,5146,16781
2022-04-04,13,2184,1269,3400,2877,3198,12928
2022-04-05,13,4387,1588,2542,3325,4476,16318
2022-04-06,13,3418,846,2202,2386,3130,11982
2022-04-07,13,2998,1014,2361,3945,4882,15200
2022-04-08,13,1601,2194,3451,3106,5754,16106
2022-04-09,13,2733,2293,3167,3551,2843,14587
2022-04-10,13,3341,1532,2593,2734,3796,13996
2022-04-11,13,2876,2902,3419,3896,3079,16172
2022-04-12,13,3109,2109,2695,4376,5323,17612
2022-04-13,13,2937,2102,3380,2648,4711,15778
2022-04-14,13,1817,1018,1742,1972,2538,9087
2022-04-15,13,2657,2232,3704,3025,3065,14683
2022-04-16,13,2337,2514,3994,2891,5109,16845
2022-04-17,13,1331,1758,3448,3667,3620,13824
2022-04-18,13,4664,2252,2842,2557,4122,16437
2022-04-19,13,3053,2931,2599,3343,4493,16419
2022-04-20,13,2477,1505,3189,1933,4508,13612
2022-04-21,13,2550,1227,1541,2248,3311,10877
2022-04-22,13,1980,1570,1981,2686,5052,13269
2022-04-23,13,3650,2216,2508,2739,5771,16884
2022-04-24,13,4480,1544,1447,4486,3823,15780
2022-04-25,13,1198,1491,1423,2217,2919,9248
2022-04-26,13,3572,1708,1396,1524,3027,11227
2022-04-27,13,3318,1809,3156,4278,3020,15581
2022-04-28,13,1632,1071,3683,3762,3878,14026
2022-04-29,13,2576,1450,3751,2375,3932,14084
2022-04-30,13,3055,1749,3883,3060,4434,16181
2022-05-01,13,3529,2722,3238,1658,4279,15426
2022-05-02,13,3702,2150,3369,3508,3142,15871
2022-05-03,13,3636,2833,2154,4413,3985,17021
2022-05-04,13,1432,1335,1630,2455,3371,10223
2022-05-05,13,4117,1098,3288,3565,4790,16858
2022-05-06,13,1841,2127,2874,3042,4886,14770
2022-05-07,13,1059,1897,2859,2522,3616,11953
2022-05-08,13,3854,2829,3198,2883,2440,15204
2022-05-09,13,4289,2906,3912,3700,3003,17810
2022-05-10,13,3094,986,1819,4486,3495,13880
2022-05-11,13,4299,1154,2551,2201,5025,15230
2022-05-12,13,1750,1618,3893,1612,4040,12913
2022-05-13,13,3775,2975,2794,1987,5092,16623
2022-05-14,13,1127,2287,1272,1756,3823,10265
2022-05-15,13,3260,2085,3506,4497,4952,18300
2022-05-16,13,1225,2019,3779,4380,2426,13829
2022-05-17,13,3325,1233,2378,4166,4352,15454
2022-05-18,13,2518,2672,2887,2822,4383,15282
2022-05-19,13,4637,2713,1261,3137,3848,15596
2022-05-20,13,2247,1875,2786,2181,2878,11967
2022-05-21,13,1664,903,1469,2576,3065,9677
2022-05-22,13,1820,2352,2252,4153,5136,15713
2022-05-23,13,3385,1101,1780,2486,5216,13968
2022-05-24,13,1864,2329,1229,2976,4357,12755
2022-05-25,13,4525,2919,1776,2234,2415,13869
2022-05-26,13,2064,2464,1659,2664,4199,13050
2022-05-27,13,1177,1898,2574,4164,5310,15123
2022-05-28,13,4819,1898,3953,2953,4948,18571
2022-05-29,13,4273,2480,3097,3790,4078,17718
2022-05-30,13,3854,1535,1674,3922,2366,13351
2022-05-31,13,2786,2431,3743,3930,3714,16604
2022-06-01,13,1463,1152,1750,3070,3599,11034
2022-06-02,13,1264,2368,1827,3468,3767,12694
2022-06-03,13,2865,2499,1377,4262,2306,13309
2022-06-04,13,1579,1132,2710,3723,4177,13321
2022-06-05,13,4343,968,1762,3142,2391,12606
2022-06-06,13,4261,2163,2063,2220,2618,13325
2022-06-07,13,1975,2648,1319,1910,2768,10620
2022-06-08,13,2435,1835,2709,1620,2736,11335
2022-06-09,13,2132,944,2282,1550,2468,9376
2022-06-10,13,4655,1909,2400,3919,4756,17639
2022-06-11,13,3087,1262,2055,1746,4413,12563
2022-06-12,13,4296,1142,2082,4018,4749,16287
2022-06-13,13,3050,1803,2349,1703,4664,13569
2022-06-14,13,2751,1218,1815,4164,2542,12490
2022-06-15,13,3419,1766,1474,4337,4671,15667
2022-06-16,13,4469,1723,2977,3137,3892,16198
2022-06-17,13,1370,996,2875,1524,4957,11722
2022-06-18,13,2837,2783,3977,4242,5641,19480
2022-06-19,13,3884,1508,1401,1631,2352,10776
2022-06-20,13,3196,1078,2214,2603,4602,13693
2022-06-21,13,1439,2564,3123,4151,5568,16845
2022-06-22,13,3060,1000,3986,3370,5515,16931
2022-06-23,13,1654,1803,2266,2824,5692,14239
2022-06-24,13,1615,2741,3727,3232,5853,17168
2022-06-25,13,3223,2602,3957,2036,2418,14236
2022-06-26,13,4733,2480,1675,2266,4933,16087
2022-06-27,13,1453,885,3498,3728,3270,12834
2022-06-28,13,1422,919,1244,4119,3502,11206
2022-06-29,13,4297,1620,1460,2890,3386,13653
2022-06-30,13,3246,1617,3985,4457,4519,17824
2022-07-01,13,2871,2049,1713,3680,3683,13996
2022-07-02,13,4015,2873,2103,1715,4475,15181
2022-07-03,13,1756,2476,2349,3629,2164,12374
2022-07-04,13,4636,1553,2527,4328,4473,17517
2022-07-05,13,3021,2314,3058,1831,5073,15297
2022-07-06,13,4300,840,2018,2763,5697,15618
2022-07-07,13,1294,2455,2488,2632,2763,11632
2022-07-08,13,3841,2246,1268,3651,3366,14372
2022-07-09,13,1125,1643,1800,3644,2364,10576
2022-07-10,13,4993,2323,3402,2899,3829,17446
2022-07-11,13,3427,884,1802,4284,5137,15534
2022-07-12,13,3757,2573,3107,3704,5213,18354
2022-07-13,13,2136,1936,2609,2654,4727,14062
2022-07-14,13,1417,1899,1612,2599,5179,12706
2022-07-15,13,3468,869,1212,3025,5730,14304
2022-07-16,13,3082,1010,2671,4379,2568,13710
2022-07-17,13,3926,2171,3594,2833,3220,15744
2022-07-18,13,2828,2519,2667,3445,2242,13701
2022-07-19,13,2962,1895,1399,1784,2769,10809
2022-07-20,13,1091,1199,2000,3199,5049,12538
2022-07-21,13,3269,1221,2798,3868,4897,16053
2022-07-22,13,3510,1791,2690,3271,4954,16216
2022-07-23,13,3468,915,3207,2874,5785,16249
2022-07-24,13,3813,1025,2420,3860,5060,16178
2022-07-25,13,4827,1280,3843,1631,5307,16888
2022-07-26,13,3955,1826,1945,2980,3488,14194
2022-07-27,13,2553,1441,3976,3805,5785,17560
2022-07-28,13,4858,1701,1777,3259,5038,16633
2022-07-29,13,1493,2752,3427,4152,4392,16216
2022-07-30,13,4909,1848,3736,2805,2717,16015
2022-07-31,13,4903,2581,2905,4480,5103,19972
2022-08-01,13,2700,2271,2898,4189,3106,15164
2022-08-02,13,2355,1707,1419,4398,3851,13730
2022-08-03,13,1276,2134,3467,2423,3473,12773
2022-08-04,13,3333,1513,3012,3683,5473,17014
2022-08-05,13,2007,1647,2939,3618,3350,13561
2022-08-06,13,1328,1229,3125,1968,4912,12562
2022-08-07,13,2285,2470,1626,2097,3356,11834
2022-08-08,13,4659,919,1529,3935,4469,15511
2022-08-09,13,4280,1813,3038,3465,4607,17203
2022-08-10,13,1596,2444,3969,3572,5429,17010
2022-08-11,13,1693,917,3628,2618,5190,14046
2022-08-12,13,3812,1523,3756,4232,3196,16519
2022-08-13,13,3440,1686,2788,1617,4529,14060
2022-08-14,13,3032,1284,1834,4079,4166,14395
2022-08-15,13,3397,2616,2592,3761,3330,15696
2022-08-16,13,4093,2711,1959,3077,5746,17586
2022-08-17,13,4354,1365,1472,3639,4928,15758
2022-08-18,13,3165,2609,2375,3698,4789,16636
2022-08-19,13,1358,2921,3842,3601,4683,16405
2022-08-20,13,2715,1429,2626,3882,3573,14225
2022-08-21,13,2054,1435,2676,4182,5293,15640
2022-08-22,13,3346,1578,2875,4416,2088,14303
2022-08-23,13,3743,1426,2946,3698,2931,14744
2022-08-24,13,4569,2163,1386,3900,5270,17288
2022-08-25,13,3779,915,2028,2549,3268,12539
2022-08-26,13,2770,2261,1793,4487,3267,14578
2022-08-27,13,4740,2761,3457,3941,5608,20507
2022-08-28,13,1553,2345,4000,1940,4153,13991
2022-08-29,13,1434,1650,3632,3486,2957,13159
2022-08-30,13,2865,2916,2074,4242,3379,15476
2022-08-31,13,3233,2497,2602,1965,2208,12505
2022-09-01,13,1423,1774,2850,1850,5816,13713
2022-09-02,13,3555,1523,2796,2069,3321,13264
2022-09-03,13,2921,1084,2131,1797,3160,11093
2022-09-04,13,3815,2286,2138,4312,2717,15268
2022-09-05,13,2657,1647,3787,1898,4809,14798
2022-09-06,13,3004,2412,2191,3710,2638,13955
2022-09-07,13,2515,2456,1816,3474,4932,15193
2022-09-08,13,2236,2140,3271,1611,2964,12222
2022-09-09,13,2724,1930,2333,4385,2198,13570
2022-09-10,13,3660,1188,3684,4182,2801,15515
2022-09-11,13,1596,1601,3668,4041,3721,14627
2022-09-12,13,1827,2586,3093,2317,3255,13078
2022-09-13,13,2193,1366,1684,3261,5171,13675
2022-09-14,13,2769,2604,3359,1592,4168,14492
2022-09-15,13,4850,2088,1986,2221,3489,14634
2022-09-16,13,1550,1097,2884,3796,2615,11942
2022-09-17,13,2521,1269,3462,1691,2268,11211
2022-09-18,13,3926,2053,1540,2067,4976,14562
2022-09-19,13,1924,1590,3718,1566,2872,11670
2022-09-20,13,1050,2527,2928,1780,2183,10468
2022-09-21,13,4979,998,3378,1750,4379,15484
2022-09-22,13,2579,2451,3350,2387,2604,13371
2022-09-23,13,1272,1968,2213,1821,2314,9588
2022-09-24,13,3264,2727,2912,2722,2766,14391
2022-09-25,13,3471,1986,3510,3265,2935,15167
2022-09-26,13,2765,1373,1268,2251,4275,11932
2022-09-27,13,1111,1168,2226,4451,3035,11991
2022-09-28,13,2229,2745,3993,3472,5324,17763
2022-09-29,13,1043,1298,2394,2323,4476,11534
2022-09-30,13,2906,1815,3821,3819,5019,17380
2022-10-01,13,1732,2109,2703,3285,4203,14032
2022-10-02,13,3898,1634,3610,3696,2051,14889
2022-10-03,13,4375,2719,1701,3464,3935,16194
2022-10-04,13,2019,2836,3121,4342,5430,17748
2022-10-05,13,2138,1174,2588,3201,5769,14870
2022-10-06,13,4823,2506,2040,4336,2030,15735
2022-10-07,13,4939,1140,2272,2789,2323,13463
2022-10-08,13,2617,1051,1240,3529,3040,11477
2022-10-09,13,1725,2980,3430,4467,4582,17184
2022-10-10,13,1033,2575,1929,3430,4017,12984
2022-10-11,13,4833,1020,3721,1673,4588,15835
2022-10-12,13,1497,2283,1579,4071,4349,13779
2022-10-13,13,1465,1547,1666,3952,2960,11590
2022-10-14,13,3621,2649,1573,2621,2785,13249
2022-10-15,13,2872,2807,3978,1702,4354,15713
2022-10-16,13,2455,807,1629,3474,4476,12841
2022-10-17,13,3252,1337,2071,3592,2239,12491
2022-10-18,13,1428,1815,2302,4060,4307,13912
2022-10-19,13,1721,2998,1567,2371,5068,13725
2022-10-20,13,3517,1352,2181,2174,2661,11885
2022-10-21,13,3153,1319,3153,3035,2749,13409
2022-10-22,13,1191,2502,3592,3036,3970,14291
2022-10-23,13,1812,1279,3319,4354,2840,13604
2022-10-24,13,3092,876,1459,3489,3947,12863
2022-10-25,13,3966,2002,1252,2864,4250,14334
2022-10-26,13,3322,2980,2135,3906,3027,15370
2022-10-27,13,3087,2503,3365,3525,3298,15778
2022-10-28,13,1102,2270,3157,4477,4445,15451
2022-10-29,13,3545,1740,2572,2305,2005,12167
2022-10-30,13,2819,2323,2930,2949,4362,15383
2022-10-31,13,2735,2353,2371,4409,5079,16947
2022-11-01,13,3223,918,1594,4436,4846,15017
2022-11-02,13,4676,2633,3707,2761,3578,17355
2022-11-03,13,1403,2489,1702,3860,4888,14342
2022-11-04,13,1773,1900,2163,3014,2140,10990
2022-11-05,13,1380,2241,3754,3165,3286,13826
2022-11-06,13,4544,1538,2302,2132,4600,15116
2022-11-07,13,3439,1777,2424,1557,2340,11537
2022-11-08,13,3332,2874,3211,2277,5751,17445
2022-11-09,13,3747,1388,1503,2027,4130,12795
2022-11-10,13,1964,2943,2034,2189,4563,13693
2022-11-11,13,4135,2455,1856,4432,4336,17214
2022-11-12,13,2406,2409,3787,2509,5948,17059
2022-11-13,13,3675,2894,1249,2789,5806,16413
2022-11-14,13,1406,970,3788,2514,5921,14599
2022-11-15,13,3471,806,1560,4384,4347,14568
2022-11-16,13,2249,2485,2940,2091,2225,11990
2022-11-17,13,4169,1581,3945,3704,4632,18031
2022-11-18,13,3558,2886,2794,3546,5110,17894
2022-11-19,13,3152,1877,3294,3106,5012,16441
2022-11-20,13,3655,2823,3749,2628,4788,17643
2022-11-21,13,4384,939,3028,3644,2447,14442
2022-11-22,13,4747,2945,2454,2631,2795,15572
2022-11-23,13,1384,1733,2610,4294,2557,12578
2022-11-24,13,2257,1675,1586,4240,5896,15654
2022-11-25,13,2066,2177,2277,1796,2494,10810
2022-11-26,13,3007,1498,2196,4069,4978,15748
2022-11-27,13,4804,2350,3991,4068,2052,17265
2022-11-28,13,3336,1910,1383,3176,2732,12537
2022-11-29,13,1490,2699,1628,3490,5761,15068
2022-11-30,13,4582,1133,3843,3471,4149,17178
2022-12-01,13,1525,1099,3759,1759,3533,11675
2022-12-02,13,1289,2052,2998,2396,5042,13777
2022-12-03,13,1724,2758,2868,1907,4350,13607
2022-12-04,13,2622,1502,1369,2861,4725,13079
2022-12-05,13,4848,844,1303,3242,3147,13384
2022-12-06,13,3239,2140,1748,1566,5021,13714
2022-12-07,13,1821,2779,3231,3866,4207,15904
2022-12-08,13,2451,979,2219,2280,2227,10156
2022-12-09,13,1075,1844,2208,3506,3308,11941
2022-12-10,13,4469,2354,1821,4355,2997,15996
2022-12-11,13,1067,2245,3193,4446,4990,15941
2022-12-12,13,3070,1743,3916,2023,3729,14481
2022-12-13,13,4167,1976,2672,2856,3429,15100
2022-12-14,13,2106,1460,2521,3655,3955,13697
2022-12-15,13,3749,992,1353,2783,5314,14191
2022-12-16,13,3427,1759,2081,3101,2974,13342
2022-12-17,13,4799,2363,2467,2591,4851,17071
2022-12-18,13,4042,857,2430,3240,3484,14053
2022-12-19,13,3177,2006,2449,3500,3519,14651
2022-12-20,13,2020,2193,2081,2969,2274,11537
2022-12-21,13,4778,2257,2840,3008,4987,17870
2022-12-22,13,3460,2651,2243,2002,2419,12775
2022-12-23,13,4730,1500,3871,2282,2512,14895
2022-12-24,13,3271,1378,2027,2503,2108,11287
2022-12-25,13,2959,1365,3426,2129,3725,13604
2022-12-26,13,4912,3000,2292,3134,5096,18434
2022-12-27,13,1224,2319,1368,4393,3448,12752
2022-12-28,13,4084,1117,2110,2853,5787,15951
2022-12-29,13,2210,1011,3655,3878,2527,13281
2022-12-30,13,2733,2713,2223,2278,2872,12819
2022-12-31,13,4576,898,1471,1536,3048,11529
2023-01-01,13,2252,2700,3088,2801,4882,15723
2023-01-02,13,1754,1931,2576,1635,2076,9972
2023-01-03,13,4241,1206,1920,3700,3679,14746
2023-01-04,13,3106,1726,2683,1819,3643,12977
2023-01-05,13,3321,2641,2559,1598,2094,12213
2023-01-06,13,4328,1822,3257,3086,3101,15594
2023-01-07,13,4807,1316,2542,3262,5954,17881
2023-01-08,13,4550,2905,1453,3592,2384,14884
2023-01-09,13,4275,1885,2598,4442,4077,17277
2023-01-10,13,4568,1171,3229,2509,4985,16462
2023-01-11,13,4195,2128,2594,4025,3097,16039
2023-01-12,13,2053,1856,1657,2294,4396,12256
2023-01-13,13,3448,2098,3172,2149,2811,13678
2023-01-14,13,2093,2511,3935,1614,2975,13128
2023-01-15,13,3039,2033,1545,3703,4565,14885
2023-01-16,13,2286,1720,2079,2784,5444,14313
2023-01-17,13,4655,967,3853,1689,4806,15970
2023-01-18,13,4084,1371,3378,4316,4906,18055
2023-01-19,13,2505,2383,2822,4105,5318,17133
2023-01-20,13,1578,2262,1434,4225,4305,13804
2023-01-21,13,4951,1338,2654,4204,3924,17071
2023-01-22,13,3801,1805,3737,4176,5030,18549
2023-01-23,13,2626,2853,1418,2736,3275,12908
2023-01-24,13,1864,2895,2749,1610,2261,11379
2023-01-25,13,2685,1701,2345,2067,5443,14241
2023-01-26,13,1281,2627,3182,3159,3058,13307
2023-01-27,13,2140,2588,2767,3240,3432,14167
2023-01-28,13,3431,2251,3963,4262,2841,16748
2023-01-29,13,1988,2601,2276,2672,2904,12441
2023-01-30,13,3089,1860,3918,2733,4290,15890
2023-01-31,13,1525,1745,3769,3170,2122,12331
2023-02-01,13,1918,2656,2278,1584,3421,11857
2023-02-02,13,1802,1265,2060,2051,2475,9653
2023-02-03,13,4518,1935,1800,1832,2510,12595
2023-02-04,13,2753,2293,1683,2756,2440,11925
2023-02-05,13,1171,2409,2696,2771,4439,13486
2023-02-06,13,4549,1369,1211,1681,5051,13861
2023-02-07,13,1092,1579,2979,2107,5181,12938
2023-02-08,13,3617,1985,2891,1774,5768,16035
2023-02-09,13,1734,2339,2019,2883,2716,11691
2023-02-10,13,2521,900,3541,1950,2596,11508
2023-02-11,13,1508,2122,3746,3165,4573,15114
2023-02-12,13,1209,1450,2813,2031,4537,12040
2023-02-13,13,1860,1857,2127,3601,2626,12071
2023-02-14,13,4090,1886,2167,2434,5013,15590
2023-02-15,13,4387,2403,3796,3721,4211,18518
2023-02-16,13,1696,2404,2935,2391,2669,12095
2023-02-17,13,2984,1438,3257,3650,4442,15771
2023-02-18,13,2430,1996,1245,2816,3878,12365
2023-02-19,13,1298,2583,2083,2642,4432,13038
2023-02-20,13,4775,2200,1704,1720,4517,14916
2023-02-21,13,2423,1968,1886,1603,5484,13364
2023-02-22,13,3344,2263,2564,4348,5646,18165
2023-02-23,13,4543,814,3890,4454,5040,18741
2023-02-24,13,2079,893,3492,2169,4367,13000
2023-02-25,13,4839,1191,1810,3655,2860,14355
2023-02-26,13,3932,2064,3433,2147,5655,17231
2023-02-27,13,4822,2133,3752,2774,4517,17998
2023-02-28,13,2379,2437,1910,4152,4420,15298
2023-03-01,13,2468,1672,1450,4463,3214,13267
2023-03-02,13,1626,1045,1440,4229,3437,11777
2023-03-03,13,3376,1118,1644,1973,3099,11210
2023-03-04,13,2264,1295,3084,2580,4476,13699
2023-03-05,13,2523,1192,3243,2205,3622,12785
2023-03-06,13,4953,2827,1253,3764,5770,18567
2023-03-07,13,2504,2851,1927,3834,3481,14597
2023-03-08,13,4923,1622,1440,3073,4061,15119
2023-03-09,13,2204,1548,2567,2946,2525,11790
2023-03-10,13,3017,2949,3495,1900,2003,13364
2023-03-11,13,4798,2144,1809,4043,4373,17167
2023-03-12,13,3708,2705,1285,3776,2678,14152
2023-03-13,13,1170,1851,3196,2403,5331,13951
2023-03-14,13,1299,2006,1933,3950,2379,11567
2023-03-15,13,1641,1793,2608,4432,2598,13072
2023-03-16,13,1969,1428,1331,2569,5323,12620
2023-03-17,13,2812,1752,1282,4146,4247,14239
2023-03-18,13,3917,1815,3633,3210,3073,15648
2023-03-19,13,3693,2978,1845,3131,2872,14519
2023-03-20,13,4510,2696,2672,1598,2406,13882
2023-03-21,13,2531,1243,2406,3410,5788,15378
2023-03-22,13,1244,893,1377,2104,4090,9708
2023-03-23,13,1753,841,2643,1588,3358,10183
2023-03-24,13,4512,2132,2105,4367,4843,17959
2023-03-25,13,4258,2294,2442,2885,2955,14834
2023-03-26,13,1186,2627,1325,2892,3235,11265
2023-03-27,13,3197,1088,2990,3382,4067,14724
2023-03-28,13,4135,1029,2336,2617,4256,14373
2023-03-29,13,2370,997,2771,2337,4940,13415
2023-03-30,13,1822,1285,2155,4351,3016,12629
2023-03-31,13,3847,2938,2896,2186,5146,17013
2023-04-01,13,3678,1359,3503,2041,4127,14708
2023-04-02,13,1196,2602,2513,4011,2240,12562
2023-04-03,13,1579,2617,3952,3616,5432,17196
2023-04-04,13,4624,2685,1807,1634,2745,13495
2023-04-05,13,1441,2892,3594,1993,3716,13636
2023-04-06,13,4280,831,2711,3255,4331,15408
2023-04-07,13,4833,2216,2846,2272,3144,15311
2023-04-08,13,3988,863,2972,4256,3452,15531
2023-04-09,13,4251,1759,2836,2517,5376,16739
2023-04-10,13,4468,2835,2321,2484,3909,16017
2023-04-11,13,1924,2127,2562,1858,4526,12997
2023-04-12,13,4602,2872,3255,2451,4793,17973
2023-04-13,13,1370,2658,1725,3914,2763,12430
2023-04-14,13,3429,2527,2195,1780,5677,15608
2023-04-15,13,1244,2284,3209,4090,5591,16418
2023-04-16,13,4055,991,3840,1785,2901,13572
2023-04-17,13,1558,1236,1708,1643,5213,11358
2023-04-18,13,2935,2611,3122,4233,3832,16733
2023-04-19,13,3097,2128,2237,3590,2555,13607
2023-04-20,13,4851,1513,3182,1844,3314,14704
2023-04-21,13,2029,1841,1961,2452,3567,11850
2023-04-22,13,1908,2613,1309,2077,3456,11363
2023-04-23,13,3174,1241,3809,1699,5609,15532
2023-04-24,13,3912,1011,1226,2506,4713,13368
2023-04-25,13,3897,2154,2859,3354,5590,17854
2023-04-26,13,3238,1174,2463,3562,2209,12646
2023-04-27,13,2658,1687,2849,3881,3785,14860
2023-04-28,13,1119,1501,1876,2787,3138,10421
2023-04-29,13,1358,2999,3154,4003,5442,16956
2023-04-30,13,4180,1223,1235,3756,4154,14548
2023-05-01,13,2021,2965,2504,3303,4787,15580
2023-05-02,13,3684,1138,2507,4315,5690,17334
2023-05-03,13,2135,1918,3756,2535,3589,13933
2023-05-04,13,2519,2484,2153,4295,3617,15068
2023-05-05,13,3803,2641,1709,3017,2396,13566
2023-05-06,13,2060,850,3929,2753,2972,12564
2023-05-07,13,3261,2531,2602,4381,3241,16016
2023-05-08,13,3387,2916,2611,3357,4054,16325
2023-05-09,13,3704,2674,3342,3791,4073,17584
2023-05-10,13,1150,2949,1600,3178,2863,11740
2023-05-11,13,2857,1389,2459,3812,5657,16174
2023-05-12,13,3166,1191,1650,2780,3481,12268
2023-05-13,13,2268,1188,1939,3079,3482,11956
2023-05-14,13,3003,2084,1905,1932,3864,12788
2023-05-15,13,1989,1887,3291,3842,3038,14047
2023-05-16,13,2468,2775,1549,3304,4833,14929
2023-05-17,13,1302,2178,2635,3384,5278,14777
2023-05-18,13,4031,1709,2803,3047,3177,14767
2023-05-19,13,2080,2924,2115,4291,2225,13635
2023-05-20,13,3928,1217,2157,2065,5609,14976
2023-05-21,13,4839,2470,2813,3993,2682,16797
2023-05-22,13,3035,1196,2344,4156,4141,14872
2023-05-23,13,1583,2951,1790,3577,4999,14900
2023-05-24,13,1909,1921,1933,4196,2775,12734
2023-05-25,13,3530,2751,2133,3863,3885,16162
2023-05-26,13,1509,1900,2828,2633,3772,12642
2023-05-27,13,4931,2073,1979,3773,5599,18355
2023-05-28,13,4386,2779,2646,3599,4053,17463
2023-05-29,13,2700,2529,2858,2236,3067,13390
2023-05-30,13,2985,2753,2964,1854,5591,16147
2023-05-31,13,4672,1508,3766,1817,3352,15115
2023-06-01,13,2249,2382,1868,1835,2177,10511
2023-06-02,13,4656,2633,3722,4393,3614,19018
2023-06-03,13,2366,2854,2779,2398,5004,15401
2023-06-04,13,3106,1142,2113,3946,4097,14404
2023-06-05,13,2950,2151,3876,3199,3444,15620
2023-06-06,13,3002,2623,1701,4058,5353,16737
2023-06-07,13,4430,1914,2563,1842,4266,15015
2023-06-08,13,1319,972,1269,3827,4208,11595
2023-06-09,13,1314,2081,1645,2862,4307,12209
2023-06-10,13,3153,1706,3082,2832,2067,12840
2023-06-11,13,3456,1787,2842,4426,5740,18251
2023-06-12,13,1643,1792,3412,1666,2732,11245
2023-06-13,13,3710,1671,3477,2962,5676,17496
2023-06-14,13,4942,2381,3749,3176,2025,16273
2023-06-15,13,1242,2977,2241,3263,3060,12783
2023-06-16,13,4366,2302,1379,1951,2767,12765
2023-06-17,13,2861,2456,3037,3418,2347,14119
2023-06-18,13,3764,2060,1772,2326,4881,14803
2023-06-19,13,1469,2571,2873,3095,5998,16006
2023-06-20,13,2438,1818,1466,2978,3467,12167
2023-06-21,13,3097,2705,2645,3917,5089,17453
2023-06-22,13,2898,1700,1676,2630,5217,14121
2023-06-23,13,2608,2494,3227,2999,3256,14584
2023-06-24,13,1869,2428,2273,2299,3396,12265
2023-06-25,13,1378,1049,1283,1811,2917,8438
2023-06-26,13,2474,2871,1661,3267,4924,15197
2023-06-27,13,1100,1219,1216,4088,2431,10054
2023-06-28,13,3199,2331,1637,3202,2282,12651
2023-06-29,13,3255,2716,3439,2072,4730,16212
2023-06-30,13,4384,1588,2571,2500,4563,15606
2023-07-01,13,3584,1055,3513,1790,2531,12473
2023-07-02,13,3575,1637,2740,4404,5056,17412
2023-07-03,13,4154,2323,3287,3793,4680,18237
2023-07-04,13,3519,1827,2224,4256,4096,15922
2023-07-05,13,3196,2253,2886,2685,2187,13207
2023-07-06,13,1631,1027,2965,2838,4702,13163
2023-07-07,13,4754,1765,2491,4458,4465,17933
2023-07-08,13,1495,1082,1617,3445,3493,11132
2023-07-09,13,2193,2917,1694,1605,4685,13094
2023-07-10,13,3899,2458,3465,3198,3726,16746
2023-07-11,13,4532,942,3300,3987,3737,16498
2023-07-12,13,2068,2225,1842,2015,4823,12973
2023-07-13,13,3335,1598,2317,3572,3613,14435
2023-07-14,13,2473,1633,2052,3077,5030,14265
2023-07-15,13,2559,2463,3717,4210,5490,18439
2023-07-16,13,4957,1721,3678,3593,4254,18203
2023-07-17,13,2005,2789,3667,2964,4099,15524
2023-07-18,13,3526,2931,2498,2205,3602,14762
2023-07-19,13,4978,1343,1422,4107,5639,17489
2023-07-20,13,2742,1338,2093,2977,4472,13622
2023-07-21,13,2217,2755,3478,2084,3519,14053
2023-07-22,13,4879,2779,2344,2153,5878,18033
2023-07-23,13,3882,2249,2709,1508,3803,14151
2023-07-24,13,3885,1787,2863,3653,3504,15692
2023-07-25,13,4135,856,1719,4359,2050,13119
2023-07-26,13,2228,1715,2088,3445,5840,15316
2023-07-27,13,3514,1005,3914,3201,2836,14470
2023-07-28,13,4967,2964,1844,4018,3835,17628
2023-07-29,13,2565,2547,3810,3271,2183,14376
2023-07-30,13,4013,800,2587,2451,2586,12437
2023-07-31,13,3949,2523,3670,1829,4184,16155
2023-08-01,13,2023,1613,2368,3781,3696,13481
2023-08-02,13,2240,2805,2979,1967,4833,14824
2023-08-03,13,4717,2604,2898,2668,2685,15572
2023-08-04,13,2336,2258,1782,3400,4491,14267
2023-08-05,13,2165,1461,3272,4329,4710,15937
2023-08-06,13,4728,2930,1228,3814,2032,14732
2023-08-07,13,3831,885,1692,2233,4440,13081
2023-08-08,13,3516,1887,1492,4291,4536,15722
2023-08-09,13,4644,2903,1912,2051,5915,17425
2023-08-10,13,1189,984,2133,4028,5959,14293
2023-08-11,13,1061,2821,3429,3116,5108,15535
2023-08-12,13,2403,825,3672,1699,2301,10900
2023-08-13,13,1361,1344,2190,4228,2381,11504
2023-08-14,13,3380,905,2729,2481,5166,14661
2023-08-15,13,3543,1863,2052,3976,5021,16455
2023-08-16,13,4069,2940,3925,2944,5195,19073
2023-08-17,13,1186,2064,3981,3254,2186,12671
2023-08-18,13,4835,1896,3079,1819,5937,17566
2023-08-19,13,3507,1648,2763,4143,2738,14799
2023-08-20,13,3790,1744,3004,2709,3457,14704
2023-08-21,13,4080,1339,3435,2121,4299,15274
2023-08-22,13,2789,901,2192,2778,4599,13259
2023-08-23,13,3082,2452,3106,2257,4950,15847
2023-08-24,13,4529,969,2790,2754,3938,14980
2023-08-25,13,4388,2335,2710,2383,5658,17474
2023-08-26,13,3500,1203,3396,3899,2074,14072
2023-08-27,13,2790,2199,2897,4019,5780,17685
2023-08-28,13,1876,2717,3058,1640,4803,14094
2023-08-29,13,2952,977,1694,2476,2941,11040
2023-08-30,13,4333,2173,1366,4386,3684,15942
2023-08-31,13,1367,2713,2731,3432,3530,13773
2023-09-01,13,3486,1572,3292,4260,2494,15104
2023-09-02,13,4641,2809,1447,1805,5422,16124
2023-09-03,13,4100,2811,3161,1718,2933,14723
2023-09-04,13,1356,1449,2091,3456,5704,14056
2023-09-05,13,4687,1641,3735,3860,3375,17298
2023-09-06,13,3013,1163,1821,3153,4912,14062
2023-09-07,13,3325,1490,3961,3199,4713,16688
2023-09-08,13,4818,1169,1316,4219,5134,16656
2023-09-09,13,1098,2645,3178,2386,3423,12730
2023-09-10,13,1906,2334,3247,2747,2888,13122
2023-09-11,13,4131,2051,3706,4153,2203,16244
2023-09-12,13,1631,2679,3923,3310,2749,14292
2023-09-13,13,1030,887,2908,3788,4823,13436
2023-09-14,13,3399,1141,3713,2300,5767,16320
2023-09-15,13,2116,955,2769,3521,5139,14500
2023-09-16,13,2631,2082,2607,2975,5498,15793
2023-09-17,13,1144,2720,1368,2269,4727,12228
2023-09-18,13,2569,2261,3498,3151,3782,15261
2023-09-19,13,3842,845,3183,1785,3228,12883
2023-09-20,13,1989,2258,3781,3361,3100,14489
2023-09-21,13,2218,1880,2262,3786,5463,15609
2023-09-22,13,3741,1529,3191,2730,3797,14988
2023-09-23,13,1072,2782,1783,3715,3715,13067
2023-09-24,13,1129,2867,2954,3193,5307,15450
2023-09-25,13,2196,2166,3821,3828,4689,16700
2023-09-26,13,4484,2541,3456,3122,2266,15869
2023-09-27,13,3998,1080,3130,3740,4933,16881
2023-09-28,13,4678,2166,2386,3617,3860,16707
2023-09-29,13,4699,2192,2120,4146,4919,18076
2023-09-30,13,1456,2180,2634,3808,2135,12213
2023-10-01,13,1624,1648,1381,3708,3686,12047
2023-10-02,13,4427,2946,2454,3755,2382,15964
2023-10-03,13,3050,1447,3312,2931,2507,13247
2023-10-04,13,2885,1748,1875,1514,5380,13402
2023-10-05,13,2413,2259,2671,1574,3362,12279
2023-10-06,13,1739,2436,3768,3290,2408,13641
2023-10-07,13,4271,1656,3483,1584,2665,13659
2023-10-08,13,1410,2422,2171,2962,5464,14429
2023-10-09,13,3899,990,2874,3823,5792,17378
2023-10-10,13,3385,1746,3257,3570,4479,16437
2023-10-11,13,4962,953,3133,2154,2080,13282
2023-10-12,13,4997,2575,1729,4431,5982,19714
2023-10-13,13,3213,1744,3278,2154,5801,16190
2023-10-14,13,2464,1507,1946,3721,3035,12673
2023-10-15,13,1564,2972,3906,4090,2784,15316
2023-10-16,13,3905,2031,1641,3041,2654,13272
2023-10-17,13,4403,1756,3755,2969,2393,15276
2023-10-18,13,4377,2029,3674,2708,4645,17433
2023-10-19,13,2875,2473,3608,3326,3969,16251
2023-10-20,13,1883,1291,3159,3128,4875,14336
2023-10-21,13,1904,1298,1278,1569,5075,11124
2023-10-22,13,3189,1400,1968,2828,5737,15122
2023-10-23,13,1561,1344,2821,4364,3075,13165
2023-10-24,13,4105,1332,1808,3495,3819,14559
2023-10-25,13,2576,2450,1800,3909,4900,15635
2023-10-26,13,2654,2394,3154,2156,2300,12658
2023-10-27,13,2689,1420,2586,3831,2144,12670
2023-10-28,13,1403,2088,1836,3388,2660,11375
2023-10-29,13,1581,1446,2315,2511,4849,12702
2023-10-30,13,4508,2423,1779,2968,2999,14677
2023-10-31,13,1807,1789,2452,3681,3581,13310
2023-11-01,13,2136,2129,3692,2545,3573,14075
2023-11-02,13,2329,1932,3942,2721,3803,14727
2023-11-03,13,2049,1605,3756,3714,2643,13767
2023-11-04,13,4808,1908,3094,2979,2734,15523
2023-11-05,13,2033,1348,1235,4000,3644,12260
2023-11-06,13,4695,1916,1460,2784,2847,13702
2023-11-07,13,3933,1157,2068,2167,3514,12839
2023-11-08,13,3451,2475,1666,3146,2150,12888
2023-11-09,13,3852,2314,3396,1771,4972,16305
2023-11-10,13,1461,2593,2499,2417,2154,11124
2023-11-11,13,2511,2380,2029,3370,3846,14136
2023-11-12,13,2814,2978,1670,2531,3459,13452
2023-11-13,13,3431,1408,2530,3164,4886,15419
2023-11-14,13,3170,1623,3700,3729,5462,17684
2023-11-15,13,2127,1149,3012,3046,2690,12024
2023-11-16,13,2903,2779,3047,2082,3078,13889
2023-11-17,13,3917,1038,3437,3020,4872,16284
2023-11-18,13,2220,2613,3487,3063,3996,15379
2023-11-19,13,2079,1587,1745,2810,5125,13346
2023-11-20,13,3410,1037,2959,3749,3563,14718
2023-11-21,13,1917,1702,3087,2492,5073,14271
2023-11-22,13,3017,1622,2106,3978,2970,13693
2023-11-23,13,1553,1437,2414,2643,2924,10971
2023-11-24,13,3593,987,3292,3851,2390,14113
2023-11-25,13,3316,2785,2856,4070,5125,18152
2023-11-26,13,3786,2957,3238,2850,5928,18759
2023-11-27,13,4726,811,3280,3711,5666,18194
2023-11-28,13,2950,2537,3337,1901,4242,14967
2023-11-29,13,2378,1278,2990,2502,5113,14261
2023-11-30,13,4330,2417,2123,3707,4186,16763
2023-12-01,13,3020,1358,1290,2361,3253,11282
2023-12-02,13,4437,2968,2252,1914,4935,16506
2023-12-03,13,4432,842,1961,2033,3701,12969
2023-12-04,13,2686,2806,2004,2099,4496,14091
2023-12-05,13,4491,1124,1464,1754,3144,11977
2023-12-06,13,3840,2618,3149,2839,2532,14978
2023-12-07,13,3900,1945,3220,1687,5957,16709
2023-12-08,13,4413,1239,1681,3790,2133,13256
2023-12-09,13,2905,2183,3482,3547,5007,17124
2023-12-10,13,2680,2370,2845,4178,4917,16990
2023-12-11,13,3887,2247,2156,2992,3390,14672
2023-12-12,13,2025,823,1650,1943,5065,11506
2023-12-13,13,1330,1590,1721,3317,5375,13333
2023-12-14,13,3522,801,1571,3377,5442,14713
2023-12-15,13,2812,2230,2448,3602,4919,16011
2023-12-16,13,3089,979,3436,4025,4337,15866
2023-12-17,13,3060,1941,1887,4425,3574,14887
2023-12-18,13,2062,1576,1691,2253,4125,11707
2023-12-19,13,3904,2098,2533,3185,3127,14847
2023-12-20,13,3849,1622,1484,4219,5160,16334
2023-12-21,13,4694,1326,2525,2157,5673,16375
2023-12-22,13,4900,948,2711,4279,5268,18106
2023-12-23,13,2517,1768,2195,2470,3664,12614
2023-12-24,13,3161,2271,3109,2466,5775,16782
2023-12-25,13,1446,2409,3516,4440,4432,16243
2023-12-26,13,4915,2170,3945,3128,3486,17644
2023-12-27,13,3592,2941,2567,2920,2397,14417
2023-12-28,13,3172,1370,1960,4248,4269,15019
2023-12-29,13,1684,931,3156,2689,5322,13782
2023-12-30,13,2327,1394,1754,4147,4211,13833
2023-12-31,13,3267,2019,3740,2926,5987,17939
2022-01-01,14,3672,2885,2925,2165,2849,14496
2022-01-02,14,1810,1948,3500,4117,4136,15511
2022-01-03,14,3838,2624,1794,2649,4335,15240
2022-01-04,14,3868,1934,1583,2367,3169,12921
2022-01-05,14,2635,1325,3700,1896,4868,14424
2022-01-06,14,1345,1033,1680,3707,3218,10983
2022-01-07,14,1865,2650,1732,2034,2370,10651
2022-01-08,14,4880,918,1745,2241,3464,13248
2022-01-09,14,4611,2956,1771,2188,4846,16372
2022-01-10,14,3185,1186,2041,4066,4849,15327
2022-01-11,14,4249,1725,1772,2435,3723,13904
2022-01-12,14,1996,966,2179,3277,5543,13961
2022-01-13,14,3979,1001,1919,2265,2018,11182
2022-01-14,14,4441,1734,1237,3740,2267,13419
2022-01-15,14,1440,2521,3028,4191,4851,16031
2022-01-16,14,1249,1369,2290,1661,5995,12564
2022-01-17,14,3835,2665,1480,4247,2778,15005
2022-01-18,14,2584,2093,2164,2351,4649,13841
2022-01-19,14,2960,2063,1865,1571,3677,12136
2022-01-20,14,2563,2764,1922,1893,5865,15007
2022-01-21,14,4230,1015,1529,2970,4927,14671
2022-01-22,14,3005,1710,1950,2979,5505,15149
2022-01-23,14,1571,1298,3557,1848,5411,13685
2022-01-24,14,3907,2109,3672,1834,4814,16336
2022-01-25,14,1917,1883,3955,1560,2296,11611
2022-01-26,14,1523,1138,2456,3619,2572,11308
2022-01-27,14,4427,1514,1914,2122,3101,13078
2022-01-28,14,3798,2383,1617,3197,5206,16201
2022-01-29,14,4589,1381,2835,3781,5750,18336
2022-01-30,14,1621,1494,2124,2475,3551,11265
2022-01-31,14,2970,1123,3287,1904,4852,14136
2022-02-01,14,2015,2670,3113,4315,3483,15596
2022-02-02,14,2256,1476,2356,2884,3954,12926
2022-02-03,14,3937,1302,1233,1589,4798,12859
2022-02-04,14,2399,1587,2613,2722,4849,14170
2022-02-05,14,3437,2066,2695,4373,2391,14962
2022-02-06,14,2862,2871,2422,4047,5107,17309
2022-02-07,14,1957,2944,3343,3521,3531,15296
2022-02-08,14,1217,988,2186,3897,3732,12020
2022-02-09,14,4107,2163,3910,3055,3148,16383
2022-02-10,14,2839,938,3382,3185,4243,14587
2022-02-11,14,1202,959,3374,2330,5219,13084
2022-02-12,14,1039,2416,3086,4352,5048,15941
2022-02-13,14,3342,1688,1560,2812,3095,12497
2022-02-14,14,4471,2939,3229,1802,2894,15335
2022-02-15,14,4567,2211,2629,2142,2274,13823
2022-02-16,14,3534,2899,3878,4006,4846,19163
2022-02-17,14,4309,2739,1841,3223,4560,16672
2022-02-18,14,4978,2652,2159,1567,2953,14309
2022-02-19,14,2278,828,3543,3318,5772,15739
2022-02-20,14,2765,2419,3937,3594,4077,16792
2022-02-21,14,2977,2947,2453,2514,4605,15496
2022-02-22,14,3640,841,3020,4131,2030,13662
2022-02-23,14,2957,2460,2553,2454,3506,13930
2022-02-24,14,2332,1644,2181,2538,5502,14197
2022-02-25,14,1178,1469,3000,2694,5325,13666
2022-02-26,14,1059,2715,2247,3686,4132,13839
2022-02-27,14,4356,2590,3100,1708,4438,16192
2022-02-28,14,4424,2060,2698,2446,5376,17004
2022-03-01,14,2983,1831,2308,3281,2698,13101
2022-03-02,14,2418,2768,2406,3460,5529,16581
2022-03-03,14,1951,1991,3335,1946,3463,12686
2022-03-04,14,2200,854,3781,3842,2021,12698
2022-03-05,14,4591,1880,2693,2540,5986,17690
2022-03-06,14,2478,2093,3808,2906,4749,16034
2022-03-07,14,2052,1877,3799,2424,5101,15253
2022-03-08,14,3065,963,1567,2644,2542,10781
2022-03-09,14,1376,1342,3669,4487,4656,15530
2022-03-10,14,3543,2325,1498,2344,4436,14146
2022-03-11,14,2674,2079,2596,1732,3226,12307
2022-03-12,14,4745,1556,3585,2680,3765,16331
2022-03-13,14,1565,2491,2649,3014,5740,15459
2022-03-14,14,1233,2814,1215,3404,5437,14103
2022-03-15,14,1196,856,3735,2298,4615,12700
2022-03-16,14,1887,2309,2256,3927,2054,12433
2022-03-17,14,4678,2724,2503,4128,3573,17606
2022-03-18,14,1102,1261,2949,3155,4841,13308
2022-03-19,14,1832,2419,2947,3147,2298,12643
2022-03-20,14,2729,2951,3805,2789,3480,15754
2022-03-21,14,3368,2404,1688,2702,2698,12860
2022-03-22,14,3561,947,2928,1871,2369,11676
2022-03-23,14,4991,2516,3247,3688,5272,19714
2022-03-24,14,3628,2417,2187,3299,3828,15359
2022-03-25,14,3346,961,3569,2822,3427,14125
2022-03-26,14,3761,2823,3282,3752,4491,18109
2022-03-27,14,3523,2304,1781,1983,4300,13891
2022-03-28,14,1525,1927,2559,1789,5944,13744
2022-03-29,14,4483,2065,2571,1729,4404,15252
2022-03-30,14,2167,971,1685,2813,2288,9924
2022-03-31,14,3615,1236,2561,2415,5304,15131
2022-04-01,14,1256,1637,2121,3232,5416,13662
2022-04-02,14,2807,2276,2616,1779,3988,13466
2022-04-03,14,2650,2038,3172,2817,3623,14300
2022-04-04,14,4000,2653,2389,2517,5924,17483
2022-04-05,14,2692,1967,2746,2161,3251,12817
2022-04-06,14,2980,958,1618,4420,4532,14508
2022-04-07,14,2284,1059,2539,4488,4685,15055
2022-04-08,14,1494,2830,1283,3606,3886,13099
2022-04-09,14,4301,2868,1289,3678,3646,15782
2022-04-10,14,3324,2777,1587,4164,3977,15829
2022-04-11,14,2430,2824,3209,3866,4052,16381
2022-04-12,14,4938,2609,2907,3885,2304,16643
2022-04-13,14,4520,2735,1496,3859,2927,15537
2022-04-14,14,1200,932,3297,3589,5798,14816
2022-04-15,14,2671,2409,2811,4388,3437,15716
2022-04-16,14,2620,1783,2422,4052,3954,14831
2022-04-17,14,3812,2739,1604,4212,3565,15932
2022-04-18,14,1340,2116,3672,4390,4670,16188
2022-04-19,14,2510,1072,1450,2849,4502,12383
2022-04-20,14,2997,2729,3475,1514,5281,15996
2022-04-21,14,2776,1194,2498,3874,4093,14435
2022-04-22,14,4393,2932,2305,2642,4110,16382
2022-04-23,14,3828,1852,2400,1662,5665,15407
2022-04-24,14,4484,896,3118,2404,5294,16196
2022-04-25,14,1344,2671,3966,2054,4667,14702
2022-04-26,14,1050,2294,3237,3471,4047,14099
2022-04-27,14,1443,2617,3945,2566,5631,16202
2022-04-28,14,3151,2848,1513,1841,2209,11562
2022-04-29,14,3813,2855,3617,2466,3310,16061
2022-04-30,14,3603,1678,3523,3798,3603,16205
2022-05-01,14,2369,2018,1664,4206,2880,13137
2022-05-02,14,2379,2435,2337,2093,4314,13558
2022-05-03,14,2483,1058,2716,3480,4662,14399
2022-05-04,14,2025,2901,2058,3982,2916,13882
2022-05-05,14,2703,2704,3275,3847,4102,16631
2022-05-06,14,4149,2564,2598,2952,2322,14585
2022-05-07,14,2822,2092,1599,2210,2377,11100
2022-05-08,14,1976,1392,2532,3342,5544,14786
2022-05-09,14,3704,1862,1587,1617,3531,12301
2022-05-10,14,2209,1956,1294,1762,2477,9698
2022-05-11,14,4494,2208,2439,3182,3887,16210
2022-05-12,14,2426,1761,3041,2886,4782,14896
2022-05-13,14,3011,1385,3501,2549,5936,16382
2022-05-14,14,4650,1470,3439,2010,5143,16712
2022-05-15,14,2716,2955,1247,4257,4305,15480
2022-05-16,14,3697,1345,2509,2224,4782,14557
2022-05-17,14,3125,1346,3211,3439,3236,14357
2022-05-18,14,3492,1952,1453,2301,4124,13322
2022-05-19,14,2346,2706,2724,4317,5133,17226
2022-05-20,14,4085,1807,2163,4368,5954,18377
2022-05-21,14,1024,1968,3714,4024,2336,13066
2022-05-22,14,2345,2174,3766,2878,5788,16951
2022-05-23,14,2936,2291,1311,3641,2444,12623
2022-05-24,14,1299,1537,1624,3702,3775,11937
2022-05-25,14,2779,1576,1719,2716,4859,13649
2022-05-26,14,2213,2260,3670,2801,4072,15016
2022-05-27,14,4275,1960,3334,3960,4058,17587
2022-05-28,14,3689,1243,2522,2901,4521,14876
2022-05-29,14,1962,2822,1642,3971,4261,14658
2022-05-30,14,2710,1526,1502,2949,5224,13911
2022-05-31,14,3662,2554,3047,3363,2468,15094
2022-06-01,14,3478,1683,3663,3281,5100,17205
2022-06-02,14,4485,2392,2423,3613,2910,15823
2022-06-03,14,3530,1297,3738,4028,4520,17113
2022-06-04,14,4648,2610,3796,4493,5337,20884
2022-06-05,14,1455,1573,2400,3365,3854,12647
2022-06-06,14,3518,1952,1835,3523,4691,15519
2022-06-07,14,2619,2003,3612,4074,4951,17259
2022-06-08,14,1075,1256,1201,4285,3215,11032
2022-06-09,14,2608,2918,1347,2729,3450,13052
2022-06-10,14,4358,1415,3451,4105,3476,16805
2022-06-11,14,3668,1567,1342,2631,3980,13188
2022-06-12,14,2787,2179,2257,2743,3268,13234
2022-06-13,14,3284,1180,3832,2724,4419,15439
2022-06-14,14,2668,2423,1251,3680,5132,15154
2022-06-15,14,4574,1353,2220,4088,4433,16668
2022-06-16,14,2679,1398,1602,3232,3938,12849
2022-06-17,14,1309,2865,2982,3945,4044,15145
2022-06-18,14,2443,2341,2942,2925,3329,13980
2022-06-19,14,4888,1252,1874,2643,2420,13077
2022-06-20,14,1703,2904,3506,1680,3560,13353
2022-06-21,14,2108,1067,2935,3981,4474,14565
2022-06-22,14,4744,2023,2588,3684,5221,18260
2022-06-23,14,3467,2614,3184,2973,5342,17580
2022-06-24,14,2554,897,3867,1930,5952,15200
2022-06-25,14,3662,1693,1986,2634,3184,13159
2022-06-26,14,2476,2274,1784,2543,4202,13279
2022-06-27,14,2623,2080,1695,1930,3512,11840
2022-06-28,14,4042,2313,2179,2258,4021,14813
2022-06-29,14,2171,1767,1291,4206,2982,12417
2022-06-30,14,4551,2697,2847,4059,2903,17057
2022-07-01,14,3266,908,2926,3797,3613,14510
2022-07-02,14,4604,1792,2699,4287,5054,18436
2022-07-03,14,3836,1146,1405,3372,4228,13987
2022-07-04,14,2583,2324,1815,3326,4869,14917
2022-07-05,14,4636,2309,3182,4183,4812,19122
2022-07-06,14,3044,2082,3344,2887,2966,14323
2022-07-07,14,3698,2240,2860,3860,4262,16920
2022-07-08,14,4063,2447,1748,3261,3518,15037
2022-07-09,14,2210,1038,2284,3822,2191,11545
2022-07-10,14,3884,1077,2001,3607,4336,14905
2022-07-11,14,4561,1713,3034,2196,3658,15162
2022-07-12,14,3085,2231,2424,4295,3426,15461
2022-07-13,14,1460,2155,1357,4285,4356,13613
2022-07-14,14,2640,2474,1377,1798,4474,12763
2022-07-15,14,1673,1135,1353,1584,2945,8690
2022-07-16,14,3529,1634,1612,4221,5119,16115
2022-07-17,14,1137,1379,2244,2049,3096,9905
2022-07-18,14,3865,2470,3997,3349,2808,16489
2022-07-19,14,1813,2910,2803,1738,5316,14580
2022-07-20,14,3470,2033,3699,3937,5165,18304
2022-07-21,14,2765,2783,1467,4121,3580,14716
2022-07-22,14,2105,2767,2047,4300,2279,13498
2022-07-23,14,2616,2188,3051,3948,2206,14009
2022-07-24,14,4715,1142,3641,4142,2495,16135
2022-07-25,14,1035,2415,2033,4396,4077,13956
2022-07-26,14,4639,1057,2471,4069,4585,16821
2022-07-27,14,4205,1498,1816,3429,4196,15144
2022-07-28,14,4603,2760,3963,3816,3297,18439
2022-07-29,14,1097,2656,3683,3163,3766,14365
2022-07-30,14,4986,1786,3737,2750,3004,16263
2022-07-31,14,1250,1154,1910,2465,4921,11700
2022-08-01,14,2902,2454,1260,3119,2359,12094
2022-08-02,14,4295,862,3482,3534,4333,16506
2022-08-03,14,1106,2450,2687,4415,5788,16446
2022-08-04,14,2066,1745,1652,3296,4307,13066
2022-08-05,14,1321,2090,1452,1644,3453,9960
2022-08-06,14,3247,2931,2503,2129,2981,13791
2022-08-07,14,4476,1700,2543,2390,3271,14380
2022-08-08,14,4715,1967,1864,1567,3428,13541
2022-08-09,14,1685,1691,2858,2259,3030,11523
2022-08-10,14,3530,2787,3352,3734,2583,15986
2022-08-11,14,3537,2731,1205,3080,5989,16542
2022-08-12,14,2707,2645,2735,3945,3566,15598
2022-08-13,14,3548,1205,1649,3133,3336,12871
2022-08-14,14,1822,1999,2854,3045,4855,14575
2022-08-15,14,3122,2908,1700,3768,4981,16479
2022-08-16,14,4498,1138,1258,3526,5431,15851
2022-08-17,14,1646,1332,3944,2200,4101,13223
2022-08-18,14,3587,1075,3834,2876,5842,17214
2022-08-19,14,4742,1703,3335,1928,5810,17518
2022-08-20,14,4873,2601,1467,2076,2107,13124
2022-08-21,14,3309,1936,2318,3268,5036,15867
2022-08-22,14,3412,2246,3769,3720,4226,17373
2022-08-23,14,2423,2393,3248,3563,2157,13784
2022-08-24,14,4063,1485,3311,1827,3427,14113
2022-08-25,14,3680,1551,2023,3947,5994,17195
2022-08-26,14,4658,2418,2884,2286,3051,15297
2022-08-27,14,1822,1948,2946,1738,5903,14357
2022-08-28,14,3839,2594,1353,2549,2093,12428
2022-08-29,14,1841,1191,1549,4378,3338,12297
2022-08-30,14,4795,1747,3433,3159,2503,15637
2022-08-31,14,4318,1118,2907,3591,5858,17792
2022-09-01,14,4951,1628,3116,4017,5650,19362
2022-09-02,14,2495,2747,3368,3180,5837,17627
2022-09-03,14,3100,915,3642,4438,3991,16086
2022-09-04,14,2959,2530,2326,3377,2458,13650
2022-09-05,14,1348,1625,3408,3866,3497,13744
2022-09-06,14,4339,2814,2603,2815,5727,18298
2022-09-07,14,4655,2353,3656,2705,5994,19363
2022-09-08,14,4162,2040,3820,3847,3743,17612
2022-09-09,14,3981,1247,3222,3829,3679,15958
2022-09-10,14,4251,2702,3265,3420,4316,17954
2022-09-11,14,1655,2233,1840,2889,4539,13156
2022-09-12,14,3679,2791,1383,3958,4284,16095
2022-09-13,14,2239,813,2762,3192,2134,11140
2022-09-14,14,1120,2599,3924,3695,2124,13462
2022-09-15,14,3911,856,3813,4487,2814,15881
2022-09-16,14,2934,1974,2236,3841,3765,14750
2022-09-17,14,2060,2069,2887,3491,5283,15790
2022-09-18,14,4782,2302,3023,2373,2754,15234
2022-09-19,14,4237,1822,3762,2646,4680,17147
2022-09-20,14,4295,2934,3597,1684,3737,16247
2022-09-21,14,3717,2731,2552,3969,2174,15143
2022-09-22,14,1802,2625,3604,1866,4113,14010
2022-09-23,14,3419,1492,2416,1927,3518,12772
2022-09-24,14,4396,1176,1776,2560,2756,12664
2022-09-25,14,1541,850,1974,2841,3048,10254
2022-09-26,14,2645,2409,1975,2555,2179,11763
2022-09-27,14,1199,1067,1768,2213,4947,11194
2022-09-28,14,2540,1123,3313,2977,5814,15767
2022-09-29,14,4285,1553,2765,3292,4150,16045
2022-09-30,14,4056,2309,2436,2158,2865,13824
2022-10-01,14,1018,2496,3375,3167,2246,12302
2022-10-02,14,1150,955,1559,4052,4747,12463
2022-10-03,14,4263,1435,3770,4420,2469,16357
2022-10-04,14,1248,2005,3206,3601,2583,12643
2022-10-05,14,4944,1295,2580,4134,2538,15491
2022-10-06,14,2039,1040,2467,4467,4310,14323
2022-10-07,14,4108,2114,2060,1510,4648,14440
2022-10-08,14,1934,1506,1329,2173,4032,10974
2022-10-09,14,1531,1446,3777,3860,2725,13339
2022-10-10,14,3270,1288,3235,1572,5074,14439
2022-10-11,14,3265,2437,2545,2319,3631,14197
2022-10-12,14,1178,2639,2847,3457,5563,15684
2022-10-13,14,4222,2399,2958,2789,5497,17865
2022-10-14,14,3394,1699,2601,3726,5283,16703
2022-10-15,14,2835,1278,2620,2786,2083,11602
2022-10-16,14,4225,2717,2023,4429,5567,18961
2022-10-17,14,4122,1333,1552,1596,4932,13535
2022-10-18,14,3541,1999,3831,1537,2595,13503
2022-10-19,14,4602,944,1284,3262,4526,14618
2022-10-20,14,1106,2464,1717,2527,4005,11819
2022-10-21,14,2223,2043,3708,3982,4938,16894
2022-10-22,14,2326,917,3918,2515,2493,12169
2022-10-23,14,2507,2009,1718,3798,2962,12994
2022-10-24,14,1508,1345,1981,3784,3438,12056
2022-10-25,14,1658,2699,3973,1691,2809,12830
2022-10-26,14,3568,2701,3890,2477,5247,17883
2022-10-27,14,1793,1809,2047,2677,2111,10437
2022-10-28,14,2818,1450,3589,2359,2894,13110
2022-10-29,14,4846,1989,1847,1827,3707,14216
2022-10-30,14,3277,850,2937,4007,4931,16002
2022-10-31,14,3604,1362,1776,2441,3009,12192
2022-11-01,14,4328,2130,1923,1829,2421,12631
2022-11-02,14,1395,2041,2250,3663,2199,11548
2022-11-03,14,4492,2778,3227,4311,5636,20444
2022-11-04,14,3341,2918,2906,3031,4928,17124
2022-11-05,14,3177,2247,2935,1531,5523,15413
2022-11-06,14,1235,2227,1257,1604,3328,9651
2022-11-07,14,2941,2601,2008,4050,5436,17036
2022-11-08,14,1714,1913,3979,3522,2209,13337
2022-11-09,14,2537,2139,1534,1880,3643,11733
2022-11-10,14,3714,2276,1872,4038,5963,17863
2022-11-11,14,4259,1538,2191,4111,4530,16629
2022-11-12,14,3858,1892,3755,4312,5880,19697
2022-11-13,14,2573,1001,2879,3811,3392,13656
2022-11-14,14,4186,1339,1866,2011,2257,11659
2022-11-15,14,2745,2392,2824,4130,2350,14441
2022-11-16,14,2946,2210,2901,2493,2732,13282
2022-11-17,14,3668,1746,3429,4362,5940,19145
2022-11-18,14,2449,2146,3260,1931,2286,12072
2022-11-19,14,2936,967,3324,4166,5560,16953
2022-11-20,14,1556,1729,3864,2674,5682,15505
2022-11-21,14,1640,2170,3028,3501,5531,15870
2022-11-22,14,4956,1324,3335,3073,5235,17923
2022-11-23,14,1111,2965,3491,3844,2618,14029
2022-11-24,14,2563,1504,2835,3695,4238,14835
2022-11-25,14,1433,2267,3155,1610,4862,13327
2022-11-26,14,1426,2696,1664,3334,3528,12648
2022-11-27,14,4405,1997,1482,3360,4823,16067
2022-11-28,14,4544,2392,1573,4051,2696,15256
2022-11-29,14,3614,1661,3325,4354,3388,16342
2022-11-30,14,1457,2449,2598,2476,5299,14279
2022-12-01,14,1854,1698,1469,1543,5282,11846
2022-12-02,14,3503,2700,1353,2567,2370,12493
2022-12-03,14,2607,993,1428,3468,2040,10536
2022-12-04,14,2271,2796,1423,2139,3281,11910
2022-12-05,14,1172,1287,3657,3158,2193,11467
2022-12-06,14,4239,1351,2345,4069,3144,15148
2022-12-07,14,3376,1548,2961,2213,3199,13297
2022-12-08,14,2845,2747,2589,4160,4614,16955
2022-12-09,14,1725,2974,1479,3473,4743,14394
2022-12-10,14,3190,2158,3194,2338,2982,13862
2022-12-11,14,1421,1704,2780,3861,4874,14640
2022-12-12,14,3438,2478,1608,2499,4485,14508
2022-12-13,14,3130,1673,2981,3438,2879,14101
2022-12-14,14,4865,2327,3305,3238,3350,17085
2022-12-15,14,2338,1444,2748,2371,2073,10974
2022-12-16,14,3019,1571,1900,1671,3109,11270
2022-12-17,14,4390,2302,1924,3477,2869,14962
2022-12-18,14,4504,1102,3154,4395,2315,15470
2022-12-19,14,3640,2204,2925,3314,3918,16001
2022-12-20,14,4068,2709,1479,2342,4140,14738
2022-12-21,14,1712,1451,3132,3532,2111,11938
2022-12-22,14,2957,2003,1657,1826,3338,11781
2022-12-23,14,3930,1391,3307,2180,3813,14621
2022-12-24,14,1776,1674,1869,3003,4577,12899
2022-12-25,14,3096,2101,2028,3921,5337,16483
2022-12-26,14,4109,995,2568,3039,5328,16039
2022-12-27,14,1820,2925,2280,2464,4769,14258
2022-12-28,14,3146,900,3474,3755,5450,16725
2022-12-29,14,2558,1270,3070,2333,4535,13766
2022-12-30,14,1753,2767,3149,2957,3755,14381
2022-12-31,14,3087,1399,2683,4497,2301,13967
2023-01-01,14,3606,2974,3325,1508,3886,15299
2023-01-02,14,4235,1164,1694,3492,3070,13655
2023-01-03,14,4386,1020,1842,2075,2369,11692
2023-01-04,14,3891,2533,3924,1672,2618,14638
2023-01-05,14,4400,2167,3901,4015,3372,17855
2023-01-06,14,4281,1423,1735,3154,5914,16507
2023-01-07,14,3984,1441,3352,3212,4583,16572
2023-01-08,14,1453,945,1654,3703,4667,12422
2023-01-09,14,3103,1634,2668,3281,3779,14465
2023-01-10,14,4148,2314,1739,3664,2240,14105
2023-01-11,14,2165,2135,2153,4392,2613,13458
2023-01-12,14,3484,1593,1202,2956,2910,12145
2023-01-13,14,1534,1065,2163,2506,5776,13044
2023-01-14,14,3882,2032,3375,3355,3286,15930
2023-01-15,14,1029,2005,2566,2187,4721,12508
2023-01-16,14,1091,2001,3349,2114,4034,12589
2023-01-17,14,1052,1828,3651,3492,2385,12408
2023-01-18,14,4677,2389,3162,3761,2715,16704
2023-01-19,14,2491,2717,3812,4153,3199,16372
2023-01-20,14,1736,2871,1943,3903,2228,12681
2023-01-21,14,1272,1091,2204,3249,2706,10522
2023-01-22,14,2352,2102,1871,4391,4853,15569
2023-01-23,14,1188,2334,3684,2347,2180,11733
2023-01-24,14,1180,1664,1986,3118,2706,10654
2023-01-25,14,3841,2900,3314,1646,5373,17074
2023-01-26,14,4998,1171,3806,2865,2033,14873
2023-01-27,14,3025,2640,1566,1753,5199,14183
2023-01-28,14,4208,1122,3535,2735,5183,16783
2023-01-29,14,3474,2747,2237,2257,3992,14707
2023-01-30,14,4520,2729,3044,3372,5495,19160
2023-01-31,14,4927,2927,2314,3158,5552,18878
2023-02-01,14,4225,2435,2498,1962,4449,15569
2023-02-02,14,1690,2625,2936,1733,2276,11260
2023-02-03,14,2032,1405,1657,3290,4801,13185
2023-02-04,14,1854,1285,2444,3357,4641,13581
2023-02-05,14,3877,2059,1538,4447,3629,15550
2023-02-06,14,4345,2032,1284,4123,2863,14647
2023-02-07,14,1858,1580,2438,2848,3302,12026
2023-02-08,14,2516,1591,2659,3032,2081,11879
2023-02-09,14,4489,1789,1845,2005,2268,12396
2023-02-10,14,4414,1704,3645,2521,5949,18233
2023-02-11,14,3484,2009,3394,2097,2843,13827
2023-02-12,14,4472,2856,2995,3279,3622,17224
2023-02-13,14,1017,2076,1330,2041,5012,11476
2023-02-14,14,4733,1794,2470,2749,5848,17594
2023-02-15,14,3740,2483,1523,2837,5187,15770
2023-02-16,14,1743,2700,2079,1940,3258,11720
2023-02-17,14,1811,1704,3043,1935,3282,11775
2023-02-18,14,3558,1055,1977,3649,4840,15079
2023-02-19,14,1245,1757,1770,1739,4054,10565
2023-02-20,14,1107,1730,3383,3661,2799,12680
2023-02-21,14,4220,2526,3645,2020,5762,18173
2023-02-22,14,3055,1613,2955,2763,2051,12437
2023-02-23,14,3522,2701,1657,3337,2025,13242
2023-02-24,14,2716,819,3914,2892,5035,15376
2023-02-25,14,4544,1828,2842,3132,3825,16171
2023-02-26,14,3098,1536,1719,3783,2846,12982
2023-02-27,14,3338,2983,1318,2733,2103,12475
2023-02-28,14,3346,1903,1206,2393,4624,13472
2023-03-01,14,2384,2871,3138,3417,2606,14416
2023-03-02,14,2250,1108,2153,2873,4111,12495
2023-03-03,14,4197,2348,3322,3231,3394,16492
2023-03-04,14,3690,2907,1667,3169,4772,16205
2023-03-05,14,2394,2896,2547,3812,5765,17414
2023-03-06,14,1124,1871,2408,4404,4502,14309
2023-03-07,14,4812,2963,2693,1786,4132,16386
2023-03-08,14,3280,1317,3641,1689,2640,12567
2023-03-09,14,1939,2530,3295,3058,5075,15897
2023-03-10,14,4298,2039,2559,2267,5447,16610
2023-03-11,14,3319,2154,3658,2860,4149,16140
2023-03-12,14,1034,1398,2532,2168,4285,11417
2023-03-13,14,4200,2058,1951,3257,2212,13678
2023-03-14,14,1339,903,1964,3314,3639,11159
2023-03-15,14,4397,1143,2871,2092,4649,15152
2023-03-16,14,1118,2094,2326,3649,3874,13061
2023-03-17,14,3290,1201,2043,3676,5024,15234
2023-03-18,14,3057,1307,3308,2185,3891,13748
2023-03-19,14,3602,2573,3517,3265,4463,17420
2023-03-20,14,4990,2908,1461,2391,2166,13916
2023-03-21,14,3338,2040,3051,1519,2547,12495
2023-03-22,14,1512,1726,2268,2711,4887,13104
2023-03-23,14,1698,1633,3483,3852,2609,13275
2023-03-24,14,4321,1540,1337,2778,3305,13281
2023-03-25,14,1086,1335,1597,1596,4015,9629
2023-03-26,14,1255,2223,3839,3765,5584,16666
2023-03-27,14,3566,2674,3920,2348,3763,16271
2023-03-28,14,4414,815,2058,3298,3865,14450
2023-03-29,14,4600,1515,3849,2847,2631,15442
2023-03-30,14,4862,2236,3994,3640,2209,16941
2023-03-31,14,1956,2630,1361,3814,4319,14080
2023-04-01,14,1696,1900,1586,3143,2319,10644
2023-04-02,14,1661,2875,3094,2580,5316,15526
2023-04-03,14,1756,1283,3896,3818,4970,15723
2023-04-04,14,3875,2297,3102,2625,5582,17481
2023-04-05,14,1543,1153,3753,1786,5134,13369
2023-04-06,14,3025,1997,1733,3824,2906,13485
2023-04-07,14,2713,2477,2817,3641,4433,16081
2023-04-08,14,3972,846,3289,2984,4823,15914
2023-04-09,14,3438,1831,2287,2705,4415,14676
2023-04-10,14,3965,2880,3847,1691,4658,17041
2023-04-11,14,3447,1938,1881,2169,5154,14589
2023-04-12,14,1275,2398,3048,4426,4261,15408
2023-04-13,14,3664,2917,3108,1642,5894,17225
2023-04-14,14,1516,1609,3482,2554,5940,15101
2023-04-15,14,3914,1632,1383,3520,3275,13724
2023-04-16,14,4143,2219,1836,4308,3204,15710
2023-04-17,14,1452,1074,2936,1691,3224,10377
2023-04-18,14,3423,909,3489,2267,4579,14667
2023-04-19,14,2369,1124,3069,3688,2201,12451
2023-04-20,14,1590,2885,2292,2775,3416,12958
2023-04-21,14,1343,2105,1471,2400,2034,9353
2023-04-22,14,4961,2243,1343,2088,2514,13149
2023-04-23,14,1322,2378,3894,3827,2041,13462
2023-04-24,14,1991,1124,3530,4168,4214,15027
2023-04-25,14,3924,1562,3420,3969,5093,17968
2023-04-26,14,2928,2655,1604,2721,5586,15494
2023-04-27,14,1003,1662,1358,3814,5292,13129
2023-04-28,14,4076,2702,2170,4015,4890,17853
2023-04-29,14,3153,1429,2358,4425,5205,16570
2023-04-30,14,1058,1925,2028,1962,5244,12217
2023-05-01,14,1213,2468,1771,2231,2196,9879
2023-05-02,14,1463,2964,2064,3855,5177,15523
2023-05-03,14,3156,2522,1233,2716,3964,13591
2023-05-04,14,2558,2766,1807,1923,2763,11817
2023-05-05,14,1384,951,2612,3881,4479,13307
2023-05-06,14,4763,2691,3081,3942,4209,18686
2023-05-07,14,1373,2435,3227,2017,3133,12185
2023-05-08,14,3124,2322,1522,2569,3342,12879
2023-05-09,14,1343,1717,3577,2749,2580,11966
2023-05-10,14,1977,2659,3924,3775,4718,17053
2023-05-11,14,2526,1573,3730,3572,5496,16897
2023-05-12,14,4146,2924,1947,2827,5500,17344
2023-05-13,14,2840,1961,2895,2935,3793,14424
2023-05-14,14,4259,1643,2015,2498,3818,14233
2023-05-15,14,2840,1810,2275,2348,5427,14700
2023-05-16,14,3634,822,3135,2862,2322,12775
2023-05-17,14,1504,2019,3001,1654,5154,13332
2023-05-18,14,4097,2129,2142,1739,2275,12382
2023-05-19,14,1736,2200,3313,2090,5943,15282
2023-05-20,14,1056,2851,2919,1550,5877,14253
2023-05-21,14,4652,1546,3634,4251,3870,17953
2023-05-22,14,2792,2826,2908,3033,4761,16320
2023-05-23,14,1899,1186,1571,3287,3089,11032
2023-05-24,14,1102,2360,1759,1991,4903,12115
2023-05-25,14,2013,2286,3459,1694,5043,14495
2023-05-26,14,3853,1076,1548,3918,5796,16191
2023-05-27,14,3393,2402,1754,3066,3789,14404
2023-05-28,14,4380,2333,1985,2788,4768,16254
2023-05-29,14,1543,2270,2829,3132,2509,12283
2023-05-30,14,3231,1113,3626,3837,4168,15975
2023-05-31,14,1519,1285,2861,3626,4935,14226
2023-06-01,14,2333,1860,1204,2950,5813,14160
2023-06-02,14,1439,2273,1672,2357,5772,13513
2023-06-03,14,2124,1340,2408,4170,5359,15401
2023-06-04,14,2087,2535,1273,2652,5303,13850
2023-06-05,14,1763,2802,1416,4297,4977,15255
2023-06-06,14,3732,867,3899,3180,5311,16989
2023-06-07,14,2383,898,2075,3017,2653,11026
2023-06-08,14,2907,1113,2417,2926,5047,14410
2023-06-09,14,4465,906,1390,4107,5027,15895
2023-06-10,14,2836,2835,1706,2787,4495,14659
2023-06-11,14,4277,2545,2652,4195,4371,18040
2023-06-12,14,3275,2780,2616,2847,4814,16332
2023-06-13,14,3627,1775,3957,3482,5920,18761
2023-06-14,14,2663,2054,1881,2919,4806,14323
2023-06-15,14,1594,2512,3656,1579,4843,14184
2023-06-16,14,4273,2477,1757,3358,4619,16484
2023-06-17,14,1458,2049,3246,3638,3027,13418
2023-06-18,14,1583,1541,2902,2179,3044,11249
2023-06-19,14,1785,1601,3964,2086,5706,15142
2023-06-20,14,1651,2259,2647,3791,4578,14926
2023-06-21,14,2732,1205,2422,3262,2943,12564
2023-06-22,14,4816,1809,3402,4026,3986,18039
2023-06-23,14,2572,1771,1488,2222,3582,11635
2023-06-24,14,4601,1936,1639,2186,4295,14657
2023-06-25,14,2292,1072,2006,2609,3306,11285
2023-06-26,14,3000,1139,2097,4412,5507,16155
2023-06-27,14,2307,944,3431,4482,4469,15633
2023-06-28,14,3056,1910,3900,3448,4135,16449
2023-06-29,14,2420,947,2193,2130,4556,12246
2023-06-30,14,3753,2242,1506,3130,2789,13420
2023-07-01,14,1561,1439,1626,4059,3073,11758
2023-07-02,14,2504,943,1793,2078,5554,12872
2023-07-03,14,4421,2190,2935,1871,4901,16318
2023-07-04,14,2712,1909,1485,3945,4780,14831
2023-07-05,14,2949,2611,1766,2341,5575,15242
2023-07-06,14,3197,2929,1584,2517,4779,15006
2023-07-07,14,4977,2407,3263,3111,3307,17065
2023-07-08,14,4203,1015,1589,3772,4157,14736
2023-07-09,14,4181,1027,2301,4148,2268,13925
2023-07-10,14,1353,1024,3502,3454,3457,12790
2023-07-11,14,1055,2936,3733,2294,4486,14504
2023-07-12,14,3302,1388,2219,2230,5252,14391
2023-07-13,14,3522,1880,3398,3544,4852,17196
2023-07-14,14,4079,2826,2163,3961,4464,17493
2023-07-15,14,2651,1119,2392,2995,5937,15094
2023-07-16,14,3480,1744,2141,3829,3550,14744
2023-07-17,14,3329,1419,1222,3485,3247,12702
2023-07-18,14,2079,2600,3496,4496,2578,15249
2023-07-19,14,1781,2624,2485,1828,5907,14625
2023-07-20,14,4141,2033,1242,3964,2887,14267
2023-07-21,14,2053,1203,2984,4186,3173,13599
2023-07-22,14,3084,2327,2213,4316,5318,17258
2023-07-23,14,3479,1793,3910,1649,2202,13033
2023-07-24,14,3654,1917,2389,4144,5994,18098
2023-07-25,14,1851,2235,2771,4457,3371,14685
2023-07-26,14,1738,2864,3637,3979,5494,17712
2023-07-27,14,2433,1104,2763,3023,3230,12553
2023-07-28,14,2315,1416,3673,4461,3122,14987
2023-07-29,14,4193,2948,3861,1611,3789,16402
2023-07-30,14,1957,2680,1273,3977,5639,15526
2023-07-31,14,2708,2354,3970,3058,2969,15059
2023-08-01,14,4502,1964,1248,3403,2729,13846
2023-08-02,14,4239,1138,3456,3601,2005,14439
2023-08-03,14,3610,2582,1873,3315,4371,15751
2023-08-04,14,1948,2348,2056,1522,2539,10413
2023-08-05,14,1886,1242,2593,2461,4480,12662
2023-08-06,14,1756,2569,2915,2369,5003,14612
2023-08-07,14,2699,1087,2498,4438,3141,13863
2023-08-08,14,1059,826,1863,3730,3417,10895
2023-08-09,14,2488,1869,1475,4102,3090,13024
2023-08-10,14,4500,2827,3610,4055,3264,18256
2023-08-11,14,1562,2914,2947,3343,3063,13829
2023-08-12,14,2670,2378,3684,3254,4938,16924
2023-08-13,14,3155,1451,1478,2067,4878,13029
2023-08-14,14,1232,1582,2910,1777,2788,10289
2023-08-15,14,2851,1931,3877,3507,4971,17137
2023-08-16,14,1036,1107,3381,2429,5836,13789
2023-08-17,14,1820,1091,2882,2796,3433,12022
2023-08-18,14,4561,1436,3450,1633,4251,15331
2023-08-19,14,1487,2701,3488,2088,5295,15059
2023-08-20,14,1127,1567,2177,2127,3542,10540
2023-08-21,14,1637,1116,3939,2294,4122,13108
2023-08-22,14,3734,1429,3089,2238,2216,12706
2023-08-23,14,2093,1335,1774,2578,4362,12142
2023-08-24,14,2599,2236,2906,1554,2879,12174
2023-08-25,14,2187,2888,3379,4263,4429,17146
2023-08-26,14,1633,2209,3242,3758,2039,12881
2023-08-27,14,1250,2838,1814,2762,4882,13546
2023-08-28,14,3270,2703,2937,3224,3268,15402
2023-08-29,14,2845,2513,2726,2865,5660,16609
2023-08-30,14,2376,1745,3717,1666,3722,13226
2023-08-31,14,2049,911,1313,2300,2619,9192
2023-09-01,14,1606,1184,1426,4240,4315,12771
2023-09-02,14,3801,2265,1223,2767,2230,12286
2023-09-03,14,4289,2541,2873,3034,3468,16205
2023-09-04,14,1443,1256,2178,3055,5587,13519
2023-09-05,14,4788,1560,3143,2999,2479,14969
2023-09-06,14,1882,881,3891,3024,3920,13598
2023-09-07,14,3352,2679,3262,4301,2512,16106
2023-09-08,14,2468,1021,1623,3907,3573,12592
2023-09-09,14,1305,2257,2896,3580,5619,15657
2023-09-10,14,2503,2299,1643,2520,4271,13236
2023-09-11,14,2154,1613,1410,4443,2060,11680
2023-09-12,14,1081,2931,3913,1962,5517,15404
2023-09-13,14,2880,2328,1766,4395,3762,15131
2023-09-14,14,4754,1899,1715,2054,5851,16273
2023-09-15,14,4905,2321,2946,2300,3499,15971
2023-09-16,14,2893,2546,3094,1633,4851,15017
2023-09-17,14,1490,1255,2406,2432,3702,11285
2023-09-18,14,4867,936,1311,2100,3841,13055
2023-09-19,14,1731,1044,3640,2728,3106,12249
2023-09-20,14,1893,2333,3989,2972,5677,16864
2023-09-21,14,3632,2125,1332,4158,4375,15622
2023-09-22,14,3345,830,1329,4312,2556,12372
2023-09-23,14,4364,2137,2661,1762,4532,15456
2023-09-24,14,4301,1334,3107,1681,4986,15409
2023-09-25,14,3122,1905,3763,3633,4732,17155
2023-09-26,14,4373,1121,3296,3843,5150,17783
2023-09-27,14,4067,807,2918,4492,4729,17013
2023-09-28,14,1164,2736,2928,3970,2770,13568
2023-09-29,14,4627,2830,2166,2819,5140,17582
2023-09-30,14,4570,1523,3610,2098,4819,16620
2023-10-01,14,4048,2012,2451,4417,3154,16082
2023-10-02,14,4853,1593,3730,2101,5427,17704
2023-10-03,14,4680,2807,2312,4298,5647,19744
2023-10-04,14,4320,2273,3065,3845,4562,18065
2023-10-05,14,3127,1508,3879,1801,3255,13570
2023-10-06,14,2213,1189,2430,4446,2299,12577
2023-10-07,14,1870,1011,2011,2256,2799,9947
2023-10-08,14,1237,1066,3952,4213,3263,13731
2023-10-09,14,3407,2498,3168,3145,4950,17168
2023-10-10,14,1236,823,1287,3300,5923,12569
2023-10-11,14,1871,2130,3605,2466,4902,14974
2023-10-12,14,3800,2681,2684,4194,2700,16059
2023-10-13,14,1322,2378,2678,3560,2304,12242
2023-10-14,14,1822,2641,3401,3056,3488,14408
2023-10-15,14,4693,962,1881,2237,3430,13203
2023-10-16,14,1039,1122,3422,3564,5357,14504
2023-10-17,14,1540,2093,2010,3862,4663,14168
2023-10-18,14,2123,862,3618,2402,3121,12126
2023-10-19,14,2054,2845,2416,2181,4047,13543
2023-10-20,14,4006,2177,2216,2086,5748,16233
2023-10-21,14,4270,2576,2876,4003,2524,16249
2023-10-22,14,2752,2503,2463,2105,2180,12003
2023-10-23,14,1297,1139,2385,1665,4614,11100
2023-10-24,14,4557,1771,1630,1665,2171,11794
2023-10-25,14,4141,2897,2829,3328,4119,17314
2023-10-26,14,2357,2704,3636,1700,4976,15373
2023-10-27,14,2507,1823,1906,2747,3766,12749
2023-10-28,14,3261,2326,1718,3216,5862,16383
2023-10-29,14,1967,1394,2788,4119,3613,13881
2023-10-30,14,2703,1956,3052,2744,5538,15993
2023-10-31,14,3125,2859,2794,4320,3818,16916
2023-11-01,14,2118,2725,3273,1810,2137,12063
2023-11-02,14,4393,978,2831,3168,4532,15902
2023-11-03,14,2475,2777,1768,2253,4322,13595
2023-11-04,14,4323,1055,2166,3361,2620,13525
2023-11-05,14,2755,2384,3897,2622,2867,14525
2023-11-06,14,2351,1004,3077,3858,2118,12408
2023-11-07,14,4930,2741,2524,4366,2626,17187
2023-11-08,14,1518,1527,3770,3972,3166,13953
2023-11-09,14,4146,2193,2438,3919,5527,18223
2023-11-10,14,3018,949,3560,2847,4592,14966
2023-11-11,14,1475,1275,1226,2349,5960,12285
2023-11-12,14,2253,2802,3636,3099,3250,15040
2023-11-13,14,3975,1380,2545,2704,3813,14417
2023-11-14,14,3381,1139,1287,2065,3397,11269
2023-11-15,14,3313,823,1611,4238,4800,14785
2023-11-16,14,3249,1013,2924,4407,2081,13674
2023-11-17,14,1993,2425,3683,4293,4918,17312
2023-11-18,14,4060,2492,3716,4115,5255,19638
2023-11-19,14,3508,1481,1297,3262,2981,12529
2023-11-20,14,1003,1596,2725,3703,3237,12264
2023-11-21,14,2762,2020,1240,1604,3166,10792
2023-11-22,14,3888,2198,3912,4264,3769,18031
2023-11-23,14,3054,1750,1458,1927,5766,13955
2023-11-24,14,2463,873,3919,2443,3959,13657
2023-11-25,14,3621,1875,3960,3431,4242,17129
2023-11-26,14,3728,2289,2782,1754,2325,12878
2023-11-27,14,3700,1336,3687,3147,4996,16866
2023-11-28,14,3708,1540,3918,1640,4398,15204
2023-11-29,14,3517,1175,2593,4423,2885,14593
2023-11-30,14,3683,2899,3189,4129,5654,19554
2023-12-01,14,1204,1467,2691,4183,3184,12729
2023-12-02,14,3220,1922,2233,4229,5062,16666
2023-12-03,14,1719,1784,3861,4188,3001,14553
2023-12-04,14,4308,2026,3299,1607,2899,14139
2023-12-05,14,2973,1619,1482,2653,3541,12268
2023-12-06,14,3147,2343,2761,3520,4196,15967
2023-12-07,14,2195,1426,2949,2262,5942,14774
2023-12-08,14,1626,904,3177,2547,4672,12926
2023-12-09,14,2104,845,1766,2556,4070,11341
2023-12-10,14,3081,2177,1366,2655,5218,14497
2023-12-11,14,3063,2802,3882,1771,2445,13963
2023-12-12,14,2963,2178,1334,2039,3744,12258
2023-12-13,14,2628,1873,3772,1965,4649,14887
2023-12-14,14,3671,1703,2171,3772,3615,14932
2023-12-15,14,3174,2526,3407,1919,3946,14972
2023-12-16,14,4686,1181,3031,2759,3656,15313
2023-12-17,14,1526,1252,3782,3910,4386,14856
2023-12-18,14,3947,2848,3188,1592,2732,14307
2023-12-19,14,2473,1355,3808,3044,3177,13857
2023-12-20,14,4532,947,3764,2258,3908,15409
2023-12-21,14,1102,1233,2892,2422,3920,11569
2023-12-22,14,1864,1537,1354,3019,5815,13589
2023-12-23,14,1321,2910,3900,2237,2273,12641
2023-12-24,14,3139,1330,2261,3517,4021,14268
2023-12-25,14,3545,1632,2347,2966,3360,13850
2023-12-26,14,3650,2490,1234,2997,2917,13288
2023-12-27,14,3929,1465,1480,3244,3086,13204
2023-12-28,14,2785,2325,1950,1870,4899,13829
2023-12-29,14,4102,1855,3341,3556,4953,17807
2023-12-30,14,3010,2873,3077,2672,5339,16971
2023-12-31,14,1845,1780,2591,2310,4487,13013
2022-01-01,15,2838,2296,1953,4080,4799,15966
2022-01-02,15,4205,1631,3813,3869,3288,16806
2022-01-03,15,3712,2339,2249,2251,4476,15027
2022-01-04,15,2770,1910,3102,2981,5384,16147
2022-01-05,15,2977,1365,3239,2239,2103,11923
2022-01-06,15,4624,2654,2406,2901,5288,17873
2022-01-07,15,4387,1204,2300,3541,3024,14456
2022-01-08,15,4390,1096,2130,4139,3965,15720
2022-01-09,15,1011,1730,1314,3987,3252,11294
2022-01-10,15,3525,2338,1305,2820,4462,14450
2022-01-11,15,4387,1464,3440,2767,2635,14693
2022-01-12,15,3021,1563,1344,4308,4729,14965
2022-01-13,15,3962,1471,2830,1874,5702,15839
2022-01-14,15,1765,2643,1334,4399,3684,13825
2022-01-15,15,3475,1494,3345,2764,3229,14307
2022-01-16,15,4283,1992,3406,4314,3577,17572
2022-01-17,15,1816,867,3096,3067,4872,13718
2022-01-18,15,1462,1296,2353,1782,4967,11860
2022-01-19,15,3565,1310,3113,3308,2340,13636
2022-01-20,15,1392,2852,3802,4258,3816,16120
2022-01-21,15,3788,1852,2201,2786,3503,14130
2022-01-22,15,2350,1908,2602,1965,2025,10850
2022-01-23,15,3520,2114,3529,3849,5230,18242
2022-01-24,15,1826,1808,1338,4175,4526,13673
2022-01-25,15,3294,1790,1513,2815,2313,11725
2022-01-26,15,1011,1773,2721,4333,3644,13482
2022-01-27,15,1732,1552,1909,3452,4809,13454
2022-01-28,15,2530,1388,3986,2976,3238,14118
2022-01-29,15,3789,1899,2809,3921,4179,16597
2022-01-30,15,4525,2278,2914,2670,3908,16295
2022-01-31,15,2560,2885,3717,2773,4721,16656
2022-02-01,15,2803,1031,1311,3349,4376,12870
2022-02-02,15,1737,2254,1976,3244,5874,15085
2022-02-03,15,1933,2511,1739,2418,5920,14521
2022-02-04,15,2491,1213,1753,4487,4631,14575
2022-02-05,15,4900,2232,2610,3290,3167,16199
2022-02-06,15,1311,1890,2932,3374,2459,11966
2022-02-07,15,3763,848,1714,2930,2075,11330
2022-02-08,15,4673,1401,3539,1675,5841,17129
2022-02-09,15,4645,2508,2722,4151,5086,19112
2022-02-10,15,2977,1617,1284,3439,3323,12640
2022-02-11,15,4849,2395,1877,4206,4994,18321
2022-02-12,15,4122,2216,2012,2721,4170,15241
2022-02-13,15,1578,856,2128,2183,2084,8829
2022-02-14,15,4565,1820,3504,3841,3711,17441
2022-02-15,15,3169,1625,1272,1709,4079,11854
2022-02-16,15,4908,1022,1829,3179,5586,16524
2022-02-17,15,2666,2250,3733,1721,4433,14803
2022-02-18,15,1316,848,3609,4288,5799,15860
2022-02-19,15,3394,2545,3418,3755,2802,15914
2022-02-20,15,4324,805,3676,1734,4950,15489
2022-02-21,15,4417,2613,3601,4031,4304,18966
2022-02-22,15,3583,2867,3768,3414,4845,18477
2022-02-23,15,4700,2815,3570,3186,4084,18355
2022-02-24,15,1834,2649,3858,2097,2303,12741
2022-02-25,15,2728,2450,2500,2695,2588,12961
2022-02-26,15,2233,1455,1670,3144,5756,14258
2022-02-27,15,1169,2382,3310,3815,5856,16532
2022-02-28,15,3327,945,3522,3186,3671,14651
2022-03-01,15,3315,2320,3569,3360,5410,17974
2022-03-02,15,2811,988,3228,3528,5269,15824
2022-03-03,15,2630,1913,1375,3422,2067,11407
2022-03-04,15,3427,1019,3967,3770,4525,16708
2022-03-05,15,3868,1638,1470,1550,5976,14502
2022-03-06,15,1217,828,1906,3696,5112,12759
2022-03-07,15,4262,1331,3655,3982,5732,18962
2022-03-08,15,1139,1954,1759,3133,2588,10573
2022-03-09,15,4934,2464,2131,3372,4706,17607
2022-03-10,15,3106,1103,2228,2766,2704,11907
2022-03-11,15,3914,1412,3007,4194,5246,17773
2022-03-12,15,2424,2326,3056,4318,2349,14473
2022-03-13,15,2130,2542,2280,3611,5018,15581
2022-03-14,15,2378,1785,1366,2722,3124,11375
2022-03-15,15,2378,1758,3834,2217,3352,13539
2022-03-16,15,4407,1142,1765,1716,2126,11156
2022-03-17,15,4043,1410,2472,3776,4096,15797
2022-03-18,15,1437,1320,3684,2332,2813,11586
2022-03-19,15,3781,1599,2434,2047,5651,15512
2022-03-20,15,2453,2414,3807,2252,5344,16270
2022-03-21,15,4665,2904,3764,1730,5407,18470
2022-03-22,15,3545,1551,3151,4496,2593,15336
2022-03-23,15,3482,1035,2768,3919,3414,14618
2022-03-24,15,1199,1231,3426,1557,3072,10485
2022-03-25,15,4307,1405,2828,3170,4306,16016
2022-03-26,15,3554,2404,1388,1922,5541,14809
2022-03-27,15,3457,1972,3483,2054,5683,16649
2022-03-28,15,3790,1631,2049,3177,3542,14189
2022-03-29,15,2326,1209,1391,1974,4859,11759
2022-03-30,15,3215,1339,3427,4270,5779,18030
2022-03-31,15,4620,1228,2840,4408,3971,17067
2022-04-01,15,1800,2895,1493,4144,4490,14822
2022-04-02,15,3017,863,3486,1775,4714,13855
2022-04-03,15,3685,1218,3649,4070,4046,16668
2022-04-04,15,1535,2830,3780,3421,2481,14047
2022-04-05,15,1886,2077,3409,3149,2870,13391
2022-04-06,15,1175,2904,3277,2398,5922,15676
2022-04-07,15,4683,2666,2319,4265,2595,16528
2022-04-08,15,3183,1320,3015,4191,5879,17588
2022-04-09,15,1410,2327,3777,2254,5298,15066
2022-04-10,15,2366,1415,1694,4261,5151,14887
2022-04-11,15,1352,982,1468,1852,4201,9855
2022-04-12,15,2699,803,2157,2358,4606,12623
2022-04-13,15,2911,2939,2020,3989,3815,15674
2022-04-14,15,1210,2570,3844,4186,2431,14241
2022-04-15,15,2053,1205,3481,2510,5415,14664
2022-04-16,15,3866,965,1246,2099,3862,12038
2022-04-17,15,2909,1050,2711,2782,5277,14729
2022-04-18,15,2625,1266,2169,2277,2229,10566
2022-04-19,15,3500,2371,3970,2865,3300,16006
2022-04-20,15,3902,2680,1451,3383,2291,13707
2022-04-21,15,1521,923,3100,1684,3222,10450
2022-04-22,15,3154,2260,3430,2474,3585,14903
2022-04-23,15,1798,869,3793,4009,4809,15278
2022-04-24,15,4101,1444,3944,3166,2415,15070
2022-04-25,15,4604,1550,3560,3925,5726,19365
2022-04-26,15,2986,1951,2409,2175,5750,15271
2022-04-27,15,3243,2178,3287,2628,2309,13645
2022-04-28,15,4154,1457,3951,3040,5861,18463
2022-04-29,15,3055,2882,3542,4434,5985,19898
2022-04-30,15,4625,2569,2795,3832,4010,17831
2022-05-01,15,2589,1686,1970,3558,3766,13569
2022-05-02,15,3085,1642,3159,2849,4964,15699
2022-05-03,15,4320,2680,1595,2042,3874,14511
2022-05-04,15,1970,2098,3597,3525,5327,16517
2022-05-05,15,4055,1244,2741,3687,4485,16212
2022-05-06,15,4128,2566,2525,3969,3842,17030
2022-05-07,15,2008,2189,3155,1910,2624,11886
2022-05-08,15,3822,2813,3522,2231,4785,17173
2022-05-09,15,2513,2806,1740,1986,3334,12379
2022-05-10,15,4879,2143,2371,3851,2527,15771
2022-05-11,15,3345,1723,3339,1697,2317,12421
2022-05-12,15,2334,1187,3150,2207,4286,13164
2022-05-13,15,4469,2975,3539,2214,5580,18777
2022-05-14,15,1577,1981,3557,3906,3763,14784
2022-05-15,15,2190,2301,2751,4239,2271,13752
2022-05-16,15,1111,1705,2722,2813,4353,12704
2022-05-17,15,4850,2593,3646,1927,5713,18729
2022-05-18,15,1194,1960,1491,3353,3601,11599
2022-05-19,15,4131,2953,1460,3049,4835,16428
2022-05-20,15,1170,1014,2276,3986,2601,11047
2022-05-21,15,4263,878,2630,3113,4306,15190
2022-05-22,15,4727,2247,3191,3442,5643,19250
2022-05-23,15,2869,1219,2796,2352,3049,12285
2022-05-24,15,2078,1376,2910,1818,4706,12888
2022-05-25,15,1815,2310,3504,2594,4625,14848
2022-05-26,15,3303,1657,1631,2390,3248,12229
2022-05-27,15,1603,2296,3803,3598,3756,15056
2022-05-28,15,3302,1698,2796,3814,4780,16390
2022-05-29,15,2510,2095,1354,3536,4695,14190
2022-05-30,15,2392,1786,3638,2794,3444,14054
2022-05-31,15,4593,2123,1696,2026,2013,12451
2022-06-01,15,4609,2141,1597,1683,5746,15776
2022-06-02,15,2341,2910,1316,1684,5825,14076
2022-06-03,15,4315,1838,3065,2800,3710,15728
2022-06-04,15,4972,2035,1560,2508,2019,13094
2022-06-05,15,1732,853,2579,3390,4576,13130
2022-06-06,15,3507,1478,3108,2629,2612,13334
2022-06-07,15,3248,1454,3280,3495,4323,15800
2022-06-08,15,3827,1965,1344,3454,5484,16074
2022-06-09,15,1013,1239,3115,3992,3792,13151
2022-06-10,15,3260,2194,1673,1801,3792,12720
2022-06-11,15,4868,1392,2475,2732,2687,14154
2022-06-12,15,4907,1004,1618,3496,5531,16556
2022-06-13,15,4059,1868,3618,3320,4527,17392
2022-06-14,15,4948,2865,2346,1790,2341,14290
2022-06-15,15,2260,1193,2581,2358,4058,12450
2022-06-16,15,4626,2435,1507,2222,5705,16495
2022-06-17,15,3195,2057,3090,1537,2918,12797
2022-06-18,15,1301,2282,1361,2875,3938,11757
2022-06-19,15,3795,1017,1478,4479,2223,12992
2022-06-20,15,4639,2111,3838,2077,3857,16522
2022-06-21,15,1326,2823,3274,4164,4808,16395
2022-06-22,15,1557,1886,2651,3831,3582,13507
2022-06-23,15,2822,816,3778,2975,3715,14106
2022-06-24,15,4829,1555,1824,3621,3286,15115
2022-06-25,15,1426,1407,3403,2557,4939,13732
2022-06-26,15,4926,2799,3427,3018,3961,18131
2022-06-27,15,2908,1434,3891,4215,2915,15363
2022-06-28,15,1334,1880,3432,2690,5264,14600
2022-06-29,15,2888,1987,3429,3775,2554,14633
2022-06-30,15,2953,939,1664,2700,5283,13539
2022-07-01,15,3684,2714,2260,4412,2290,15360
2022-07-02,15,2417,1907,3967,4452,2229,14972
2022-07-03,15,1475,2764,3346,3489,5494,16568
2022-07-04,15,4264,2658,3169,3709,4450,18250
2022-07-05,15,1869,2488,3662,1777,2866,12662
2022-07-06,15,2338,1331,1878,2684,2827,11058
2022-07-07,15,3326,2843,3011,2027,2863,14070
2022-07-08,15,3221,937,3708,1920,4800,14586
2022-07-09,15,3570,1601,1710,4341,4137,15359
2022-07-10,15,4895,2932,1423,3755,2951,15956
2022-07-11,15,3778,1127,2319,1574,4595,13393
2022-07-12,15,2512,2025,3134,4298,4901,16870
2022-07-13,15,3415,800,2449,2541,3827,13032
2022-07-14,15,1931,2810,3824,2635,5988,17188
2022-07-15,15,2399,1417,2407,4041,5669,15933
2022-07-16,15,2693,2567,2192,3649,5277,16378
2022-07-17,15,4867,2345,3575,2295,5091,18173
2022-07-18,15,3229,2322,2126,3395,4812,15884
2022-07-19,15,3921,2400,3493,2987,3336,16137
2022-07-20,15,2610,2483,1568,4219,5652,16532
2022-07-21,15,4597,2004,3460,3854,2029,15944
2022-07-22,15,3188,2867,3255,4252,4118,17680
2022-07-23,15,1060,1807,2528,2883,4554,12832
2022-07-24,15,3380,1371,3638,1598,5154,15141
2022-07-25,15,4536,2966,3967,2353,4563,18385
2022-07-26,15,2513,1305,2710,4331,4124,14983
2022-07-27,15,3846,2155,2086,3186,4762,16035
2022-07-28,15,1830,1891,3388,3329,3583,14021
2022-07-29,15,4844,1310,2352,4241,5604,18351
2022-07-30,15,2522,2314,3198,1538,5980,15552
2022-07-31,15,4518,2562,3655,3162,2701,16598
2022-08-01,15,2391,1936,2647,4474,5872,17320
2022-08-02,15,3188,915,1857,1865,5086,12911
2022-08-03,15,1170,2206,1298,4355,3653,12682
2022-08-04,15,4951,1176,2188,4459,4230,17004
2022-08-05,15,1890,2453,1968,1884,5814,14009
2022-08-06,15,2545,2468,2118,1981,3897,13009
2022-08-07,15,4817,2380,1947,2817,2402,14363
2022-08-08,15,3905,2452,2996,2575,2950,14878
2022-08-09,15,4228,1243,3875,4461,2644,16451
2022-08-10,15,3625,1756,2277,3151,5832,16641
2022-08-11,15,1616,1871,3118,3051,4298,13954
2022-08-12,15,3176,1352,1594,4212,4435,14769
2022-08-13,15,2137,2681,3939,2493,5961,17211
2022-08-14,15,4739,1994,3228,3282,4315,17558
2022-08-15,15,2806,1169,2342,1773,2184,10274
2022-08-16,15,2240,1993,2008,2943,4681,13865
2022-08-17,15,3098,1598,1933,3998,5103,15730
2022-08-18,15,1342,2603,1337,2625,4679,12586
2022-08-19,15,2018,1422,2019,2923,5719,14101
2022-08-20,15,4832,2768,3732,4133,2591,18056
2022-08-21,15,3410,1019,3814,1672,4840,14755
2022-08-22,15,3072,1381,2213,2211,5162,14039
2022-08-23,15,1380,2288,3193,4271,5604,16736
2022-08-24,15,3590,866,1751,3897,3582,13686
2022-08-25,15,1853,1739,3419,3386,5271,15668
2022-08-26,15,4904,2972,1697,3528,4887,17988
2022-08-27,15,4318,1209,2765,4302,3998,16592
2022-08-28,15,2207,2288,1369,4092,3461,13417
2022-08-29,15,4279,1131,1484,3814,3969,14677
2022-08-30,15,2861,1718,1510,3335,3308,12732
2022-08-31,15,2857,2645,2475,4355,4015,16347
2022-09-01,15,1004,979,3018,4443,5859,15303
2022-09-02,15,3046,1461,1955,4235,2169,12866
2022-09-03,15,1187,2179,2369,2904,3260,11899
2022-09-04,15,3165,2214,3586,2779,5363,17107
2022-09-05,15,4781,1344,3409,3855,2842,16231
2022-09-06,15,1824,976,2785,4320,3972,13877
2022-09-07,15,2069,1099,1564,3579,4235,12546
2022-09-08,15,4815,1268,2260,2131,2498,12972
2022-09-09,15,1609,2349,2006,3693,4143,13800
2022-09-10,15,1771,1123,1716,4379,3406,12395
2022-09-11,15,2140,1768,1639,3993,5048,14588
2022-09-12,15,4899,1150,3923,4162,2978,17112
2022-09-13,15,1203,1594,2161,3032,4887,12877
2022-09-14,15,3353,1568,2075,2224,4306,13526
2022-09-15,15,3244,1886,2207,3777,2323,13437
2022-09-16,15,4008,2617,3969,2983,2373,15950
2022-09-17,15,3523,2923,1967,3687,3079,15179
2022-09-18,15,2880,1973,2080,3547,4698,15178
2022-09-19,15,3494,1559,3318,3988,2628,14987
2022-09-20,15,4858,2972,1346,2715,3275,15166
2022-09-21,15,2712,2522,1216,2444,3804,12698
2022-09-22,15,3558,1117,2482,2217,3423,12797
2022-09-23,15,3912,2990,3949,4289,3241,18381
2022-09-24,15,2867,2181,1331,2457,5854,14690
2022-09-25,15,2455,1575,3449,3383,4919,15781
2022-09-26,15,1994,1256,3893,3106,5365,15614
2022-09-27,15,1760,2046,1898,2642,5676,14022
2022-09-28,15,1182,1095,2363,2104,3739,10483
2022-09-29,15,3191,1684,3314,3510,4163,15862
2022-09-30,15,1713,2827,3618,1812,4950,14920
2022-10-01,15,2626,808,2517,2263,4111,12325
2022-10-02,15,2247,2608,2239,2106,3051,12251
2022-10-03,15,1397,2387,3594,3133,4457,14968
2022-10-04,15,1114,2276,3859,1585,3533,12367
2022-10-05,15,3735,1539,3393,2994,5688,17349
2022-10-06,15,1020,851,2868,3328,5937,14004
2022-10-07,15,4190,2750,1752,1808,2267,12767
2022-10-08,15,4526,2783,1788,4393,3298,16788
2022-10-09,15,2993,2598,2985,2078,4123,14777
2022-10-10,15,3178,975,2527,4057,5022,15759
2022-10-11,15,3024,971,3360,3014,2133,12502
2022-10-12,15,4576,1050,2957,3756,4186,16525
2022-10-13,15,1343,2874,1727,2573,3100,11617
2022-10-14,15,1508,973,3213,3773,4516,13983
2022-10-15,15,1415,1913,2949,1740,2926,10943
2022-10-16,15,2930,2326,3995,3657,3571,16479
2022-10-17,15,1302,1035,1534,1801,3519,9191
2022-10-18,15,1171,1060,3579,4398,5387,15595
2022-10-19,15,4705,1356,3793,1598,3363,14815
2022-10-20,15,1713,1119,2710,2573,5194,13309
2022-10-21,15,2871,1867,3367,2993,5283,16381
2022-10-22,15,1942,2608,2086,2165,2925,11726
2022-10-23,15,4106,1183,2579,3561,4578,16007
2022-10-24,15,3781,1988,3700,2291,4343,16103
2022-10-25,15,3454,2728,3376,2976,2362,14896
2022-10-26,15,3028,2486,2058,2013,3185,12770
2022-10-27,15,3211,2212,1714,4001,4513,15651
2022-10-28,15,4505,1884,1547,4277,2169,14382
2022-10-29,15,3288,2075,2198,3568,5988,17117
2022-10-30,15,4255,982,1273,1751,3280,11541
2022-10-31,15,1492,1295,2408,4226,4465,13886
2022-11-01,15,2043,1951,3052,3322,3658,14026
2022-11-02,15,3815,1022,1656,2839,3601,12933
2022-11-03,15,3628,1237,3168,1743,3744,13520
2022-11-04,15,4461,1907,3088,3652,2404,15512
2022-11-05,15,2213,1741,1584,4230,3956,13724
2022-11-06,15,1887,2331,1326,2134,3555,11233
2022-11-07,15,1735,1863,2459,1734,3098,10889
2022-11-08,15,1018,1899,3695,4322,3692,14626
2022-11-09,15,2872,2239,3666,1883,2646,13306
2022-11-10,15,2962,917,3556,4363,2950,14748
2022-11-11,15,1388,1885,3184,1676,5179,13312
2022-11-12,15,4028,1461,3432,3348,4858,17127
2022-11-13,15,2835,2635,3755,1623,3895,14743
2022-11-14,15,1984,2781,2583,1629,5946,14923
2022-11-15,15,4849,1741,3092,3907,5049,18638
2022-11-16,15,2471,2744,3064,1970,3116,13365
2022-11-17,15,2674,1931,1313,2816,5082,13816
2022-11-18,15,3646,1360,1726,1898,3598,12228
2022-11-19,15,4031,1584,3749,1741,2983,14088
2022-11-20,15,1931,2952,3714,2455,5143,16195
2022-11-21,15,2269,1105,2610,2089,4455,12528
2022-11-22,15,2370,2290,2153,3386,5686,15885
2022-11-23,15,4414,1364,2779,4211,3919,16687
2022-11-24,15,4012,1760,1280,2609,4431,14092
2022-11-25,15,3369,1092,2337,4159,4295,15252
2022-11-26,15,2507,1606,1767,3282,2102,11264
2022-11-27,15,1362,2465,2951,4235,4136,15149
2022-11-28,15,3874,2185,1989,3252,3484,14784
2022-11-29,15,2571,1548,2616,3033,2238,12006
2022-11-30,15,2390,859,1274,3201,3695,11419
2022-12-01,15,2497,2285,1276,3848,5351,15257
2022-12-02,15,2849,2035,3514,2058,4178,14634
2022-12-03,15,2086,2880,2380,2206,4717,14269
2022-12-04,15,1894,1846,1813,2893,4902,13348
2022-12-05,15,1926,2510,1599,3481,4843,14359
2022-12-06,15,4345,1113,1239,3725,3721,14143
2022-12-07,15,4601,2210,1319,2689,3421,14240
2022-12-08,15,3890,2791,3872,1903,4449,16905
2022-12-09,15,1306,1940,1251,3109,4927,12533
2022-12-10,15,1952,2266,1662,3492,2230,11602
2022-12-11,15,3918,1045,3393,4071,5540,17967
2022-12-12,15,1999,901,3192,2188,2027,10307
2022-12-13,15,3568,862,3675,4001,4272,16378
2022-12-14,15,4883,1292,3708,1898,4495,16276
2022-12-15,15,3794,2445,3892,2921,3866,16918
2022-12-16,15,3974,1604,3218,1577,3964,14337
2022-12-17,15,4608,1382,1610,1857,2833,12290
2022-12-18,15,3747,1154,1275,3371,4392,13939
2022-12-19,15,1010,1250,2451,2490,4515,11716
2022-12-20,15,3702,2528,1524,1945,2696,12395
2022-12-21,15,2562,1911,2479,3147,4703,14802
2022-12-22,15,4477,1710,3889,2588,5946,18610
2022-12-23,15,3783,2139,3612,1580,4307,15421
2022-12-24,15,1289,1523,3985,2580,5197,14574
2022-12-25,15,2237,2032,2054,3022,4698,14043
2022-12-26,15,4716,1115,4000,2928,2655,15414
2022-12-27,15,3414,2019,1734,2462,5565,15194
2022-12-28,15,3203,2784,3268,2476,5605,17336
2022-12-29,15,4250,2975,1980,2653,4266,16124
2022-12-30,15,1970,1198,1278,3619,2867,10932
2022-12-31,15,1705,845,1483,1968,2735,8736
2023-01-01,15,3870,2686,2583,3224,2752,15115
2023-01-02,15,3717,2275,3724,1659,2023,13398
2023-01-03,15,2752,1894,3787,3085,3278,14796
2023-01-04,15,4711,2704,3944,2934,4652,18945
2023-01-05,15,4801,876,2667,2841,4742,15927
2023-01-06,15,4772,2767,3115,3336,5975,19965
2023-01-07,15,4375,2022,2298,2955,5712,17362
2023-01-08,15,3228,1453,3728,2380,4667,15456
2023-01-09,15,1644,1891,2489,1705,3769,11498
2023-01-10,15,2546,1996,2741,3101,4152,14536
2023-01-11,15,3909,855,2141,3169,4389,14463
2023-01-12,15,4905,841,2573,2786,5325,16430
2023-01-13,15,3948,2301,3002,1819,3365,14435
2023-01-14,15,1395,802,2388,2258,3362,10205
2023-01-15,15,1778,1350,2922,1920,3982,11952
2023-01-16,15,3802,2594,3961,2879,4560,17796
2023-01-17,15,4625,1910,2226,2531,3191,14483
2023-01-18,15,3779,2641,3794,3642,2955,16811
2023-01-19,15,2903,2395,1246,2353,4549,13446
2023-01-20,15,1154,891,3528,4069,5316,14958
2023-01-21,15,1950,1261,2065,3755,4045,13076
2023-01-22,15,2178,2417,2382,2387,5221,14585
2023-01-23,15,1292,2679,3999,2508,3702,14180
2023-01-24,15,4224,2261,3908,4277,4464,19134
2023-01-25,15,2475,2450,3406,4358,2732,15421
2023-01-26,15,4862,845,3432,2761,2031,13931
2023-01-27,15,2573,1582,3273,2009,2063,11500
2023-01-28,15,3564,1205,3654,4297,2158,14878
2023-01-29,15,1183,1993,2413,2300,4708,12597
2023-01-30,15,3084,2549,2634,1906,4071,14244
2023-01-31,15,1508,1814,3190,3403,4434,14349
2023-02-01,15,3498,1186,2675,4292,2990,14641
2023-02-02,15,4886,2265,1437,1912,5818,16318
2023-02-03,15,3542,2370,1446,2984,4923,15265
2023-02-04,15,3732,2238,2472,4356,3580,16378
2023-02-05,15,3053,2081,1866,4022,3950,14972
2023-02-06,15,2713,1989,1918,3604,3325,13549
2023-02-07,15,1097,1314,2679,2271,4547,11908
2023-02-08,15,1952,2407,1818,4473,2784,13434
2023-02-09,15,3776,2064,2658,2655,2506,13659
2023-02-10,15,3243,1834,2517,2680,2123,12397
2023-02-11,15,1989,1124,2787,3755,4649,14304
2023-02-12,15,2487,819,2467,1787,2360,9920
2023-02-13,15,4910,1876,3370,1640,5229,17025
2023-02-14,15,3251,2851,3099,1808,5936,16945
2023-02-15,15,4998,2016,1478,2844,3973,15309
2023-02-16,15,3674,1053,2441,2301,3105,12574
2023-02-17,15,4281,1504,1879,2154,2019,11837
2023-02-18,15,3428,869,2853,4478,5406,17034
2023-02-19,15,2580,1447,1213,2586,4505,12331
2023-02-20,15,3610,1313,3340,2119,3342,13724
2023-02-21,15,3185,2172,2233,2484,2096,12170
2023-02-22,15,3578,1923,2120,1536,4604,13761
2023-02-23,15,2561,2933,1943,3438,3359,14234
2023-02-24,15,1822,1819,3500,2003,3716,12860
2023-02-25,15,4489,1056,1869,2752,2449,12615
2023-02-26,15,2100,1138,1832,2586,3268,10924
2023-02-27,15,4924,2831,3966,2096,2845,16662
2023-02-28,15,1368,1940,3821,2003,3565,12697
2023-03-01,15,2350,1010,3013,3542,2582,12497
2023-03-02,15,2023,2168,3192,2822,3749,13954
2023-03-03,15,2155,2117,1324,2607,2879,11082
2023-03-04,15,4865,2791,3133,3775,3120,17684
2023-03-05,15,4705,1143,3872,3492,3232,16444
2023-03-06,15,4877,1629,3029,2912,2910,15357
2023-03-07,15,4822,2959,3050,3653,4606,19090
2023-03-08,15,3297,959,3090,4475,5707,17528
2023-03-09,15,1839,2138,2183,3364,2454,11978
2023-03-10,15,3023,2637,2410,2942,4510,15522
2023-03-11,15,4654,1474,1584,2041,2491,12244
2023-03-12,15,2250,1688,3508,4200,3854,15500
2023-03-13,15,2982,925,3991,1696,4543,14137
2023-03-14,15,4655,1658,2708,2819,4715,16555
2023-03-15,15,3608,1607,3996,3411,2698,15320
2023-03-16,15,2517,2047,3365,3546,2674,14149
2023-03-17,15,2020,1430,2684,3925,3266,13325
2023-03-18,15,4064,1524,3813,3889,2907,16197
2023-03-19,15,3790,1482,3401,4341,5028,18042
2023-03-20,15,4752,2075,3800,3280,5517,19424
2023-03-21,15,4384,1760,2871,2317,2753,14085
2023-03-22,15,3911,1002,1914,2524,3554,12905
2023-03-23,15,2836,2935,3205,1956,4474,15406
2023-03-24,15,1265,802,2698,2917,2207,9889
2023-03-25,15,1142,1124,2398,4123,4115,12902
2023-03-26,15,1865,934,1255,3229,3788,11071
2023-03-27,15,4209,813,1951,3858,5847,16678
2023-03-28,15,4952,2675,3142,2231,5606,18606
2023-03-29,15,4421,2305,3141,3522,2039,15428
2023-03-30,15,4345,2670,3838,3871,4445,19169
2023-03-31,15,3268,1377,3460,1966,2867,12938
2023-04-01,15,3690,1109,3528,4130,4703,17160
2023-04-02,15,2243,1437,1832,4342,3294,13148
2023-04-03,15,4219,937,3508,1873,5508,16045
2023-04-04,15,2731,902,3702,3211,5358,15904
2023-04-05,15,2926,1021,2723,2838,5494,15002
2023-04-06,15,1495,2340,3016,3654,2800,13305
2023-04-07,15,1847,823,1270,3117,2808,9865
2023-04-08,15,2274,1150,1910,4338,2018,11690
2023-04-09,15,2429,1180,2985,2622,4017,13233
2023-04-10,15,2940,2111,3173,4085,3806,16115
2023-04-11,15,2505,1376,3531,4078,3322,14812
2023-04-12,15,1430,1629,3953,2218,3884,13114
2023-04-13,15,3948,2240,2615,3255,4498,16556
2023-04-14,15,3858,1940,2979,2117,5643,16537
2023-04-15,15,3406,2637,1570,3396,2895,13904
2023-04-16,15,1937,2661,2955,2043,3068,12664
2023-04-17,15,4021,805,3219,1661,4564,14270
2023-04-18,15,4374,1823,2575,3630,3336,15738
2023-04-19,15,3483,1118,2403,2849,4866,14719
2023-04-20,15,4918,2995,3264,1561,3189,15927
2023-04-21,15,3732,2523,1467,2137,4728,14587
2023-04-22,15,2503,1441,1234,3541,4114,12833
2023-04-23,15,1267,827,3288,3389,4636,13407
2023-04-24,15,3805,918,2307,4034,2116,13180
2023-04-25,15,3521,1475,2234,2080,4890,14200
2023-04-26,15,4131,880,1810,2041,5240,14102
2023-04-27,15,3412,1613,1894,1841,3690,12450
2023-04-28,15,4918,2580,1913,2037,3159,14607
2023-04-29,15,4705,1686,2572,4463,4722,18148
2023-04-30,15,1645,1120,1503,2006,2290,8564
2023-05-01,15,4772,1016,2013,3915,2038,13754
2023-05-02,15,2589,2470,2977,1718,3766,13520
2023-05-03,15,4550,1106,2696,3910,4895,17157
2023-05-04,15,4373,1295,3989,2743,3120,15520
2023-05-05,15,3635,2281,3563,3467,4025,16971
2023-05-06,15,4286,1885,1302,2881,2193,12547
2023-05-07,15,4269,2736,3071,2213,3790,16079
2023-05-08,15,1136,1390,3415,2653,2345,10939
2023-05-09,15,2353,924,3997,4342,4711,16327
2023-05-10,15,3937,1161,1411,4194,4957,15660
2023-05-11,15,2115,2917,2920,3865,2758,14575
2023-05-12,15,2954,1155,1308,2138,4014,11569
2023-05-13,15,1627,2429,3603,3981,3932,15572
2023-05-14,15,2980,1417,1782,1592,5039,12810
2023-05-15,15,1053,2022,3513,4305,3427,14320
2023-05-16,15,4958,2103,1698,2588,5343,16690
2023-05-17,15,2344,998,1549,3863,4835,13589
2023-05-18,15,1651,1673,2457,1795,2583,10159
2023-05-19,15,3887,2538,2707,1706,5763,16601
2023-05-20,15,4845,2398,3572,2887,4653,18355
2023-05-21,15,1305,2630,2627,3608,5148,15318
2023-05-22,15,4363,940,2554,4359,2167,14383
2023-05-23,15,2291,1930,2936,3781,2926,13864
2023-05-24,15,3307,1925,3011,3350,4354,15947
2023-05-25,15,4663,1253,3054,4059,3536,16565
2023-05-26,15,3388,1317,1627,2316,5202,13850
2023-05-27,15,2762,1483,3400,2868,3371,13884
2023-05-28,15,1068,2659,1370,4474,5111,14682
2023-05-29,15,3871,1426,2841,2557,2230,12925
2023-05-30,15,4365,1454,3534,2853,4403,16609
2023-05-31,15,2453,2849,3906,1881,4814,15903
2023-06-01,15,4535,2594,2647,2353,2573,14702
2023-06-02,15,4726,2496,1570,2476,3853,15121
2023-06-03,15,4095,1243,3386,3513,3661,15898
2023-06-04,15,1561,2835,1339,4061,3256,13052
2023-06-05,15,2216,2425,2858,3283,4802,15584
2023-06-06,15,2014,2602,1860,2600,4210,13286
2023-06-07,15,2039,1881,1824,3933,2973,12650
2023-06-08,15,1256,1419,2517,1714,2321,9227
2023-06-09,15,2206,2272,1803,2819,5261,14361
2023-06-10,15,1997,878,3667,1736,3016,11294
2023-06-11,15,1519,1001,2614,2278,3576,10988
2023-06-12,15,4489,1687,3574,2039,3548,15337
2023-06-13,15,2132,2487,1445,3129,3362,12555
2023-06-14,15,1898,1571,3375,1597,2112,10553
2023-06-15,15,4026,1229,3583,2468,5062,16368
2023-06-16,15,2807,988,2415,4110,3099,13419
2023-06-17,15,2957,2579,2698,4452,5105,17791
2023-06-18,15,4357,910,2621,4021,4708,16617
2023-06-19,15,4381,855,2231,3219,2956,13642
2023-06-20,15,4053,2833,1285,2644,2525,13340
2023-06-21,15,1419,938,1555,3482,3741,11135
2023-06-22,15,3647,2767,2381,2670,4094,15559
2023-06-23,15,4286,2275,3027,2631,4546,16765
2023-06-24,15,4171,2287,3587,2517,2884,15446
2023-06-25,15,3917,2805,2571,2369,4025,15687
2023-06-26,15,2197,2932,3492,4417,2240,15278
2023-06-27,15,4898,1436,3505,2253,4403,16495
2023-06-28,15,1531,2907,3401,2268,2584,12691
2023-06-29,15,2387,2640,2470,4406,4137,16040
2023-06-30,15,1135,832,3022,2482,5754,13225
2023-07-01,15,4169,1519,1643,2062,5946,15339
2023-07-02,15,3432,1031,3330,2757,4349,14899
2023-07-03,15,1450,2122,1738,3539,3580,12429
2023-07-04,15,2220,2325,3595,1582,3190,12912
2023-07-05,15,3990,855,3614,1581,2818,12858
2023-07-06,15,3987,2519,2781,2010,3950,15247
2023-07-07,15,1534,2934,2125,4352,3409,14354
2023-07-08,15,3767,2333,1850,2492,2815,13257
2023-07-09,15,4962,1754,3233,3075,2326,15350
2023-07-10,15,4961,1868,3729,2250,5511,18319
2023-07-11,15,2293,2672,3983,2045,2319,13312
2023-07-12,15,1043,1682,2198,2277,3110,10310
2023-07-13,15,2260,2848,3700,2361,3817,14986
2023-07-14,15,1110,900,3064,3453,4355,12882
2023-07-15,15,1081,1175,3339,3821,3295,12711
2023-07-16,15,1052,1505,3781,2389,3026,11753
2023-07-17,15,4253,1872,2993,3685,4124,16927
2023-07-18,15,2681,2645,3651,4237,5894,19108
2023-07-19,15,3216,1316,3775,2679,2288,13274
2023-07-20,15,1760,2709,3031,2157,5004,14661
2023-07-21,15,1063,1611,2950,3592,4317,13533
2023-07-22,15,2724,2108,1257,2520,2865,11474
2023-07-23,15,4617,1279,1296,4286,4547,16025
2023-07-24,15,2098,988,2404,2310,2557,10357
2023-07-25,15,3010,2742,2633,1866,5648,15899
2023-07-26,15,3399,1916,2185,4079,5991,17570
2023-07-27,15,1113,1772,1979,1738,2782,9384
2023-07-28,15,1615,1033,2802,3141,3857,12448
2023-07-29,15,1450,2582,2668,3847,3971,14518
2023-07-30,15,4473,2326,3508,2970,4771,18048
2023-07-31,15,1510,2027,1588,3666,2762,11553
2023-08-01,15,3813,2309,2718,4289,3545,16674
2023-08-02,15,2847,2162,3061,2758,2624,13452
2023-08-03,15,1419,2422,3791,1771,5975,15378
2023-08-04,15,1758,1685,3085,4306,5827,16661
2023-08-05,15,2630,2254,3324,1576,4839,14623
2023-08-06,15,4874,1831,1407,4210,2463,14785
2023-08-07,15,1234,847,3015,3851,5997,14944
2023-08-08,15,4260,1222,2817,3781,2378,14458
2023-08-09,15,3797,1215,1749,1755,4064,12580
2023-08-10,15,4948,1007,3062,1769,3375,14161
2023-08-11,15,1659,1954,1828,3594,4800,13835
2023-08-12,15,4914,1693,3893,4080,4921,19501
2023-08-13,15,3239,2934,2658,1601,5124,15556
2023-08-14,15,4482,1884,1308,3288,2652,13614
2023-08-15,15,3668,2415,2002,3751,4503,16339
2023-08-16,15,3458,1054,2385,1526,2484,10907
2023-08-17,15,4747,1249,2290,1540,5049,14875
2023-08-18,15,3404,2295,1229,4268,5263,16459
2023-08-19,15,3257,2127,1449,2656,3058,12547
2023-08-20,15,1907,2492,1302,3590,2485,11776
2023-08-21,15,4510,810,3450,1889,4655,15314
2023-08-22,15,3881,1982,1933,4426,4838,17060
2023-08-23,15,1429,2172,2638,3840,4175,14254
2023-08-24,15,4866,2941,3873,2866,3212,17758
2023-08-25,15,2599,2101,2754,1724,2798,11976
2023-08-26,15,2925,1866,2571,4417,2746,14525
2023-08-27,15,1548,2677,2680,2800,4269,13974
2023-08-28,15,2383,2624,2561,1538,5760,14866
2023-08-29,15,4556,2229,2668,2763,5615,17831
2023-08-30,15,3964,2241,3757,4228,3305,17495
2023-08-31,15,2331,1483,1786,2130,2629,10359
2023-09-01,15,4166,2441,2691,2806,5761,17865
2023-09-02,15,3747,819,2013,2449,4613,13641
2023-09-03,15,4007,1768,1219,3900,2974,13868
2023-09-04,15,1951,1042,3696,2230,3636,12555
2023-09-05,15,3449,2653,3860,1879,2506,14347
2023-09-06,15,1026,1094,3334,1637,3419,10510
2023-09-07,15,1517,1305,3546,2634,4209,13211
2023-09-08,15,3701,1364,2244,1965,5058,14332
2023-09-09,15,3976,2772,2230,4487,2218,15683
2023-09-10,15,2860,1851,1434,3745,2408,12298
2023-09-11,15,1066,1852,2172,2201,5423,12714
2023-09-12,15,3157,2505,2189,1732,2343,11926
2023-09-13,15,2171,2678,1922,2087,2727,11585
2023-09-14,15,2287,2848,3832,4391,3596,16954
2023-09-15,15,3186,2878,2432,4144,2425,15065
2023-09-16,15,2597,2166,2075,1517,2391,10746
2023-09-17,15,3772,2259,1404,4068,4599,16102
2023-09-18,15,1043,2320,3801,3726,4421,15311
2023-09-19,15,3436,2501,1286,3229,5419,15871
2023-09-20,15,4187,2849,2822,3262,2482,15602
2023-09-21,15,1378,1283,1555,2250,4825,11291
2023-09-22,15,2222,1949,2004,4203,2765,13143
2023-09-23,15,3820,1512,1350,1875,5114,13671
2023-09-24,15,4594,1347,1200,2712,2621,12474
2023-09-25,15,3106,1327,3607,2393,3408,13841
2023-09-26,15,4200,2112,1875,4192,3166,15545
2023-09-27,15,1449,2435,2598,4019,4766,15267
2023-09-28,15,2178,1814,2645,2969,5692,15298
2023-09-29,15,1125,1796,3781,4024,4383,15109
2023-09-30,15,4293,1941,2019,2250,3760,14263
2023-10-01,15,3997,1994,3833,2097,4739,16660
2023-10-02,15,4041,887,1731,3215,5909,15783
2023-10-03,15,3413,871,2159,3740,3037,13220
2023-10-04,15,2726,1520,1696,3128,2787,11857
2023-10-05,15,3530,1760,1974,1776,5351,14391
2023-10-06,15,4144,2231,2064,2022,3729,14190
2023-10-07,15,3732,2759,3428,2860,3781,16560
2023-10-08,15,4896,2074,3008,4014,5128,19120
2023-10-09,15,3340,1673,1557,4077,2244,12891
2023-10-10,15,4899,2657,2816,4313,2651,17336
2023-10-11,15,4163,2473,2406,3365,4151,16558
2023-10-12,15,4775,2842,1221,3665,4240,16743
2023-10-13,15,2627,2634,1322,4005,3152,13740
2023-10-14,15,1648,2485,3419,2473,3013,13038
2023-10-15,15,4861,2144,2275,2683,4858,16821
2023-10-16,15,3088,1265,2381,3493,2249,12476
2023-10-17,15,4138,1133,2286,2010,3506,13073
2023-10-18,15,3630,991,2452,2542,4240,13855
2023-10-19,15,2310,1825,1940,3064,5435,14574
2023-10-20,15,1495,2903,2295,1530,4253,12476
2023-10-21,15,1683,2506,2860,2129,5187,14365
2023-10-22,15,2734,2774,2268,2289,4088,14153
2023-10-23,15,4601,1811,3850,2441,5649,18352
2023-10-24,15,3395,2708,2476,1815,5606,16000
2023-10-25,15,2272,2343,2806,2863,5489,15773
2023-10-26,15,3227,1430,1563,3037,5276,14533
2023-10-27,15,4610,1178,1951,3615,2580,13934
2023-10-28,15,4488,2258,3589,1770,5801,17906
2023-10-29,15,2574,2473,1770,3408,3129,13354
2023-10-30,15,3482,2619,3127,2471,2447,14146
2023-10-31,15,4915,1208,1341,1568,2603,11635
2023-11-01,15,2188,1109,2118,4112,3190,12717
2023-11-02,15,4906,2288,2882,1621,4454,16151
2023-11-03,15,3372,1550,3945,4073,5968,18908
2023-11-04,15,4872,1208,3940,3081,4663,17764
2023-11-05,15,4805,1771,2656,3697,5843,18772
2023-11-06,15,1279,1993,2312,3402,3155,12141
2023-11-07,15,2001,1585,3699,2743,5139,15167
2023-11-08,15,3184,1236,1288,4124,3373,13205
2023-11-09,15,3188,2096,2915,3375,3400,14974
2023-11-10,15,1701,1626,3806,4361,4171,15665
2023-11-11,15,3322,2414,3973,3045,5208,17962
2023-11-12,15,3975,1417,2733,3466,5675,17266
2023-11-13,15,3357,1788,2216,3642,5502,16505
2023-11-14,15,4549,2051,3648,4052,2307,16607
2023-11-15,15,1728,2000,1316,3934,2415,11393
2023-11-16,15,2020,1361,1392,2364,3796,10933
2023-11-17,15,1740,1294,2159,3442,4483,13118
2023-11-18,15,2659,1848,2607,2181,5057,14352
2023-11-19,15,1637,2593,1512,3700,4949,14391
2023-11-20,15,4235,1222,3855,1809,5532,16653
2023-11-21,15,3600,1457,1805,2941,4974,14777
2023-11-22,15,3643,1960,2007,2211,5069,14890
2023-11-23,15,4162,2875,2706,2686,2490,14919
2023-11-24,15,2441,1157,3483,4268,3372,14721
2023-11-25,15,2634,1754,2501,2590,4766,14245
2023-11-26,15,3929,2321,2733,3095,5682,17760
2023-11-27,15,2289,2599,3932,2539,3070,14429
2023-11-28,15,3457,2886,2391,2287,4388,15409
2023-11-29,15,2730,1727,3734,4114,4433,16738
2023-11-30,15,3321,2952,3900,2146,5993,18312
2023-12-01,15,3699,1583,3011,2812,4593,15698
2023-12-02,15,2430,2956,2647,2154,2298,12485
2023-12-03,15,4311,1516,3340,3506,4546,17219
2023-12-04,15,3113,2729,1545,4327,2031,13745
2023-12-05,15,1999,1590,1621,2057,5413,12680
2023-12-06,15,1208,1677,1255,3142,5753,13035
2023-12-07,15,3740,1522,3393,3190,4831,16676
2023-12-08,15,3401,2785,3166,2971,3030,15353
2023-12-09,15,1258,1563,3998,2357,2537,11713
2023-12-10,15,2811,1959,1632,2054,5036,13492
2023-12-11,15,3610,1652,3570,2942,4404,16178
2023-12-12,15,1594,1171,1307,2429,5436,11937
2023-12-13,15,2336,2944,2699,1817,4833,14629
2023-12-14,15,2153,2913,2005,1769,5263,14103
2023-12-15,15,3695,2396,2483,3754,3951,16279
2023-12-16,15,1131,2072,1792,2753,5323,13071
2023-12-17,15,3144,2477,3015,2392,5193,16221
2023-12-18,15,1168,2423,2106,3056,2161,10914
2023-12-19,15,2683,2230,2039,2717,4499,14168
2023-12-20,15,4788,2468,3575,4208,3898,18937
2023-12-21,15,1001,2285,1580,4284,5747,14897
2023-12-22,15,4625,2211,2768,2141,3067,14812
2023-12-23,15,2753,2325,2989,2756,5791,16614
2023-12-24,15,2202,850,3081,1972,5595,13700
2023-12-25,15,2879,1212,3100,3258,3652,14101
2023-12-26,15,3928,2720,2456,3962,2514,15580
2023-12-27,15,3240,2064,2806,3377,4422,15909
2023-12-28,15,1649,2610,2621,2586,5458,14924
2023-12-29,15,4056,1849,3222,3201,5155,17483
2023-12-30,15,4246,1976,1204,4195,2718,14339
2023-12-31,15,4068,1168,3861,3516,2017,14630
2022-01-01,16,4780,1052,1436,1715,2229,11212
2022-01-02,16,2890,2159,2969,4100,4790,16908
2022-01-03,16,2601,993,1825,4418,3569,13406
2022-01-04,16,4821,2610,3755,2719,3720,17625
2022-01-05,16,1525,1285,2136,2292,2507,9745
2022-01-06,16,2235,1963,3955,3238,2294,13685
2022-01-07,16,3654,2573,1521,3358,3800,14906
2022-01-08,16,2138,1183,1801,3343,5828,14293
2022-01-09,16,3535,1887,2326,2040,5849,15637
2022-01-10,16,4234,1771,1502,1844,2116,11467
2022-01-11,16,2963,1246,1438,2742,4047,12436
2022-01-12,16,2420,2740,2001,2732,4608,14501
2022-01-13,16,3267,1001,2795,4311,3734,15108
2022-01-14,16,1795,2999,3212,4372,2992,15370
2022-01-15,16,3738,2324,1932,2329,5527,15850
2022-01-16,16,3768,1723,2670,1895,4176,14232
2022-01-17,16,4664,2892,1341,3413,2669,14979
2022-01-18,16,3553,1173,2448,1883,2317,11374
2022-01-19,16,3399,2276,3895,3963,4779,18312
2022-01-20,16,3574,1629,2351,3428,2506,13488
2022-01-21,16,2073,2936,3396,2456,2143,13004
2022-01-22,16,3609,2370,3876,4156,2090,16101
2022-01-23,16,4877,2482,1206,2488,4476,15529
2022-01-24,16,2660,2619,3182,2841,4126,15428
2022-01-25,16,2669,1867,1775,3424,5230,14965
2022-01-26,16,3849,1167,1661,2347,5201,14225
2022-01-27,16,4869,1026,2037,3146,4346,15424
2022-01-28,16,1152,2624,1811,3008,2279,10874
2022-01-29,16,1899,1627,2397,2406,4024,12353
2022-01-30,16,2443,1127,3244,1524,5224,13562
2022-01-31,16,2527,941,3702,2931,3759,13860
2022-02-01,16,3691,1285,3658,3044,4011,15689
2022-02-02,16,1881,2455,2613,4309,4343,15601
2022-02-03,16,1673,853,3747,3812,2029,12114
2022-02-04,16,2471,1471,2322,3770,4672,14706
2022-02-05,16,2699,885,1263,2815,5485,13147
2022-02-06,16,2665,1463,3680,3485,4442,15735
2022-02-07,16,4212,1177,2963,4387,5890,18629
2022-02-08,16,4963,1964,3207,3317,2942,16393
2022-02-09,16,4683,2044,3632,2668,4447,17474
2022-02-10,16,1308,1983,3942,3361,2341,12935
2022-02-11,16,3226,2212,2507,2582,4352,14879
2022-02-12,16,4851,1442,2677,2181,3215,14366
2022-02-13,16,4336,1207,2742,1933,5552,15770
2022-02-14,16,2358,1681,3584,2610,2138,12371
2022-02-15,16,2988,2301,1243,4167,2565,13264
2022-02-16,16,3633,1588,1610,4265,5126,16222
2022-02-17,16,1225,2212,3812,3500,3615,14364
2022-02-18,16,3401,809,2133,3180,4586,14109
2022-02-19,16,1203,2605,2213,4447,2122,12590
2022-02-20,16,3831,2617,2889,4439,4243,18019
2022-02-21,16,1998,1616,2022,2231,3280,11147
2022-02-22,16,3046,1585,2431,4119,4085,15266
2022-02-23,16,1234,2618,2464,2402,5600,14318
2022-02-24,16,3477,1251,3162,1911,5769,15570
2022-02-25,16,2573,2233,2176,2437,2695,12114
2022-02-26,16,4212,2168,3618,4038,5989,20025
2022-02-27,16,3413,995,2023,2617,3442,12490
2022-02-28,16,4471,2957,3674,3498,3438,18038
2022-03-01,16,2120,2231,2662,3792,2027,12832
2022-03-02,16,1132,2181,1592,3835,5958,14698
2022-03-03,16,2971,2595,1921,4063,3137,14687
2022-03-04,16,4351,966,1570,1839,5224,13950
2022-03-05,16,3060,1323,3219,4423,3321,15346
2022-03-06,16,2263,2709,1818,4216,5193,16199
2022-03-07,16,4576,2634,1797,3088,2942,15037
2022-03-08,16,4257,2270,2319,2121,5291,16258
2022-03-09,16,2075,2896,3746,2977,2215,13909
2022-03-10,16,3100,1713,2444,3972,4777,16006
2022-03-11,16,3358,2132,2260,4482,2099,14331
2022-03-12,16,1769,1629,3128,3845,4984,15355
2022-03-13,16,4696,1590,1395,3032,3710,14423
2022-03-14,16,4030,2764,3582,1548,4137,16061
2022-03-15,16,3151,1042,1961,4069,2315,12538
2022-03-16,16,2511,2301,2619,3704,4106,15241
2022-03-17,16,3295,943,1221,2448,5164,13071
2022-03-18,16,1266,2405,3191,2662,3396,12920
2022-03-19,16,4269,1097,2987,4256,4352,16961
2022-03-20,16,4477,2084,1641,3607,4073,15882
2022-03-21,16,1798,971,2800,2974,3050,11593
2022-03-22,16,4136,2252,3217,3046,3605,16256
2022-03-23,16,2145,1833,3460,2930,3742,14110
2022-03-24,16,2765,1297,1913,2778,3123,11876
2022-03-25,16,1112,1219,1579,4269,4738,12917
2022-03-26,16,4146,1647,2575,1814,4752,14934
2022-03-27,16,3178,2023,3293,1681,5970,16145
2022-03-28,16,1092,1807,3921,1902,2217,10939
2022-03-29,16,2924,2377,2217,3395,5528,16441
2022-03-30,16,2950,2903,2870,4360,4862,17945
2022-03-31,16,3102,1891,1498,2673,2160,11324
2022-04-01,16,1548,2371,1952,1863,4305,12039
2022-04-02,16,2859,2665,3550,3896,2670,15640
2022-04-03,16,3189,1869,1938,2419,4074,13489
2022-04-04,16,1809,1072,3766,3590,5161,15398
2022-04-05,16,1872,1569,2596,1827,3010,10874
2022-04-06,16,3052,2743,1754,3328,5131,16008
2022-04-07,16,1573,1782,1297,3903,2851,11406
2022-04-08,16,4607,1644,2938,2366,3255,14810
2022-04-09,16,1785,1384,2069,1903,2112,9253
2022-04-10,16,1189,2271,2703,2048,2542,10753
2022-04-11,16,4983,1884,2371,3768,3985,16991
2022-04-12,16,2418,1535,2712,4415,3208,14288
2022-04-13,16,3085,809,1800,4062,2646,12402
2022-04-14,16,2766,2350,2595,1936,2419,12066
2022-04-15,16,4136,2845,1607,2209,5161,15958
2022-04-16,16,4845,2532,3591,2536,4707,18211
2022-04-17,16,3210,1786,3194,2770,3637,14597
2022-04-18,16,1690,2850,1313,2505,4212,12570
2022-04-19,16,1847,1078,3472,3320,2131,11848
2022-04-20,16,2539,1771,2457,2716,2408,11891
2022-04-21,16,3523,1926,1595,3223,5225,15492
2022-04-22,16,4973,1778,2429,3752,4122,17054
2022-04-23,16,2376,1666,1739,2634,4165,12580
2022-04-24,16,1447,884,3982,4014,2851,13178
2022-04-25,16,1408,1738,3964,2188,3970,13268
2022-04-26,16,3812,1330,3924,3405,4721,17192
2022-04-27,16,4196,2182,3284,1615,3954,15231
2022-04-28,16,4583,1471,1702,2022,4653,14431
2022-04-29,16,4443,2943,1403,2844,2961,14594
2022-04-30,16,2598,1053,2722,3051,2409,11833
2022-05-01,16,2614,2567,3636,3940,2789,15546
2022-05-02,16,2060,1749,3834,3318,2694,13655
2022-05-03,16,2085,2406,3406,3209,4117,15223
2022-05-04,16,3105,2315,1848,2382,5156,14806
2022-05-05,16,2471,2769,2655,3066,2961,13922
2022-05-06,16,2564,2693,3883,2591,4558,16289
2022-05-07,16,2426,846,2062,3703,4298,13335
2022-05-08,16,4834,2018,1839,2486,4221,15398
2022-05-09,16,3710,2190,3781,3340,3605,16626
2022-05-10,16,4982,1411,2885,4129,4624,18031
2022-05-11,16,4280,1986,2903,4270,3118,16557
2022-05-12,16,3148,2305,2228,1723,4657,14061
2022-05-13,16,4087,2393,2743,1874,5003,16100
2022-05-14,16,3671,2298,2532,2155,3167,13823
2022-05-15,16,4847,1955,2975,2612,3197,15586
2022-05-16,16,4520,2830,3016,3170,2028,15564
2022-05-17,16,4258,1834,3666,2616,3737,16111
2022-05-18,16,4499,1445,1329,3625,2388,13286
2022-05-19,16,4867,2401,1897,1524,5331,16020
2022-05-20,16,1994,1946,1236,2112,3162,10450
2022-05-21,16,4129,1761,2370,3931,4249,16440
2022-05-22,16,3658,2965,3648,2079,2679,15029
2022-05-23,16,1548,1677,1444,3423,4162,12254
2022-05-24,16,3449,1820,1936,3464,2830,13499
2022-05-25,16,3126,2945,3403,3158,4402,17034
2022-05-26,16,4920,2278,1792,2545,4482,16017
2022-05-27,16,1917,2152,1628,1506,5053,12256
2022-05-28,16,1018,2708,2178,1596,4521,12021
2022-05-29,16,1122,1495,2267,2671,5652,13207
2022-05-30,16,1624,1807,1965,2820,5778,13994
2022-05-31,16,2072,2366,2500,2618,3117,12673
2022-06-01,16,2239,2720,1401,2869,3346,12575
2022-06-02,16,4159,1418,3282,1609,4546,15014
2022-06-03,16,3006,2693,2648,3072,4709,16128
2022-06-04,16,2752,2951,1559,2057,3463,12782
2022-06-05,16,3294,2459,2759,3603,4930,17045
2022-06-06,16,1086,2144,1569,3068,4142,12009
2022-06-07,16,3612,2843,2516,2683,2473,14127
2022-06-08,16,2022,2238,2246,4340,5357,16203
2022-06-09,16,4413,1851,3108,3691,4070,17133
2022-06-10,16,1829,1295,3872,2568,4535,14099
2022-06-11,16,1682,1209,3586,3473,4622,14572
2022-06-12,16,1958,2269,2642,3605,3561,14035
2022-06-13,16,4763,1868,3818,2440,3346,16235
2022-06-14,16,4590,2996,1361,3722,4521,17190
2022-06-15,16,4634,2410,1500,2992,5656,17192
2022-06-16,16,2762,1243,2830,3100,3782,13717
2022-06-17,16,2891,1022,2953,2195,3710,12771
2022-06-18,16,2481,887,1254,2562,3507,10691
2022-06-19,16,4659,1216,3716,4026,5700,19317
2022-06-20,16,1868,1475,3384,2094,3003,11824
2022-06-21,16,1434,2863,3596,3762,3839,15494
2022-06-22,16,2222,2750,2567,3415,5834,16788
2022-06-23,16,4347,1002,3393,2299,5596,16637
2022-06-24,16,1299,1919,1985,3032,4876,13111
2022-06-25,16,3367,2679,1645,3008,5696,16395
2022-06-26,16,4512,2924,3974,3929,4838,20177
2022-06-27,16,4033,2096,1510,3067,4689,15395
2022-06-28,16,4960,1663,3180,2306,2424,14533
2022-06-29,16,4827,2082,1935,2436,2914,14194
2022-06-30,16,1367,1942,1605,3517,5901,14332
2022-07-01,16,3680,1892,1482,3414,3137,13605
2022-07-02,16,2789,2215,2120,1645,4689,13458
2022-07-03,16,2596,2361,3680,4330,2506,15473
2022-07-04,16,4557,2957,2812,2012,5968,18306
2022-07-05,16,2307,2152,2905,2037,4259,13660
2022-07-06,16,4096,2831,3685,1753,4940,17305
2022-07-07,16,4382,2303,2883,3516,3568,16652
2022-07-08,16,4466,1912,2970,1878,3442,14668
2022-07-09,16,2855,2838,3080,2885,2473,14131
2022-07-10,16,2545,1798,2803,2949,2558,12653
2022-07-11,16,3590,1271,3560,3129,2192,13742
2022-07-12,16,1958,1646,3006,4339,3789,14738
2022-07-13,16,1582,1364,3703,1683,2518,10850
2022-07-14,16,2184,2759,1726,2713,4853,14235
2022-07-15,16,3542,2309,1745,2006,2384,11986
2022-07-16,16,4577,2528,3182,4103,2283,16673
2022-07-17,16,3313,1704,3974,3913,5145,18049
2022-07-18,16,4066,2616,3152,4028,3756,17618
2022-07-19,16,2938,872,1377,3462,4944,13593
2022-07-20,16,2474,1077,2292,3723,5256,14822
2022-07-21,16,3125,1590,1900,2207,4440,13262
2022-07-22,16,4885,2843,2200,3079,4440,17447
2022-07-23,16,1365,2720,2735,2284,5082,14186
2022-07-24,16,2627,925,3166,3394,2715,12827
2022-07-25,16,2586,2660,3793,1861,5565,16465
2022-07-26,16,4657,2430,2401,1531,5194,16213
2022-07-27,16,3871,1551,3902,2801,4396,16521
2022-07-28,16,2514,2946,1313,3293,2402,12468
2022-07-29,16,4113,863,3020,4215,4357,16568
2022-07-30,16,4762,1081,1590,3004,4077,14514
2022-07-31,16,1515,1314,1960,3883,2822,11494
2022-08-01,16,2901,2177,3716,4108,3493,16395
2022-08-02,16,3476,2337,1559,3396,2002,12770
2022-08-03,16,3029,954,1677,4068,5527,15255
2022-08-04,16,4807,1033,3350,1934,5617,16741
2022-08-05,16,3189,1443,2594,2510,5760,15496
2022-08-06,16,3719,1249,2849,2831,3318,13966
2022-08-07,16,2558,2474,2951,1603,5561,15147
2022-08-08,16,3474,1848,3809,2819,5937,17887
2022-08-09,16,2167,2663,2302,3773,4690,15595
2022-08-10,16,4381,844,3818,3075,4931,17049
2022-08-11,16,2264,1385,2384,3947,3123,13103
2022-08-12,16,4021,2357,3469,3529,5597,18973
2022-08-13,16,3636,2276,3373,1550,4041,14876
2022-08-14,16,3311,2405,1553,4167,5747,17183
2022-08-15,16,4123,1253,1662,3946,5716,16700
2022-08-16,16,2156,887,1854,2581,5699,13177
2022-08-17,16,3542,1073,2730,3359,5566,16270
2022-08-18,16,3196,2276,1873,3210,5706,16261
2022-08-19,16,4353,2084,3454,1915,5385,17191
2022-08-20,16,2270,1646,1465,3368,2450,11199
2022-08-21,16,3937,977,1300,3263,4562,14039
2022-08-22,16,3559,2439,3442,3700,4059,17199
2022-08-23,16,1508,1103,1535,2484,2294,8924
2022-08-24,16,2223,1427,2691,2829,3187,12357
2022-08-25,16,3299,2492,1888,3183,3454,14316
2022-08-26,16,1310,1397,3295,4091,3978,14071
2022-08-27,16,3164,1427,1606,3939,4371,14507
2022-08-28,16,3480,903,3421,4423,5315,17542
2022-08-29,16,1525,2111,1493,4205,4000,13334
2022-08-30,16,3126,2981,1862,3585,4678,16232
2022-08-31,16,1003,2134,2731,3738,5468,15074
2022-09-01,16,1457,889,3085,3057,4917,13405
2022-09-02,16,2508,2751,1529,2336,5009,14133
2022-09-03,16,3219,1158,1891,3458,3433,13159
2022-09-04,16,3277,2786,2585,4127,4530,17305
2022-09-05,16,1944,863,2374,2296,5469,12946
2022-09-06,16,2968,2403,3428,2773,2139,13711
2022-09-07,16,2119,2589,2815,3708,3411,14642
2022-09-08,16,1138,2257,3240,3249,3332,13216
2022-09-09,16,4432,1065,1796,4431,5382,17106
2022-09-10,16,4700,1926,3854,3113,5886,19479
2022-09-11,16,4545,2043,1235,2155,5989,15967
2022-09-12,16,2602,2378,2778,2452,4659,14869
2022-09-13,16,3045,2774,2002,4420,4436,16677
2022-09-14,16,3806,2963,3846,4023,4430,19068
2022-09-15,16,2881,2491,3105,1521,5036,15034
2022-09-16,16,4763,2418,3095,4272,2586,17134
2022-09-17,16,3885,2439,1899,1544,3822,13589
2022-09-18,16,2208,1273,1273,1619,4469,10842
2022-09-19,16,4384,1629,2872,4180,4351,17416
2022-09-20,16,3823,2913,1219,2541,2871,13367
2022-09-21,16,1498,1062,1927,3239,5039,12765
2022-09-22,16,3967,1454,3751,2355,5695,17222
2022-09-23,16,1980,2031,1221,3006,4298,12536
2022-09-24,16,4637,1098,1457,1632,3573,12397
2022-09-25,16,1680,2693,3977,4054,3849,16253
2022-09-26,16,3733,2799,3146,3677,3702,17057
2022-09-27,16,3216,1072,1378,2858,3372,11896
2022-09-28,16,3350,2332,3068,2935,2772,14457
2022-09-29,16,4261,944,3906,1997,2035,13143
2022-09-30,16,2386,2396,3269,3984,4387,16422
2022-10-01,16,2907,2352,2925,2469,3963,14616
2022-10-02,16,4394,2374,3840,2795,2299,15702
2022-10-03,16,4642,1872,3786,3773,3274,17347
2022-10-04,16,1320,1893,1261,3149,5192,12815
2022-10-05,16,2177,1649,3740,4289,2686,14541
2022-10-06,16,1375,1566,3011,4463,4594,15009
2022-10-07,16,4068,2167,2838,2652,2426,14151
2022-10-08,16,1823,878,3099,2725,5929,14454
2022-10-09,16,4698,1525,1874,1818,5902,15817
2022-10-10,16,4240,2104,3786,1504,3570,15204
2022-10-11,16,4168,2249,2100,4329,5986,18832
2022-10-12,16,3535,2480,1696,2587,2628,12926
2022-10-13,16,1776,2218,2311,1956,2969,11230
2022-10-14,16,4513,964,1328,1552,5290,13647
2022-10-15,16,1755,2997,3333,4083,2596,14764
2022-10-16,16,4633,2148,3287,2064,4108,16240
2022-10-17,16,4491,1562,3917,3845,5513,19328
2022-10-18,16,4208,2313,1952,2117,4434,15024
2022-10-19,16,3352,1090,2562,1749,3033,11786
2022-10-20,16,1494,1107,3680,3510,2438,12229
2022-10-21,16,2315,1757,2929,1945,3647,12593
2022-10-22,16,2557,1135,1823,1808,4244,11567
2022-10-23,16,4736,1741,3589,3792,2322,16180
2022-10-24,16,2319,839,2368,1795,4081,11402
2022-10-25,16,3442,994,3698,2043,4028,14205
2022-10-26,16,3779,2764,1274,3501,4477,15795
2022-10-27,16,3410,2139,1715,2933,5765,15962
2022-10-28,16,3427,2601,3283,1886,5868,17065
2022-10-29,16,2147,1988,3183,2512,4856,14686
2022-10-30,16,2396,2067,2460,3391,3365,13679
2022-10-31,16,3467,2381,1454,1520,3548,12370
2022-11-01,16,2660,2919,2085,2563,5378,15605
2022-11-02,16,3502,1667,2465,1723,3951,13308
2022-11-03,16,4527,2734,2634,2927,2800,15622
2022-11-04,16,4289,2838,3703,3424,5476,19730
2022-11-05,16,3169,2760,2971,2200,4133,15233
2022-11-06,16,4638,2951,1531,3873,5332,18325
2022-11-07,16,2475,1337,3356,2671,4271,14110
2022-11-08,16,2646,1582,1405,2484,2031,10148
2022-11-09,16,3899,2448,3663,3318,2979,16307
2022-11-10,16,2748,2862,3399,2487,2260,13756
2022-11-11,16,4188,1307,2832,3683,4584,16594
2022-11-12,16,1775,2349,1466,1821,5916,13327
2022-11-13,16,1349,1424,2439,3965,4146,13323
2022-11-14,16,2844,813,1746,3514,2134,11051
2022-11-15,16,2809,1764,3646,3929,3471,15619
2022-11-16,16,3112,2385,1374,1518,2740,11129
2022-11-17,16,3183,1823,2861,1971,3260,13098
2022-11-18,16,3099,2966,1577,3683,5395,16720
2022-11-19,16,3760,2552,3842,3509,2817,16480
2022-11-20,16,4492,1302,3641,3767,2786,15988
2022-11-21,16,2539,2978,3756,3393,5908,18574
2022-11-22,16,1897,2208,2284,2940,2379,11708
2022-11-23,16,1495,2564,1375,1501,2256,9191
2022-11-24,16,3944,2592,3113,4113,4311,18073
2022-11-25,16,2744,2843,1221,2972,4511,14291
2022-11-26,16,3996,2773,3954,4193,5762,20678
2022-11-27,16,3969,2926,2146,4100,5154,18295
2022-11-28,16,4859,1024,1677,2315,2225,12100
2022-11-29,16,3830,2684,3503,4279,3154,17450
2022-11-30,16,2836,1303,2540,4496,2833,14008
2022-12-01,16,2356,1941,2877,2923,4840,14937
2022-12-02,16,2977,1834,1817,4229,4275,15132
2022-12-03,16,3877,2265,2648,3187,3122,15099
2022-12-04,16,4108,933,2695,3371,2314,13421
2022-12-05,16,4595,1984,3332,2859,4080,16850
2022-12-06,16,2822,1108,1957,2671,5067,13625
2022-12-07,16,1402,1143,3721,3238,4256,13760
2022-12-08,16,4731,1899,1245,1684,4071,13630
2022-12-09,16,4345,1313,1215,4432,3323,14628
2022-12-10,16,4555,2910,1798,1823,5598,16684
2022-12-11,16,1571,1613,1564,2871,3457,11076
2022-12-12,16,1710,1159,3042,2556,2413,10880
2022-12-13,16,4476,2584,1500,1950,5622,16132
2022-12-14,16,3583,1733,3699,1903,4314,15232
2022-12-15,16,1143,2400,2697,3878,2383,12501
2022-12-16,16,3986,2906,1954,4116,3259,16221
2022-12-17,16,3533,1374,2875,2489,4764,15035
2022-12-18,16,2927,2503,3350,3576,5341,17697
2022-12-19,16,3206,2657,1950,4065,3130,15008
2022-12-20,16,2945,1786,3932,2448,2605,13716
2022-12-21,16,1615,1479,3662,3253,5809,15818
2022-12-22,16,4042,1811,1718,1828,3494,12893
2022-12-23,16,2389,2192,2790,3561,2589,13521
2022-12-24,16,3220,2130,1912,1678,5076,14016
2022-12-25,16,3136,1555,3596,1684,4468,14439
2022-12-26,16,4486,2685,3160,2703,5325,18359
2022-12-27,16,4858,1830,1328,4165,3360,15541
2022-12-28,16,3851,1435,1517,2178,2860,11841
2022-12-29,16,1284,986,1374,2343,3017,9004
2022-12-30,16,4908,2617,1651,3333,4315,16824
2022-12-31,16,2666,1853,1560,3509,5921,15509
2023-01-01,16,4904,1559,2905,2028,4785,16181
2023-01-02,16,2302,1876,3625,4303,4314,16420
2023-01-03,16,2121,966,2829,2114,3583,11613
2023-01-04,16,1180,2868,1935,3050,5899,14932
2023-01-05,16,1588,1209,2277,1912,3426,10412
2023-01-06,16,3662,2745,1273,3776,3257,14713
2023-01-07,16,1288,2906,1349,3608,2941,12092
2023-01-08,16,4787,1462,2903,4412,2610,16174
2023-01-09,16,3366,2176,1817,2709,2985,13053
2023-01-10,16,1487,1685,3889,3764,2310,13135
2023-01-11,16,4737,1622,1589,1777,4693,14418
2023-01-12,16,1023,1538,2538,3159,4889,13147
2023-01-13,16,4978,1320,1649,3389,5289,16625
2023-01-14,16,3293,999,3188,2417,2070,11967
2023-01-15,16,3583,1430,2748,1739,5413,14913
2023-01-16,16,4074,2462,2532,2993,2736,14797
2023-01-17,16,1009,1929,2842,2134,3226,11140
2023-01-18,16,3217,1609,1744,2782,4571,13923
2023-01-19,16,1615,2342,1262,4377,2714,12310
2023-01-20,16,1120,1426,1600,3350,4458,11954
2023-01-21,16,4748,1423,3408,3355,2985,15919
2023-01-22,16,4179,1890,3840,4407,3229,17545
2023-01-23,16,2421,2860,2773,2091,5913,16058
2023-01-24,16,3803,836,1545,2349,2154,10687
2023-01-25,16,2889,2851,3551,2561,3945,15797
2023-01-26,16,3433,1485,1863,1701,5355,13837
2023-01-27,16,1344,1330,2189,3909,2097,10869
2023-01-28,16,2714,1005,1515,3466,3001,11701
2023-01-29,16,3523,1913,1280,3300,3596,13612
2023-01-30,16,4350,1639,1259,3629,2363,13240
2023-01-31,16,1525,1866,2364,4290,2296,12341
2023-02-01,16,3911,1087,2365,4101,4071,15535
2023-02-02,16,4208,1418,1292,2299,4073,13290
2023-02-03,16,2020,2484,3825,2786,2358,13473
2023-02-04,16,1940,875,3848,1610,2320,10593
2023-02-05,16,3528,1798,3425,2572,3971,15294
2023-02-06,16,3503,1137,2680,3379,2446,13145
2023-02-07,16,3277,2546,3897,3480,2448,15648
2023-02-08,16,4840,2999,1714,2802,3475,15830
2023-02-09,16,1705,1455,3541,1867,2650,11218
2023-02-10,16,1053,2084,1936,2588,4098,11759
2023-02-11,16,3374,2847,2272,3051,5784,17328
2023-02-12,16,2359,1625,3697,4319,5632,17632
2023-02-13,16,2880,2045,3064,1953,5681,15623
2023-02-14,16,1113,1615,1527,4235,4280,12770
2023-02-15,16,3151,2947,1288,4473,4845,16704
2023-02-16,16,3550,2744,1758,1623,4674,14349
2023-02-17,16,4244,2720,1713,2858,5537,17072
2023-02-18,16,2141,1003,1445,1665,5305,11559
2023-02-19,16,3997,824,3045,3144,3298,14308
2023-02-20,16,2694,1045,3897,2784,2468,12888
2023-02-21,16,2628,2887,3850,3297,3026,15688
2023-02-22,16,4870,1029,2135,3698,5376,17108
2023-02-23,16,3662,2913,3477,2846,3743,16641
2023-02-24,16,2004,2454,2523,2961,2800,12742
2023-02-25,16,4085,2406,3432,2477,3289,15689
2023-02-26,16,1456,2261,3955,4069,5003,16744
2023-02-27,16,4134,1269,3056,1765,4284,14508
2023-02-28,16,2939,2639,2978,2492,2414,13462
2023-03-01,16,1438,2271,2360,1650,5098,12817
2023-03-02,16,3582,2762,2661,1950,2337,13292
2023-03-03,16,3321,1171,2590,4261,3549,14892
2023-03-04,16,4001,1059,1597,3876,2128,12661
2023-03-05,16,1629,2536,1401,3686,5147,14399
2023-03-06,16,2061,1750,3591,2220,3036,12658
2023-03-07,16,3543,1584,3274,2059,3861,14321
2023-03-08,16,1713,1217,2540,3731,4303,13504
2023-03-09,16,3301,944,3911,2835,3293,14284
2023-03-10,16,1110,1944,2539,2147,2432,10172
2023-03-11,16,1852,2608,3307,3910,4318,15995
2023-03-12,16,2573,2076,3052,2113,4742,14556
2023-03-13,16,3674,2213,2594,1767,3223,13471
2023-03-14,16,4400,1945,1203,2504,5369,15421
2023-03-15,16,3608,1120,1737,2900,5014,14379
2023-03-16,16,1085,2106,3367,1558,4129,12245
2023-03-17,16,2622,1735,1726,2316,5006,13405
2023-03-18,16,4327,2289,1245,4437,5964,18262
2023-03-19,16,1539,2157,1425,2974,2996,11091
2023-03-20,16,3493,2600,1850,2790,2972,13705
2023-03-21,16,2795,1144,3240,3041,3367,13587
2023-03-22,16,1325,1648,3125,2824,5969,14891
2023-03-23,16,1044,2374,2945,4102,5869,16334
2023-03-24,16,4744,1632,3411,3152,3767,16706
2023-03-25,16,3562,1565,2905,3795,3786,15613
2023-03-26,16,4147,1691,2851,2284,5641,16614
2023-03-27,16,1901,1939,3571,3749,5232,16392
2023-03-28,16,1882,2142,1280,3162,4726,13192
2023-03-29,16,4025,2360,2099,2662,5465,16611
2023-03-30,16,4352,2478,1200,2200,4002,14232
2023-03-31,16,2146,1955,1797,4277,5160,15335
2023-04-01,16,2616,1508,3050,4384,4885,16443
2023-04-02,16,1893,811,3227,3208,5516,14655
2023-04-03,16,4742,1734,3367,2899,2381,15123
2023-04-04,16,1820,997,3477,2229,2109,10632
2023-04-05,16,3700,2790,1868,1789,3643,13790
2023-04-06,16,3164,1924,2901,1752,2747,12488
2023-04-07,16,2494,1273,1579,3088,3969,12403
2023-04-08,16,3050,2515,2729,3040,4040,15374
2023-04-09,16,4855,2065,1964,3049,3882,15815
2023-04-10,16,1268,2638,1727,2983,2103,10719
2023-04-11,16,3563,1724,1279,3556,3824,13946
2023-04-12,16,3879,1565,3044,3981,5510,17979
2023-04-13,16,3767,1029,2827,2783,4793,15199
2023-04-14,16,1318,1483,2481,3704,5993,14979
2023-04-15,16,4590,1046,1510,4263,2747,14156
2023-04-16,16,1464,2794,2645,4120,3427,14450
2023-04-17,16,1143,1852,3764,3564,2147,12470
2023-04-18,16,3251,2464,2393,3546,5921,17575
2023-04-19,16,2061,2004,2958,2848,3260,13131
2023-04-20,16,4173,2128,2007,3745,3871,15924
2023-04-21,16,1815,2793,2285,3956,2539,13388
2023-04-22,16,4714,2740,3511,3700,5074,19739
2023-04-23,16,3475,2144,2577,1999,3686,13881
2023-04-24,16,4242,2475,3309,2368,2177,14571
2023-04-25,16,1504,2243,3754,2893,2645,13039
2023-04-26,16,2455,2789,3991,3887,3354,16476
2023-04-27,16,4468,2401,2249,2784,4834,16736
2023-04-28,16,3081,2008,3541,2081,3167,13878
2023-04-29,16,1729,1419,2984,2793,3907,12832
2023-04-30,16,4378,1515,1814,3164,3343,14214
2023-05-01,16,2806,949,1792,2095,3841,11483
2023-05-02,16,4056,1378,1844,2458,3904,13640
2023-05-03,16,2468,2745,2764,4256,3874,16107
2023-05-04,16,1699,2658,2746,3663,2850,13616
2023-05-05,16,1956,1013,1750,2671,3593,10983
2023-05-06,16,1387,2181,1622,3710,4443,13343
2023-05-07,16,4317,1174,3045,2261,3012,13809
2023-05-08,16,2068,2534,3883,2460,4871,15816
2023-05-09,16,4314,969,3041,4444,2736,15504
2023-05-10,16,2106,1795,3330,3207,3215,13653
2023-05-11,16,1117,2846,2522,2523,4764,13772
2023-05-12,16,1026,1358,3565,3449,5004,14402
2023-05-13,16,2073,2621,1202,3598,4930,14424
2023-05-14,16,1563,963,3187,1607,3928,11248
2023-05-15,16,2718,1585,2984,4111,5784,17182
2023-05-16,16,2122,1706,3883,4041,2091,13843
2023-05-17,16,1416,2020,1877,4096,5698,15107
2023-05-18,16,4997,1161,2749,3776,5143,17826
2023-05-19,16,2298,1703,1634,2065,4987,12687
2023-05-20,16,1147,2169,1950,4107,4561,13934
2023-05-21,16,2923,2044,3001,3306,2546,13820
2023-05-22,16,4612,1758,3884,2791,4408,17453
2023-05-23,16,4915,2689,3250,1607,2799,15260
2023-05-24,16,4965,2945,3008,2084,2068,15070
2023-05-25,16,3693,1698,1313,3405,4102,14211
2023-05-26,16,1460,1476,1569,3768,2073,10346
2023-05-27,16,4004,2761,3166,4459,4967,19357
2023-05-28,16,2175,1267,2737,1932,5839,13950
2023-05-29,16,2574,1903,2400,2431,4193,13501
2023-05-30,16,1495,2291,2132,4170,3804,13892
2023-05-31,16,1112,2951,1790,3752,2543,12148
2023-06-01,16,2367,962,3957,2102,5336,14724
2023-06-02,16,2008,1759,1629,3871,2311,11578
2023-06-03,16,4190,2972,2190,2724,5022,17098
2023-06-04,16,4952,894,3540,2256,5762,17404
2023-06-05,16,4864,1404,3583,3046,5988,18885
2023-06-06,16,4022,1595,3427,4272,5234,18550
2023-06-07,16,4351,2538,3781,1538,5164,17372
2023-06-08,16,2640,2863,2235,3816,5596,17150
2023-06-09,16,1846,1940,2558,4037,5082,15463
2023-06-10,16,2214,2100,3170,3513,2690,13687
2023-06-11,16,4320,1785,3091,3398,4971,17565
2023-06-12,16,2291,2635,3160,4233,2260,14579
2023-06-13,16,2975,845,1289,2857,4088,12054
2023-06-14,16,2135,1091,2291,3924,5677,15118
2023-06-15,16,1325,2851,2941,1681,2580,11378
2023-06-16,16,3153,921,2661,4046,3283,14064
2023-06-17,16,2845,2125,1463,3115,4478,14026
2023-06-18,16,3915,2705,2623,2419,4537,16199
2023-06-19,16,2277,822,2650,2673,3015,11437
2023-06-20,16,4059,1193,1745,4360,3260,14617
2023-06-21,16,1004,2905,3314,2011,4894,14128
2023-06-22,16,4966,2230,3323,3017,3814,17350
2023-06-23,16,3189,2475,2002,4252,4682,16600
2023-06-24,16,2246,1691,2294,4330,4633,15194
2023-06-25,16,3035,2250,2935,1521,3977,13718
2023-06-26,16,4795,2428,2721,4393,3804,18141
2023-06-27,16,3913,2146,3600,3039,3075,15773
2023-06-28,16,2166,2474,1501,3088,5127,14356
2023-06-29,16,4660,2309,3510,2304,2889,15672
2023-06-30,16,4412,1966,3254,1835,5213,16680
2023-07-01,16,1497,2041,2070,2351,2445,10404
2023-07-02,16,4540,1009,3185,1659,2593,12986
2023-07-03,16,4078,1178,3807,2768,3496,15327
2023-07-04,16,1834,2577,3978,1728,3714,13831
2023-07-05,16,4263,2564,3172,2850,4233,17082
2023-07-06,16,1314,2439,3782,4443,5481,17459
2023-07-07,16,3340,1122,1605,2399,5237,13703
2023-07-08,16,3152,1752,2083,2079,5946,15012
2023-07-09,16,4044,887,3253,3608,5468,17260
2023-07-10,16,4162,1712,2634,3442,3689,15639
2023-07-11,16,1571,1673,1741,3356,2941,11282
2023-07-12,16,2526,2566,3302,3065,4570,16029
2023-07-13,16,2923,1601,1614,1542,4543,12223
2023-07-14,16,4776,2764,2504,3782,3545,17371
2023-07-15,16,3045,1459,1216,2803,2518,11041
2023-07-16,16,4739,2367,3943,2038,5425,18512
2023-07-17,16,3588,971,3480,4108,3774,15921
2023-07-18,16,3160,2500,3514,3500,3019,15693
2023-07-19,16,4294,1329,2527,2282,5341,15773
2023-07-20,16,3199,1844,1241,4178,5190,15652
2023-07-21,16,2011,2645,1933,3144,2758,12491
2023-07-22,16,3836,2774,3944,3133,4977,18664
2023-07-23,16,3529,1012,2806,2352,5725,15424
2023-07-24,16,2866,2293,2555,4259,3970,15943
2023-07-25,16,4240,807,1522,1670,3362,11601
2023-07-26,16,3802,1904,2941,2348,5508,16503
2023-07-27,16,2076,2239,3127,3428,2564,13434
2023-07-28,16,2939,892,3502,3631,2531,13495
2023-07-29,16,1802,1035,1261,2846,4222,11166
2023-07-30,16,2781,1926,3984,1659,2988,13338
2023-07-31,16,4645,1326,1874,3720,2009,13574
2023-08-01,16,3955,1226,1999,3259,3664,14103
2023-08-02,16,1782,2528,3332,3254,4553,15449
2023-08-03,16,2149,1438,1654,3880,4175,13296
2023-08-04,16,1202,1030,1459,1806,3335,8832
2023-08-05,16,1793,2492,2444,1636,4384,12749
2023-08-06,16,2881,1414,1625,2490,5301,13711
2023-08-07,16,4493,958,2218,4371,3015,15055
2023-08-08,16,1157,2003,1918,3106,3679,11863
2023-08-09,16,3311,979,1332,3906,5280,14808
2023-08-10,16,1180,1798,3951,2402,4837,14168
2023-08-11,16,1561,1485,2016,2157,5027,12246
2023-08-12,16,2851,1858,2964,2161,4961,14795
2023-08-13,16,2266,2422,1363,4107,2838,12996
2023-08-14,16,1736,2723,1221,1686,2624,9990
2023-08-15,16,1628,1052,2085,3894,5302,13961
2023-08-16,16,3079,2165,3769,4289,4676,17978
2023-08-17,16,4778,1488,2510,3383,3389,15548
2023-08-18,16,2605,2761,3491,2844,2905,14606
2023-08-19,16,1835,1050,2234,2142,3445,10706
2023-08-20,16,4797,1864,3227,3562,3627,17077
2023-08-21,16,2182,1015,1634,3234,2023,10088
2023-08-22,16,1089,899,2834,1769,5237,11828
2023-08-23,16,3482,2253,1820,3453,5070,16078
2023-08-24,16,3566,2105,3579,4431,2094,15775
2023-08-25,16,3366,2635,1548,3237,3991,14777
2023-08-26,16,4233,2202,2681,1937,5318,16371
2023-08-27,16,4729,2116,2390,3695,3725,16655
2023-08-28,16,2471,1644,3667,4259,3173,15214
2023-08-29,16,3398,1440,1913,1528,3090,11369
2023-08-30,16,2405,1428,1693,2468,3411,11405
2023-08-31,16,3574,2730,1246,2736,5813,16099
2023-09-01,16,4946,2647,2369,1567,4627,16156
2023-09-02,16,1926,2221,1215,3692,3109,12163
2023-09-03,16,1819,2666,1786,2873,4153,13297
2023-09-04,16,2005,1248,1664,2647,5780,13344
2023-09-05,16,2920,2535,3500,3110,5238,17303
2023-09-06,16,1058,2477,1570,2185,2958,10248
2023-09-07,16,3793,1742,1623,1537,4237,12932
2023-09-08,16,3747,1668,3951,3691,5415,18472
2023-09-09,16,3703,1947,3421,2251,2471,13793
2023-09-10,16,3423,1508,3247,3584,3501,15263
2023-09-11,16,2403,2983,1868,1692,3287,12233
2023-09-12,16,3358,1664,2535,1621,3032,12210
2023-09-13,16,4040,2773,2588,3503,5203,18107
2023-09-14,16,1446,1077,2703,3049,2759,11034
2023-09-15,16,1040,906,3997,3891,4679,14513
2023-09-16,16,1619,2819,2647,3110,3294,13489
2023-09-17,16,2454,1732,3863,4388,5607,18044
2023-09-18,16,3011,1481,3790,1608,5174,15064
2023-09-19,16,3197,2078,2564,2551,2548,12938
2023-09-20,16,1116,1376,3204,1687,2126,9509
2023-09-21,16,4180,2933,2672,1831,5101,16717
2023-09-22,16,3571,1953,3346,1959,3254,14083
2023-09-23,16,2583,2582,1666,2302,3964,13097
2023-09-24,16,3793,2416,3627,1873,5371,17080
2023-09-25,16,3151,1109,2433,1619,4080,12392
2023-09-26,16,1833,1209,3698,3357,3296,13393
2023-09-27,16,4446,1541,1566,3960,4448,15961
2023-09-28,16,4781,1236,3027,2690,3504,15238
2023-09-29,16,3390,903,3342,2339,4573,14547
2023-09-30,16,3344,1364,3867,1579,4315,14469
2023-10-01,16,4681,2941,1837,1676,3654,14789
2023-10-02,16,3954,942,2565,1912,2424,11797
2023-10-03,16,1607,2091,3322,2079,2286,11385
2023-10-04,16,4020,1523,1926,3501,3879,14849
2023-10-05,16,2379,2361,2767,3750,2503,13760
2023-10-06,16,1319,1855,2040,3228,3665,12107
2023-10-07,16,4458,974,1702,2849,5032,15015
2023-10-08,16,4958,1630,2370,3973,4166,17097
2023-10-09,16,2620,2993,3386,1621,4021,14641
2023-10-10,16,1562,1588,3303,2167,2235,10855
2023-10-11,16,1949,2856,2504,4210,3647,15166
2023-10-12,16,3205,2498,3777,2219,3343,15042
2023-10-13,16,1620,1278,3637,4409,3380,14324
2023-10-14,16,1992,1816,1831,4128,3650,13417
2023-10-15,16,1543,1555,1200,2281,5214,11793
2023-10-16,16,4891,2625,1333,3018,4991,16858
2023-10-17,16,2753,1650,3161,2232,2510,12306
2023-10-18,16,1018,2410,2113,4477,5648,15666
2023-10-19,16,3043,2447,2241,3058,2253,13042
2023-10-20,16,3656,2296,3074,3432,5650,18108
2023-10-21,16,2322,972,3018,3117,2600,12029
2023-10-22,16,2721,1540,1768,3536,3740,13305
2023-10-23,16,1264,902,2601,1967,4834,11568
2023-10-24,16,2351,2053,2390,3209,2465,12468
2023-10-25,16,4912,1129,1920,3727,4914,16602
2023-10-26,16,2377,1282,2071,2012,5479,13221
2023-10-27,16,2491,1092,2394,3700,5416,15093
2023-10-28,16,4763,1858,3960,2430,4257,17268
2023-10-29,16,2029,1124,1589,3649,4381,12772
2023-10-30,16,1897,1779,1566,3189,2699,11130
2023-10-31,16,2188,1740,3560,4165,2496,14149
2023-11-01,16,2672,2407,2646,3548,2789,14062
2023-11-02,16,2397,956,1214,4464,4435,13466
2023-11-03,16,2598,1050,2445,3525,3735,13353
2023-11-04,16,4534,1473,3279,2071,2439,13796
2023-11-05,16,3588,1095,2696,2652,4355,14386
2023-11-06,16,4740,872,1925,4214,3130,14881
2023-11-07,16,1791,1624,1683,4429,4240,13767
2023-11-08,16,4403,1657,3378,3699,3855,16992
2023-11-09,16,1840,1419,1495,1965,4169,10888
2023-11-10,16,1284,2005,2591,4369,4483,14732
2023-11-11,16,4123,1505,3451,2545,3196,14820
2023-11-12,16,3863,1903,2835,1873,2949,13423
2023-11-13,16,2406,1736,3879,3270,5449,16740
2023-11-14,16,4839,1783,1997,4369,4717,17705
2023-11-15,16,3318,2128,3734,3209,2685,15074
2023-11-16,16,2234,2915,2201,2743,2411,12504
2023-11-17,16,4826,2455,3042,2996,2724,16043
2023-11-18,16,1726,1209,3703,3328,5526,15492
2023-11-19,16,3416,2375,3256,1760,3190,13997
2023-11-20,16,1746,1271,2964,3174,3670,12825
2023-11-21,16,4969,1278,3594,2399,2002,14242
2023-11-22,16,2181,2120,2997,1759,2229,11286
2023-11-23,16,2198,1339,3775,2092,2821,12225
2023-11-24,16,1986,1540,3619,1846,5914,14905
2023-11-25,16,4030,2815,2415,3238,4626,17124
2023-11-26,16,3855,1936,1712,2450,3911,13864
2023-11-27,16,4193,1380,3995,2231,5823,17622
2023-11-28,16,3562,2313,1793,3992,5709,17369
2023-11-29,16,3304,1777,3135,4474,5020,17710
2023-11-30,16,4382,1536,1308,1548,4380,13154
2023-12-01,16,3685,1031,2953,3432,3696,14797
2023-12-02,16,4349,2862,2630,1503,2458,13802
2023-12-03,16,2028,2224,1385,3691,5729,15057
2023-12-04,16,1872,1239,3706,4028,4453,15298
2023-12-05,16,2912,2303,2943,3474,4990,16622
2023-12-06,16,3721,1194,2204,4315,4051,15485
2023-12-07,16,1133,2099,3489,2157,4202,13080
2023-12-08,16,3670,2298,3105,2625,4713,16411
2023-12-09,16,3175,1664,2177,1537,5782,14335
2023-12-10,16,2766,2287,2869,2781,3177,13880
2023-12-11,16,2853,2886,2803,2076,3303,13921
2023-12-12,16,4397,1304,3522,1895,5008,16126
2023-12-13,16,4672,2983,2638,3421,2391,16105
2023-12-14,16,4818,2599,2468,1538,3506,14929
2023-12-15,16,2793,1137,2613,1814,5096,13453
2023-12-16,16,2332,2194,2911,1622,3462,12521
2023-12-17,16,2090,1762,1703,3197,2638,11390
2023-12-18,16,4070,960,1880,3036,5887,15833
2023-12-19,16,2873,2228,2302,3786,3311,14500
2023-12-20,16,3006,933,2561,3265,2152,11917
2023-12-21,16,1492,1945,2045,1983,4111,11576
2023-12-22,16,3564,2326,2119,4335,2324,14668
2023-12-23,16,2388,842,1387,1881,2112,8610
2023-12-24,16,2895,1087,3084,2255,2651,11972
2023-12-25,16,2434,1812,2140,4263,2018,12667
2023-12-26,16,3174,1335,3040,2008,3767,13324
2023-12-27,16,2125,1984,1752,3305,4536,13702
2023-12-28,16,4887,1359,3024,2786,3642,15698
2023-12-29,16,1285,1060,3700,3968,5522,15535
2023-12-30,16,3742,2674,3087,1588,2766,13857
2023-12-31,16,3830,857,2545,1729,2463,11424
2022-01-01,17,4678,2303,2258,4398,2656,16293
2022-01-02,17,1589,2886,3422,4106,2370,14373
2022-01-03,17,4771,2414,3721,4165,2253,17324
2022-01-04,17,2587,2703,2344,2256,5032,14922
2022-01-05,17,3002,1564,2617,2149,2427,11759
2022-01-06,17,2389,1443,2724,1651,3820,12027
2022-01-07,17,2133,2917,3634,2681,2340,13705
2022-01-08,17,3578,2814,3070,4356,5987,19805
2022-01-09,17,2527,1923,1555,2188,2477,10670
2022-01-10,17,4480,2089,2398,1740,3718,14425
2022-01-11,17,2183,2057,2428,2825,5025,14518
2022-01-12,17,4428,1978,2087,2422,5478,16393
2022-01-13,17,1414,2380,3123,2688,2120,11725
2022-01-14,17,2705,2955,2278,2655,3977,14570
2022-01-15,17,4754,2065,3986,2681,2190,15676
2022-01-16,17,2206,2710,2360,4086,4209,15571
2022-01-17,17,3628,2557,2855,1699,3442,14181
2022-01-18,17,4402,1385,2448,4148,5413,17796
2022-01-19,17,2409,1179,3425,2751,3397,13161
2022-01-20,17,1205,1582,3819,4474,3118,14198
2022-01-21,17,2008,1871,3473,2856,3627,13835
2022-01-22,17,4421,2938,1319,2104,5893,16675
2022-01-23,17,3328,2451,3910,3760,2039,15488
2022-01-24,17,4384,2498,2488,3781,2250,15401
2022-01-25,17,2298,1033,3522,4081,2362,13296
2022-01-26,17,3346,2347,2796,3579,3640,15708
2022-01-27,17,4239,1986,3308,3950,5279,18762
2022-01-28,17,3076,2156,2033,1829,4869,13963
2022-01-29,17,4681,1748,3770,3894,4906,18999
2022-01-30,17,3396,2250,3063,2641,4823,16173
2022-01-31,17,3158,2349,1413,4319,2595,13834
2022-02-01,17,4029,1357,3422,3840,4728,17376
2022-02-02,17,3986,2605,2351,2145,5643,16730
2022-02-03,17,1088,1863,2582,3406,5989,14928
2022-02-04,17,1407,1717,2300,2541,2843,10808
2022-02-05,17,2215,995,1784,2185,4936,12115
2022-02-06,17,2083,2968,3071,2370,4565,15057
2022-02-07,17,3834,1603,2335,3430,5937,17139
2022-02-08,17,2429,1974,1289,3026,5470,14188
2022-02-09,17,3985,1987,3257,1902,2510,13641
2022-02-10,17,4515,1904,3743,3750,3338,17250
2022-02-11,17,3456,1429,2893,4322,5647,17747
2022-02-12,17,1511,1823,1398,2966,5102,12800
2022-02-13,17,4709,2724,3991,3241,2336,17001
2022-02-14,17,2766,2753,3688,4091,4450,17748
2022-02-15,17,2611,2444,3586,2321,2683,13645
2022-02-16,17,1951,1781,1741,1906,2879,10258
2022-02-17,17,3804,2713,1676,4149,5911,18253
2022-02-18,17,4320,2981,3879,3587,4997,19764
2022-02-19,17,2217,1148,2516,3227,3694,12802
2022-02-20,17,3326,1838,2174,2895,4308,14541
2022-02-21,17,1148,2346,3031,3062,4142,13729
2022-02-22,17,3902,2462,2459,3626,3431,15880
2022-02-23,17,3272,1219,3509,2293,3244,13537
2022-02-24,17,3219,969,3493,2821,5600,16102
2022-02-25,17,2647,2392,3240,3368,2689,14336
2022-02-26,17,4334,2983,3201,1704,4887,17109
2022-02-27,17,1025,1060,1882,2154,2740,8861
2022-02-28,17,2016,880,3440,4308,3372,14016
2022-03-01,17,3855,1821,2942,3672,3204,15494
2022-03-02,17,2976,1998,3131,2611,5090,15806
2022-03-03,17,2293,1418,3540,2838,4196,14285
2022-03-04,17,2006,1831,3792,2672,3816,14117
2022-03-05,17,4770,2447,3128,2949,5166,18460
2022-03-06,17,3172,1994,2262,2380,4562,14370
2022-03-07,17,2059,1778,3158,3091,5908,15994
2022-03-08,17,3213,2975,3600,2477,4240,16505
2022-03-09,17,2275,2295,2089,4394,4805,15858
2022-03-10,17,2609,954,3399,3121,2190,12273
2022-03-11,17,3050,2284,2642,3694,3932,15602
2022-03-12,17,3305,1463,2204,2937,2761,12670
2022-03-13,17,3912,2978,2932,4305,2289,16416
2022-03-14,17,1599,1673,3608,3606,3552,14038
2022-03-15,17,1788,873,1696,2213,4383,10953
2022-03-16,17,3020,1317,2427,3282,3397,13443
2022-03-17,17,2644,1461,2794,1948,2350,11197
2022-03-18,17,1478,2924,3445,3508,2630,13985
2022-03-19,17,2693,1071,3099,4214,2476,13553
2022-03-20,17,2787,1262,3534,4360,5016,16959
2022-03-21,17,4151,2049,3057,2920,3850,16027
2022-03-22,17,2754,2684,1492,4147,4436,15513
2022-03-23,17,1714,2140,2847,2672,5483,14856
2022-03-24,17,1010,2266,2604,1692,5312,12884
2022-03-25,17,4281,2984,1430,2564,3974,15233
2022-03-26,17,1793,1594,2357,3494,2221,11459
2022-03-27,17,3679,2680,3388,3419,3083,16249
2022-03-28,17,2605,2997,1519,3668,4567,15356
2022-03-29,17,1939,1215,2005,3283,3735,12177
2022-03-30,17,1906,1700,2349,4349,3866,14170
2022-03-31,17,1385,1042,2987,3811,2083,11308
2022-04-01,17,4757,895,3402,2796,4324,16174
2022-04-02,17,3348,2897,3662,3953,2354,16214
2022-04-03,17,4865,836,3451,4343,2978,16473
2022-04-04,17,2227,1101,2798,3309,3306,12741
2022-04-05,17,4005,2145,3732,4314,3752,17948
2022-04-06,17,2747,1130,2999,2657,5989,15522
2022-04-07,17,3611,1356,2118,3693,5581,16359
2022-04-08,17,4827,1630,1576,4087,5513,17633
2022-04-09,17,4715,1301,2725,4466,3856,17063
2022-04-10,17,2562,1793,3137,1927,2374,11793
2022-04-11,17,1808,1813,2599,4224,2794,13238
2022-04-12,17,2052,1861,3713,1577,3938,13141
2022-04-13,17,1400,2444,2836,3132,2955,12767
2022-04-14,17,1542,2788,3772,2855,5291,16248
2022-04-15,17,4441,2188,1611,4207,4891,17338
2022-04-16,17,2637,1946,3687,2942,3465,14677
2022-04-17,17,3831,2779,1927,3557,4697,16791
2022-04-18,17,4861,2383,3294,1946,5586,18070
2022-04-19,17,3315,1778,3571,1643,5484,15791
2022-04-20,17,1067,2282,3914,3747,4085,15095
2022-04-21,17,3391,1906,3350,4137,5713,18497
2022-04-22,17,3770,1451,3166,3626,3405,15418
2022-04-23,17,4384,1877,2727,2078,5424,16490
2022-04-24,17,3048,2256,1618,3568,3208,13698
2022-04-25,17,3231,1526,2454,4028,2116,13355
2022-04-26,17,2977,962,2645,3112,2077,11773
2022-04-27,17,1051,1045,3669,3322,5971,15058
2022-04-28,17,4010,2008,1790,3567,3451,14826
2022-04-29,17,4988,2123,1665,1857,2425,13058
2022-04-30,17,4600,2683,1372,3874,4810,17339
2022-05-01,17,4287,1218,2494,3657,5322,16978
2022-05-02,17,4812,2283,1284,2556,5986,16921
2022-05-03,17,4832,2096,2072,3101,4326,16427
2022-05-04,17,2011,930,2682,2122,2675,10420
2022-05-05,17,2599,1517,3464,2220,2588,12388
2022-05-06,17,2321,2913,3705,1562,4465,14966
2022-05-07,17,2553,2812,1663,3179,4249,14456
2022-05-08,17,4421,2372,2617,3403,5097,17910
2022-05-09,17,3634,949,3076,3590,2921,14170
2022-05-10,17,4023,2128,3578,3959,3571,17259
2022-05-11,17,3606,1948,1851,2774,4362,14541
2022-05-12,17,4770,1038,1651,4457,5937,17853
2022-05-13,17,4128,2384,1731,2199,5367,15809
2022-05-14,17,1897,911,1988,3782,2997,11575
2022-05-15,17,2562,1336,3775,4443,2028,14144
2022-05-16,17,2221,1354,3569,4199,5583,16926
2022-05-17,17,1293,1751,1286,2269,2826,9425
2022-05-18,17,2752,1260,1434,4427,5365,15238
2022-05-19,17,2898,1269,2891,1721,3524,12303
2022-05-20,17,4069,1820,3167,3804,5354,18214
2022-05-21,17,4717,2073,1523,1630,4643,14586
2022-05-22,17,4449,851,3225,2462,3740,14727
2022-05-23,17,3967,1393,3865,3727,4000,16952
2022-05-24,17,2318,2553,3208,3560,4253,15892
2022-05-25,17,1986,2416,3519,2605,5308,15834
2022-05-26,17,1246,2901,2023,2653,5954,14777
2022-05-27,17,3487,2051,3040,2394,4543,15515
2022-05-28,17,1708,1948,1934,2071,4169,11830
2022-05-29,17,2040,2720,2947,3725,5652,17084
2022-05-30,17,4054,2013,2073,3791,2580,14511
2022-05-31,17,3915,2212,3980,3940,4101,18148
2022-06-01,17,2658,2396,3674,1855,3411,13994
2022-06-02,17,2182,1601,2212,2245,3762,12002
2022-06-03,17,3891,1803,3488,3994,5246,18422
2022-06-04,17,4838,1278,1433,3070,3252,13871
2022-06-05,17,3056,2777,1348,2558,3043,12782
2022-06-06,17,4312,2060,1855,2225,2920,13372
2022-06-07,17,2058,1699,2596,3154,3315,12822
2022-06-08,17,2977,1147,3529,1648,5764,15065
2022-06-09,17,3192,2936,3277,4094,2777,16276
2022-06-10,17,3166,1670,3067,4197,3582,15682
2022-06-11,17,4746,2945,2650,3603,5298,19242
2022-06-12,17,2014,1872,2907,3267,3144,13204
2022-06-13,17,2113,2843,3483,2031,5902,16372
2022-06-14,17,1955,1533,3058,4052,3280,13878
2022-06-15,17,3034,970,2997,2567,3895,13463
2022-06-16,17,1043,2059,3262,4411,5754,16529
2022-06-17,17,2361,1065,2642,2949,3336,12353
2022-06-18,17,1923,1696,2902,3896,3497,13914
2022-06-19,17,3703,2875,2566,2049,4659,15852
2022-06-20,17,1512,1951,2301,2845,3376,11985
2022-06-21,17,2137,2139,3934,2713,2461,13384
2022-06-22,17,3372,2361,3312,2796,5200,17041
2022-06-23,17,3587,1972,1649,3038,2324,12570
2022-06-24,17,4933,2785,1333,3402,5055,17508
2022-06-25,17,1235,2248,2601,1624,4809,12517
2022-06-26,17,2782,1703,2268,3737,2863,13353
2022-06-27,17,3233,1649,2935,2496,3662,13975
2022-06-28,17,1873,1631,1356,1754,2460,9074
2022-06-29,17,1701,2320,2182,4310,5181,15694
2022-06-30,17,1860,1294,2260,1587,4688,11689
2022-07-01,17,4281,2777,2159,2668,2936,14821
2022-07-02,17,1786,2618,2859,1649,3320,12232
2022-07-03,17,2358,2004,2103,4260,4723,15448
2022-07-04,17,3693,1411,3745,2724,2600,14173
2022-07-05,17,3233,2095,1663,3432,3493,13916
2022-07-06,17,2174,1501,2163,1877,5965,13680
2022-07-07,17,4862,2976,2549,4199,5742,20328
2022-07-08,17,3204,1960,3555,4301,3335,16355
2022-07-09,17,2418,1807,3516,3574,5621,16936
2022-07-10,17,1535,2462,3802,4326,5410,17535
2022-07-11,17,3905,1667,1743,1986,2757,12058
2022-07-12,17,3423,1036,3509,1800,3940,13708
2022-07-13,17,3080,1337,1472,2313,2057,10259
2022-07-14,17,2596,2572,2997,3187,2478,13830
2022-07-15,17,4821,1564,3244,2212,5940,17781
2022-07-16,17,2238,2218,2362,4461,3222,14501
2022-07-17,17,1433,1936,3341,2691,4098,13499
2022-07-18,17,2908,1428,1785,2073,5615,13809
2022-07-19,17,3963,2130,2262,3796,2998,15149
2022-07-20,17,1027,2318,1635,3034,4148,12162
2022-07-21,17,1407,2467,3723,4386,4992,16975
2022-07-22,17,4224,2752,3597,2688,4264,17525
2022-07-23,17,1896,2109,1545,1583,3569,10702
2022-07-24,17,4462,1552,3827,3339,4809,17989
2022-07-25,17,4954,2713,2712,3706,4850,18935
2022-07-26,17,2661,1168,3351,3691,2918,13789
2022-07-27,17,4598,2427,1471,3171,5449,17116
2022-07-28,17,3714,2718,2574,1738,3304,14048
2022-07-29,17,2848,2604,2832,2593,5814,16691
2022-07-30,17,4556,2558,2494,3302,2575,15485
2022-07-31,17,4415,969,2556,3249,3333,14522
2022-08-01,17,3568,2478,1204,4000,5732,16982
2022-08-02,17,4352,2935,3590,2307,4686,17870
2022-08-03,17,3640,909,1400,2533,5360,13842
2022-08-04,17,1766,2601,1556,2613,4480,13016
2022-08-05,17,1877,2466,2353,4437,5681,16814
2022-08-06,17,3062,2436,3032,2795,3708,15033
2022-08-07,17,4405,1293,1947,1922,2088,11655
2022-08-08,17,1376,930,2891,4179,4200,13576
2022-08-09,17,4913,1966,1752,4270,4460,17361
2022-08-10,17,1896,1915,1675,2199,2335,10020
2022-08-11,17,1186,2076,3059,2280,3269,11870
2022-08-12,17,3196,1033,1392,4388,4650,14659
2022-08-13,17,4902,2385,3564,2636,2398,15885
2022-08-14,17,1719,918,1332,3677,2621,10267
2022-08-15,17,4510,1727,1964,3709,5945,17855
2022-08-16,17,4367,1678,1466,2762,2051,12324
2022-08-17,17,3502,2630,1594,3774,3516,15016
2022-08-18,17,2010,2595,3007,3285,2189,13086
2022-08-19,17,4802,2389,1521,2852,5176,16740
2022-08-20,17,2218,1301,2574,2688,4771,13552
2022-08-21,17,1631,1012,2518,3430,2956,11547
2022-08-22,17,2270,2974,2327,2367,3433,13371
2022-08-23,17,1541,2496,2236,4397,2383,13053
2022-08-24,17,1580,1528,2238,1545,4462,11353
2022-08-25,17,4201,2780,3873,4235,4736,19825
2022-08-26,17,1743,2918,1527,2131,4714,13033
2022-08-27,17,4815,2342,1293,3782,5767,17999
2022-08-28,17,3742,1892,2028,2157,3591,13410
2022-08-29,17,3843,2029,3287,2402,3341,14902
2022-08-30,17,2013,2152,1798,3621,2081,11665
2022-08-31,17,4293,2093,2345,3599,2407,14737
2022-09-01,17,4002,1556,3227,1746,5118,15649
2022-09-02,17,1542,2197,3177,3970,2039,12925
2022-09-03,17,2128,2701,2878,3363,2654,13724
2022-09-04,17,3431,2848,1520,3141,2228,13168
2022-09-05,17,3601,2142,1460,4148,2024,13375
2022-09-06,17,3442,1002,1285,3246,5244,14219
2022-09-07,17,3827,917,2632,4015,4688,16079
2022-09-08,17,2254,2197,3585,2578,5874,16488
2022-09-09,17,4782,876,1812,3858,3226,14554
2022-09-10,17,2532,1491,1857,3992,4602,14474
2022-09-11,17,1017,2787,3055,3862,4709,15430
2022-09-12,17,1761,1596,3236,3217,4310,14120
2022-09-13,17,2798,2885,1824,1753,4618,13878
2022-09-14,17,4474,1740,1771,1676,5062,14723
2022-09-15,17,4050,2374,3517,3483,3364,16788
2022-09-16,17,1845,1550,3745,2758,5486,15384
2022-09-17,17,1496,2610,2817,1894,2507,11324
2022-09-18,17,1172,1443,3847,1938,4265,12665
2022-09-19,17,1055,999,3766,2329,2864,11013
2022-09-20,17,3567,2552,2907,2466,4758,16250
2022-09-21,17,4998,2200,1561,3884,3654,16297
2022-09-22,17,2034,2319,3625,3519,3925,15422
2022-09-23,17,3077,1551,2745,2107,2422,11902
2022-09-24,17,2441,2380,1661,3082,5684,15248
2022-09-25,17,3074,1909,3472,1545,5579,15579
2022-09-26,17,2604,1671,3891,2314,2330,12810
2022-09-27,17,3392,1568,3892,2435,3943,15230
2022-09-28,17,2176,1576,2687,2370,2742,11551
2022-09-29,17,3349,2895,2134,3625,2284,14287
2022-09-30,17,2908,803,2264,4170,5374,15519
2022-10-01,17,2312,1010,3629,4081,4626,15658
2022-10-02,17,1360,2525,2845,2901,5018,14649
2022-10-03,17,4680,1384,3347,4023,2468,15902
2022-10-04,17,4405,2691,1443,4409,3802,16750
2022-10-05,17,2487,1143,3560,3441,2755,13386
2022-10-06,17,4185,2262,3070,3171,5799,18487
2022-10-07,17,4052,2641,3353,2522,5765,18333
2022-10-08,17,4471,987,1668,3970,2573,13669
2022-10-09,17,3071,967,1640,4089,5688,15455
2022-10-10,17,4687,2043,2487,1926,5199,16342
2022-10-11,17,3628,928,2837,3824,3488,14705
2022-10-12,17,2026,1401,3986,2309,5313,15035
2022-10-13,17,4019,1210,3059,2310,2048,12646
2022-10-14,17,2957,2031,2979,1853,5057,14877
2022-10-15,17,4297,2175,2537,4342,3202,16553
2022-10-16,17,4790,2605,2262,1711,5823,17191
2022-10-17,17,3185,2453,3729,2012,5145,16524
2022-10-18,17,4653,1558,2207,3928,3419,15765
2022-10-19,17,4019,2698,2346,2508,2658,14229
2022-10-20,17,1615,1019,3316,2684,5409,14043
2022-10-21,17,4132,2110,2391,2966,5469,17068
2022-10-22,17,2468,2714,1812,2497,2461,11952
2022-10-23,17,3768,1716,2413,4175,4690,16762
2022-10-24,17,3718,2610,1382,2611,2652,12973
2022-10-25,17,2616,1293,3252,3546,5940,16647
2022-10-26,17,1852,1238,3640,3488,2595,12813
2022-10-27,17,2571,1299,2529,3333,3770,13502
2022-10-28,17,2365,1519,3605,4333,4340,16162
2022-10-29,17,2210,1270,2481,1921,2723,10605
2022-10-30,17,4062,1140,3222,3000,5481,16905
2022-10-31,17,1543,2033,2674,4102,2280,12632
2022-11-01,17,2185,1968,2602,2723,5876,15354
2022-11-02,17,3887,2875,2867,4493,5313,19435
2022-11-03,17,1837,1750,1768,3569,3994,12918
2022-11-04,17,4351,882,1566,4208,3556,14563
2022-11-05,17,1200,2275,1429,1823,3284,10011
2022-11-06,17,2715,916,1991,4309,2269,12200
2022-11-07,17,2280,1058,2114,1987,5487,12926
2022-11-08,17,2975,1823,2819,4197,3671,15485
2022-11-09,17,4867,1690,3816,4088,3662,18123
2022-11-10,17,2343,831,1255,2072,5151,11652
2022-11-11,17,4749,2394,1434,2762,2012,13351
2022-11-12,17,4184,1897,1400,3466,5370,16317
2022-11-13,17,3936,1951,1754,3411,5234,16286
2022-11-14,17,2899,1161,3407,3833,4697,15997
2022-11-15,17,4705,1730,2759,2366,5510,17070
2022-11-16,17,2110,1910,2323,4081,2891,13315
2022-11-17,17,2956,1610,1809,3820,2496,12691
2022-11-18,17,2039,2772,2129,1890,4662,13492
2022-11-19,17,1728,2932,2072,3887,5355,15974
2022-11-20,17,2024,908,1390,4399,5997,14718
2022-11-21,17,4019,1161,3761,2986,5559,17486
2022-11-22,17,3988,2907,2559,4010,2361,15825
2022-11-23,17,1849,1248,3617,4438,3889,15041
2022-11-24,17,2078,1563,2407,2821,2642,11511
2022-11-25,17,4033,2594,2984,4108,3808,17527
2022-11-26,17,1842,1684,3238,2534,5682,14980
2022-11-27,17,1176,2811,1484,4297,4290,14058
2022-11-28,17,4523,818,2063,2508,4768,14680
2022-11-29,17,1930,1894,2830,2034,3073,11761
2022-11-30,17,1620,2921,3567,3525,2099,13732
2022-12-01,17,2292,2221,1609,3220,2926,12268
2022-12-02,17,3603,2008,3429,4059,4804,17903
2022-12-03,17,3386,1717,2837,2008,4063,14011
2022-12-04,17,3083,1773,3069,3736,4384,16045
2022-12-05,17,3488,2336,1914,2959,3334,14031
2022-12-06,17,4629,2282,2211,2280,3724,15126
2022-12-07,17,4733,1653,1222,2950,2863,13421
2022-12-08,17,1688,2500,2605,3693,2858,13344
2022-12-09,17,4283,2224,3563,1618,3517,15205
2022-12-10,17,3212,2945,1498,1735,2182,11572
2022-12-11,17,1874,1129,1364,1857,4379,10603
2022-12-12,17,3199,1398,2949,1532,5386,14464
2022-12-13,17,3945,1114,1828,2861,2061,11809
2022-12-14,17,4077,2402,2508,2936,5387,17310
2022-12-15,17,3860,1263,3756,3147,5297,17323
2022-12-16,17,4150,2565,1399,3727,3158,14999
2022-12-17,17,1583,908,2853,1743,5933,13020
2022-12-18,17,3672,2629,3331,4454,5132,19218
2022-12-19,17,1961,1221,2297,1870,3002,10351
2022-12-20,17,3922,2887,1862,4385,4966,18022
2022-12-21,17,3629,2164,1866,1842,4775,14276
2022-12-22,17,4438,1941,3519,2344,2731,14973
2022-12-23,17,3637,2936,2163,4148,5403,18287
2022-12-24,17,2849,1564,1804,2442,4745,13404
2022-12-25,17,2492,2150,3976,3617,2342,14577
2022-12-26,17,2992,805,3752,1911,5225,14685
2022-12-27,17,2027,1018,1504,4419,2894,11862
2022-12-28,17,2301,2099,2846,3263,5351,15860
2022-12-29,17,2129,1193,2258,3921,4258,13759
2022-12-30,17,4755,1158,1231,2368,3454,12966
2022-12-31,17,2761,2877,2721,3860,4180,16399
2023-01-01,17,2231,2171,2372,3249,3709,13732
2023-01-02,17,4305,1033,2914,3541,4801,16594
2023-01-03,17,4809,1424,3411,2453,4373,16470
2023-01-04,17,1686,1153,2247,3588,5546,14220
2023-01-05,17,1585,825,1634,2064,5058,11166
2023-01-06,17,1579,2116,3981,4428,2165,14269
2023-01-07,17,2345,2872,2676,2328,4467,14688
2023-01-08,17,4426,2164,1862,3453,4238,16143
2023-01-09,17,2579,2516,1896,2227,4349,13567
2023-01-10,17,1063,1006,3573,3033,2287,10962
2023-01-11,17,4242,1995,2878,2799,3579,15493
2023-01-12,17,3115,1914,3677,3287,5819,17812
2023-01-13,17,1158,1550,3193,2221,3117,11239
2023-01-14,17,2887,1226,2155,2525,3573,12366
2023-01-15,17,2110,1694,1293,3874,3115,12086
2023-01-16,17,3550,2578,2206,3910,4185,16429
2023-01-17,17,1347,1203,1804,1833,4392,10579
2023-01-18,17,3450,1689,3108,2780,5976,17003
2023-01-19,17,4655,2266,3427,2210,4669,17227
2023-01-20,17,3688,2689,3374,3428,3931,17110
2023-01-21,17,4341,2537,3477,4164,4268,18787
2023-01-22,17,1233,2210,3202,1668,3220,11533
2023-01-23,17,1942,1643,3885,4481,5326,17277
2023-01-24,17,4541,987,3288,3750,3558,16124
2023-01-25,17,3134,1656,3034,2968,4235,15027
2023-01-26,17,3484,2173,2841,4258,5893,18649
2023-01-27,17,2298,908,3346,1548,2395,10495
2023-01-28,17,4361,2665,3814,3693,2850,17383
2023-01-29,17,1936,2417,3620,3233,4953,16159
2023-01-30,17,4524,2561,3025,1670,4317,16097
2023-01-31,17,3674,2627,2381,1582,4740,15004
2023-02-01,17,3483,1183,3278,1516,3481,12941
2023-02-02,17,2498,2635,3493,2081,5564,16271
2023-02-03,17,1444,914,3440,2550,3915,12263
2023-02-04,17,3421,1902,2109,2627,4379,14438
2023-02-05,17,3709,2571,2222,3067,5606,17175
2023-02-06,17,3116,1309,3814,2095,3121,13455
2023-02-07,17,2802,950,2117,4291,2753,12913
2023-02-08,17,4852,1153,3534,3484,3215,16238
2023-02-09,17,2190,1781,3039,2157,5215,14382
2023-02-10,17,1680,2402,1582,2386,4983,13033
2023-02-11,17,3923,1188,3327,1780,4210,14428
2023-02-12,17,2867,1224,2915,1750,5850,14606
2023-02-13,17,4221,2820,2501,2527,2293,14362
2023-02-14,17,4797,1100,1323,2373,4922,14515
2023-02-15,17,1680,2836,3804,3730,4052,16102
2023-02-16,17,2850,1424,1238,2383,5797,13692
2023-02-17,17,4638,1148,2325,2735,2326,13172
2023-02-18,17,2274,2880,3422,3904,4636,17116
2023-02-19,17,2746,1901,1797,4120,3748,14312
2023-02-20,17,1140,2216,3683,4181,4834,16054
2023-02-21,17,3624,2143,3687,1792,2443,13689
2023-02-22,17,2874,1173,1305,2973,3620,11945
2023-02-23,17,4765,2725,3599,1787,4621,17497
2023-02-24,17,2806,1357,2120,3162,4775,14220
2023-02-25,17,4407,2376,2059,4050,3826,16718
2023-02-26,17,2168,1470,1235,3937,5482,14292
2023-02-27,17,3271,2919,2293,2279,4187,14949
2023-02-28,17,2487,1057,1544,3723,4886,13697
2023-03-01,17,4402,1558,2432,3859,2580,14831
2023-03-02,17,1229,2913,2460,2450,4776,13828
2023-03-03,17,4139,1527,1578,1513,4853,13610
2023-03-04,17,3722,1764,2407,1764,5758,15415
2023-03-05,17,4098,1124,3800,4248,3242,16512
2023-03-06,17,4064,1489,3779,3073,2575,14980
2023-03-07,17,2477,1742,2279,4244,5154,15896
2023-03-08,17,1989,1426,2253,3666,3019,12353
2023-03-09,17,3807,1505,2220,2198,2207,11937
2023-03-10,17,1502,2521,2811,3852,5086,15772
2023-03-11,17,1863,1200,3821,1501,3789,12174
2023-03-12,17,3268,2097,3585,3517,2401,14868
2023-03-13,17,2399,2055,1379,3745,5680,15258
2023-03-14,17,4291,2440,1503,3937,2255,14426
2023-03-15,17,1915,949,2607,3817,5310,14598
2023-03-16,17,1466,2069,2196,3297,4741,13769
2023-03-17,17,4550,2068,3012,1865,3597,15092
2023-03-18,17,2968,2080,1633,1628,2172,10481
2023-03-19,17,1752,1530,2742,2848,4271,13143
2023-03-20,17,1850,2880,2592,3765,5361,16448
2023-03-21,17,2575,1969,2445,4149,3862,15000
2023-03-22,17,4166,2403,3691,1507,3046,14813
2023-03-23,17,4244,1211,2154,3204,4920,15733
2023-03-24,17,1701,2594,3856,2804,3310,14265
2023-03-25,17,4307,1265,3341,2678,5672,17263
2023-03-26,17,1238,2305,2648,2531,5058,13780
2023-03-27,17,1508,911,1361,2962,5313,12055
2023-03-28,17,3789,1655,2824,2495,4285,15048
2023-03-29,17,2340,1569,3435,2191,2278,11813
2023-03-30,17,3061,2953,1964,2219,2729,12926
2023-03-31,17,2166,1858,3923,2801,2329,13077
2023-04-01,17,2170,843,2299,2747,4999,13058
2023-04-02,17,1535,1407,1473,2688,4981,12084
2023-04-03,17,2033,1036,3726,3545,4220,14560
2023-04-04,17,4255,1663,2386,1510,3854,13668
2023-04-05,17,4677,2832,3555,1605,3343,16012
2023-04-06,17,3205,2248,2319,1705,3003,12480
2023-04-07,17,2023,2181,3814,2057,3677,13752
2023-04-08,17,1673,2460,2741,2988,4695,14557
2023-04-09,17,1024,931,2215,1926,4929,11025
2023-04-10,17,1992,1384,1384,4317,2245,11322
2023-04-11,17,2015,2017,1523,2242,5592,13389
2023-04-12,17,2501,2911,1546,2811,2088,11857
2023-04-13,17,3042,1580,3651,3536,4284,16093
2023-04-14,17,3799,2514,1241,3200,5262,16016
2023-04-15,17,4223,2332,2628,2791,2271,14245
2023-04-16,17,2790,2180,3359,3518,4790,16637
2023-04-17,17,3579,2036,2254,2823,3341,14033
2023-04-18,17,1689,1414,1659,2462,4877,12101
2023-04-19,17,1440,1520,2150,3956,2520,11586
2023-04-20,17,1167,1845,2712,3369,2280,11373
2023-04-21,17,1549,1259,2648,3016,2965,11437
2023-04-22,17,3250,849,2125,2687,5552,14463
2023-04-23,17,3619,1183,1774,4474,2975,14025
2023-04-24,17,3199,2578,3011,3763,3955,16506
2023-04-25,17,4014,1971,3621,4069,5607,19282
2023-04-26,17,4371,2947,2900,3619,4764,18601
2023-04-27,17,2951,1976,3592,4027,4408,16954
2023-04-28,17,4967,1091,3886,2909,2675,15528
2023-04-29,17,1849,1295,1202,3286,2033,9665
2023-04-30,17,4368,2763,3829,1816,5904,18680
2023-05-01,17,2074,2798,3066,2798,2594,13330
2023-05-02,17,4258,1122,2638,2732,2875,13625
2023-05-03,17,1551,1735,3927,2830,4428,14471
2023-05-04,17,4911,1306,1619,2993,2359,13188
2023-05-05,17,3485,2098,3377,1977,5481,16418
2023-05-06,17,3701,1239,3587,4312,3057,15896
2023-05-07,17,3738,820,1788,2359,5652,14357
2023-05-08,17,3606,1802,2793,3967,5397,17565
2023-05-09,17,1401,2392,3378,1954,2365,11490
2023-05-10,17,2315,2161,1913,2611,5524,14524
2023-05-11,17,4038,1706,1570,1552,3009,11875
2023-05-12,17,2556,2440,2783,3901,3577,15257
2023-05-13,17,1651,2918,2568,2146,3321,12604
2023-05-14,17,3648,2864,1299,1775,2911,12497
2023-05-15,17,2002,964,3561,2449,3509,12485
2023-05-16,17,1269,1421,2988,3698,5515,14891
2023-05-17,17,2008,1608,3948,2199,4065,13828
2023-05-18,17,3313,2121,3893,4446,2819,16592
2023-05-19,17,4654,1021,2567,2517,2385,13144
2023-05-20,17,1133,2557,3067,3697,5735,16189
2023-05-21,17,4876,2131,1428,2871,5600,16906
2023-05-22,17,4836,1906,2605,2402,5490,17239
2023-05-23,17,1466,1214,3422,2015,4251,12368
2023-05-24,17,2661,2321,2004,2745,3583,13314
2023-05-25,17,4269,2885,3598,3419,4588,18759
2023-05-26,17,4265,2597,1357,3388,3060,14667
2023-05-27,17,2956,2403,3522,4253,3303,16437
2023-05-28,17,1121,1516,2889,2144,5406,13076
2023-05-29,17,1438,2824,3560,3485,2998,14305
2023-05-30,17,1421,2719,2205,4098,2146,12589
2023-05-31,17,4605,2005,3970,1952,5207,17739
2023-06-01,17,2581,2079,3633,3764,2800,14857
2023-06-02,17,4570,2740,3784,3069,2691,16854
2023-06-03,17,4842,1130,1245,4417,3187,14821
2023-06-04,17,2689,1816,1949,2312,5257,14023
2023-06-05,17,3323,2283,2858,2399,5551,16414
2023-06-06,17,3733,2123,2728,2018,4317,14919
2023-06-07,17,1419,851,2657,4338,3793,13058
2023-06-08,17,4978,2437,2713,3545,4520,18193
2023-06-09,17,3290,2653,1767,3994,5674,17378
2023-06-10,17,2957,2568,2843,2353,2363,13084
2023-06-11,17,3868,882,3842,3798,3167,15557
2023-06-12,17,4583,1252,1308,2275,5120,14538
2023-06-13,17,3508,1261,1776,1738,3065,11348
2023-06-14,17,3027,2420,3479,2093,4391,15410
2023-06-15,17,2239,1250,2746,2213,2913,11361
2023-06-16,17,2284,2015,3377,1668,2824,12168
2023-06-17,17,1056,1223,1398,3040,2443,9160
2023-06-18,17,1816,1607,3914,2649,3639,13625
2023-06-19,17,2753,2655,1525,1746,3439,12118
2023-06-20,17,4222,1231,2277,3279,2402,13411
2023-06-21,17,2706,1378,3167,2907,4831,14989
2023-06-22,17,1330,1538,3481,2684,2977,12010
2023-06-23,17,3762,2060,1319,4078,3006,14225
2023-06-24,17,2293,1461,2037,3886,2662,12339
2023-06-25,17,2338,1622,2655,3373,5031,15019
2023-06-26,17,3404,1485,1721,4259,4786,15655
2023-06-27,17,1792,1366,1290,3008,2196,9652
2023-06-28,17,1411,2467,1670,2860,3734,12142
2023-06-29,17,2618,1583,1761,1688,3952,11602
2023-06-30,17,4055,1046,3976,2447,3611,15135
2023-07-01,17,2301,1562,1736,2313,4628,12540
2023-07-02,17,4460,1996,2985,4380,5756,19577
2023-07-03,17,3875,2364,1593,1802,5242,14876
2023-07-04,17,2102,1976,3915,3399,4478,15870
2023-07-05,17,1117,2823,3440,3356,5205,15941
2023-07-06,17,1099,1725,2810,3301,4547,13482
2023-07-07,17,2962,2131,2601,3751,4925,16370
2023-07-08,17,1792,2263,3147,3688,5485,16375
2023-07-09,17,4277,2131,1679,4355,2642,15084
2023-07-10,17,3698,2866,3288,3417,3381,16650
2023-07-11,17,2338,1868,2595,2698,3122,12621
2023-07-12,17,3364,1624,2272,2323,5959,15542
2023-07-13,17,3809,2051,1335,3994,2584,13773
2023-07-14,17,3004,958,1310,3366,5847,14485
2023-07-15,17,1256,2254,2903,2096,4641,13150
2023-07-16,17,2969,2324,3875,3811,5300,18279
2023-07-17,17,4906,2634,2535,2799,3244,16118
2023-07-18,17,4935,1013,3844,3874,4374,18040
2023-07-19,17,1724,2474,2365,3919,2068,12550
2023-07-20,17,1123,1331,3749,4235,5515,15953
2023-07-21,17,1373,2594,2444,2501,4171,13083
2023-07-22,17,4551,1683,1447,3360,3378,14419
2023-07-23,17,1275,2200,2383,4370,4668,14896
2023-07-24,17,2232,1320,3732,1736,3223,12243
2023-07-25,17,2733,1568,2716,4097,5785,16899
2023-07-26,17,4783,1828,2451,2173,3078,14313
2023-07-27,17,1847,1709,1974,2209,4229,11968
2023-07-28,17,2938,979,1758,3425,5052,14152
2023-07-29,17,4003,1488,2730,4087,4587,16895
2023-07-30,17,4831,2974,1868,4188,5332,19193
2023-07-31,17,4543,1800,3761,3513,4318,17935
2023-08-01,17,2501,2148,3389,2256,4679,14973
2023-08-02,17,2531,1629,1390,2847,3883,12280
2023-08-03,17,4944,1195,3810,1570,4846,16365
2023-08-04,17,2246,2332,3638,3632,5523,17371
2023-08-05,17,3423,2512,1402,2244,4964,14545
2023-08-06,17,2681,1605,3233,2183,2578,12280
2023-08-07,17,1054,2972,2668,2944,2865,12503
2023-08-08,17,1080,2446,1324,1820,5065,11735
2023-08-09,17,4568,894,3868,1884,5197,16411
2023-08-10,17,4133,1803,2606,3483,5483,17508
2023-08-11,17,4423,817,2979,2454,3235,13908
2023-08-12,17,1310,2927,2518,3456,5498,15709
2023-08-13,17,4011,1172,1727,1662,3666,12238
2023-08-14,17,3962,1871,3746,3931,3286,16796
2023-08-15,17,1342,1728,2005,3971,4685,13731
2023-08-16,17,4904,2376,3679,3369,5023,19351
2023-08-17,17,3509,2163,3796,1891,5128,16487
2023-08-18,17,4311,1208,3814,3664,2719,15716
2023-08-19,17,3094,972,2375,4188,4136,14765
2023-08-20,17,1119,1655,3036,1610,2872,10292
2023-08-21,17,3569,1365,1921,3015,2387,12257
2023-08-22,17,3266,1193,3268,1674,5517,14918
2023-08-23,17,3900,2676,2038,2491,3450,14555
2023-08-24,17,4358,1452,3499,3881,4813,18003
2023-08-25,17,3189,2066,3347,3774,4091,16467
2023-08-26,17,3315,1567,2241,3592,2943,13658
2023-08-27,17,4510,2866,1833,1559,5635,16403
2023-08-28,17,3320,1309,2835,4031,5688,17183
2023-08-29,17,1260,1986,1254,3353,5744,13597
2023-08-30,17,1619,2095,3435,4441,3251,14841
2023-08-31,17,1345,2120,3184,3539,2263,12451
2023-09-01,17,3273,956,3118,2011,4864,14222
2023-09-02,17,3168,1477,2355,3748,2403,13151
2023-09-03,17,1486,2040,2309,3564,3453,12852
2023-09-04,17,1193,2382,1913,2691,4736,12915
2023-09-05,17,2519,1422,1532,3678,5385,14536
2023-09-06,17,4747,2227,1495,2869,4667,16005
2023-09-07,17,2811,2386,1341,3759,5297,15594
2023-09-08,17,4983,1582,2988,1500,2752,13805
2023-09-09,17,1057,1959,2732,3683,3058,12489
2023-09-10,17,2100,1092,1527,3621,5835,14175
2023-09-11,17,1385,2070,1887,4249,5769,15360
2023-09-12,17,2430,2097,1203,2632,4429,12791
2023-09-13,17,4883,1195,1942,2250,2007,12277
2023-09-14,17,3004,2908,2722,1864,5462,15960
2023-09-15,17,3693,2827,2923,3211,3551,16205
2023-09-16,17,4181,1935,1856,3343,5062,16377
2023-09-17,17,3586,1928,3864,1919,2782,14079
2023-09-18,17,1678,2843,3279,4015,3267,15082
2023-09-19,17,1292,952,1986,3477,5278,12985
2023-09-20,17,4379,2831,2194,3467,5809,18680
2023-09-21,17,2337,1632,3090,3908,2634,13601
2023-09-22,17,4424,1718,1844,3154,5750,16890
2023-09-23,17,4368,1555,1911,2010,5280,15124
2023-09-24,17,4772,1967,1631,2044,5895,16309
2023-09-25,17,1057,2106,1823,2668,4678,12332
2023-09-26,17,3040,2209,1320,3549,4194,14312
2023-09-27,17,3477,1262,1286,2211,2176,10412
2023-09-28,17,1741,1443,3990,3825,3431,14430
2023-09-29,17,2466,1559,1480,2755,4005,12265
2023-09-30,17,2027,1338,2113,2994,2801,11273
2023-10-01,17,4139,994,3555,4352,2478,15518
2023-10-02,17,2306,2793,3478,1562,5061,15200
2023-10-03,17,4227,2893,3393,2010,2002,14525
2023-10-04,17,3657,2834,2895,2569,3470,15425
2023-10-05,17,4434,1584,3754,1803,3380,14955
2023-10-06,17,4228,1779,2941,2098,4466,15512
2023-10-07,17,1220,1840,2360,1582,5478,12480
2023-10-08,17,1590,924,1916,3483,2249,10162
2023-10-09,17,4924,1325,2162,3820,3193,15424
2023-10-10,17,1380,2784,1414,3057,5412,14047
2023-10-11,17,3085,2798,1427,4191,3574,15075
2023-10-12,17,3040,1397,3553,3461,2340,13791
2023-10-13,17,1985,2117,2865,4148,2806,13921
2023-10-14,17,2943,1728,1751,4047,4878,15347
2023-10-15,17,4677,2179,3944,2705,3138,16643
2023-10-16,17,1397,2534,2173,1817,3479,11400
2023-10-17,17,1582,1857,3559,2891,3474,13363
2023-10-18,17,2957,1505,1867,3168,4095,13592
2023-10-19,17,4882,2976,1427,4479,4186,17950
2023-10-20,17,2575,2889,1625,3505,3423,14017
2023-10-21,17,2649,1666,2686,4201,3751,14953
2023-10-22,17,4152,2697,1490,3210,3432,14981
2023-10-23,17,1566,1781,3691,3938,4904,15880
2023-10-24,17,3385,999,1794,1700,3634,11512
2023-10-25,17,2031,2184,3893,4188,2304,14600
2023-10-26,17,4335,2348,3645,4371,3582,18281
2023-10-27,17,1861,2786,3469,3512,4281,15909
2023-10-28,17,2144,885,3012,3534,4140,13715
2023-10-29,17,2276,2868,3049,2062,3005,13260
2023-10-30,17,4876,1974,3944,2246,4966,18006
2023-10-31,17,4779,1121,3454,1952,3467,14773
2023-11-01,17,2285,2352,3902,4069,5781,18389
2023-11-02,17,1591,819,3241,2063,2331,10045
2023-11-03,17,1894,1197,2152,2315,5364,12922
2023-11-04,17,2768,2920,1411,3009,5088,15196
2023-11-05,17,3551,1223,1240,3322,2859,12195
2023-11-06,17,4956,1490,3900,4250,5994,20590
2023-11-07,17,1118,2333,3941,3749,5820,16961
2023-11-08,17,2441,2161,3073,3560,5019,16254
2023-11-09,17,4321,1233,2728,3324,2478,14084
2023-11-10,17,4454,2923,3593,4311,3328,18609
2023-11-11,17,4341,1457,1386,4145,5120,16449
2023-11-12,17,2086,1060,1528,3829,4762,13265
2023-11-13,17,3588,2158,3377,2494,3961,15578
2023-11-14,17,4894,1534,1372,4471,5692,17963
2023-11-15,17,4282,1279,3432,2646,2924,14563
2023-11-16,17,2253,2508,3780,4265,2552,15358
2023-11-17,17,1217,1568,2677,1740,4923,12125
2023-11-18,17,4406,1182,3512,2297,2150,13547
2023-11-19,17,4611,2093,3231,1918,4743,16596
2023-11-20,17,2092,1774,3836,2631,5988,16321
2023-11-21,17,1732,2869,2639,2396,4828,14464
2023-11-22,17,3511,1227,2204,2076,4899,13917
2023-11-23,17,1949,1840,3295,1757,2601,11442
2023-11-24,17,1278,2724,2675,4096,5266,16039
2023-11-25,17,4485,1838,1871,2983,3989,15166
2023-11-26,17,4743,2215,2924,2447,3798,16127
2023-11-27,17,4071,2822,2039,3584,4822,17338
2023-11-28,17,4899,2741,1320,3374,5794,18128
2023-11-29,17,1445,2544,1737,3904,2279,11909
2023-11-30,17,4772,2950,1284,2823,4332,16161
2023-12-01,17,3922,1840,3609,1568,5074,16013
2023-12-02,17,1832,811,2138,1556,5747,12084
2023-12-03,17,2821,1257,2813,3781,3013,13685
2023-12-04,17,1027,859,3532,2646,5401,13465
2023-12-05,17,4245,1702,2451,2009,3023,13430
2023-12-06,17,3605,2772,2616,4281,4163,17437
2023-12-07,17,1655,1465,2754,3981,4181,14036
2023-12-08,17,3602,2383,2451,4441,5832,18709
2023-12-09,17,2974,2365,1629,1980,2328,11276
2023-12-10,17,3052,1282,3036,3518,3073,13961
2023-12-11,17,2919,1392,1666,4081,3358,13416
2023-12-12,17,2781,1334,1229,1967,5670,12981
2023-12-13,17,3163,870,1655,3465,2116,11269
2023-12-14,17,3917,1591,1728,2807,3198,13241
2023-12-15,17,2651,1423,3594,2068,5465,15201
2023-12-16,17,3079,1664,1295,2735,3369,12142
2023-12-17,17,4065,1349,3767,3151,4564,16896
2023-12-18,17,3373,1361,2944,2754,3925,14357
2023-12-19,17,3563,1857,1856,1669,4255,13200
2023-12-20,17,2217,1012,3111,3177,5103,14620
2023-12-21,17,2513,2871,2016,2143,3269,12812
2023-12-22,17,3390,2291,3204,3847,4475,17207
2023-12-23,17,4690,2003,3863,2243,2258,15057
2023-12-24,17,1829,2668,2932,4402,3528,15359
2023-12-25,17,1571,1795,2883,2047,5411,13707
2023-12-26,17,1291,1294,2928,2755,2045,10313
2023-12-27,17,1992,834,2025,2482,4385,11718
2023-12-28,17,4743,2483,2407,2553,4839,17025
2023-12-29,17,4534,1214,2865,2073,4563,15249
2023-12-30,17,2232,1354,2084,2899,3664,12233
2023-12-31,17,3917,2178,2607,2738,4882,16322
2022-01-01,18,2268,1347,3853,4237,4104,15809
2022-01-02,18,4974,2048,3716,4451,3131,18320
2022-01-03,18,2552,1446,2434,2504,4018,12954
2022-01-04,18,1177,2573,1584,3786,3835,12955
2022-01-05,18,1008,1066,3553,4353,5335,15315
2022-01-06,18,3326,1612,2027,3983,4136,15084
2022-01-07,18,1683,1262,1976,2793,4661,12375
2022-01-08,18,4832,1031,1764,1997,4224,13848
2022-01-09,18,2318,2259,3957,4411,3837,16782
2022-01-10,18,1705,2021,1555,1682,5663,12626
2022-01-11,18,2173,2774,3706,3019,3628,15300
2022-01-12,18,4422,2457,2764,2199,4291,16133
2022-01-13,18,3586,1710,3109,3313,5263,16981
2022-01-14,18,1659,827,3535,1657,3704,11382
2022-01-15,18,2759,2590,3522,2463,3431,14765
2022-01-16,18,4077,1952,3151,3814,4114,17108
2022-01-17,18,5000,2061,3202,4275,3639,18177
2022-01-18,18,2193,2044,2754,2287,5683,14961
2022-01-19,18,1282,2860,2289,1701,3208,11340
2022-01-20,18,3706,2191,3085,1985,3750,14717
2022-01-21,18,2139,2228,2834,1809,5687,14697
2022-01-22,18,2546,1268,3745,2663,3589,13811
2022-01-23,18,4364,2857,2482,2692,4051,16446
2022-01-24,18,4577,2658,3957,4164,2017,17373
2022-01-25,18,3690,1173,3547,2794,5222,16426
2022-01-26,18,1949,1946,3292,1551,3874,12612
2022-01-27,18,2385,811,2005,4431,5801,15433
2022-01-28,18,1325,1531,2791,3619,3765,13031
2022-01-29,18,1920,2739,2574,3275,3323,13831
2022-01-30,18,4889,2985,1902,3907,2974,16657
2022-01-31,18,4980,2408,2729,3771,4598,18486
2022-02-01,18,4021,2492,3426,3221,2195,15355
2022-02-02,18,3277,2819,2053,1800,3244,13193
2022-02-03,18,2278,2509,1217,2391,4492,12887
2022-02-04,18,2786,2507,2326,2725,2486,12830
2022-02-05,18,2567,2777,1659,3528,5038,15569
2022-02-06,18,1399,2705,2085,1612,5511,13312
2022-02-07,18,2017,2773,1397,3696,3546,13429
2022-02-08,18,3940,2160,1682,2495,5974,16251
2022-02-09,18,4429,2142,1439,1743,2828,12581
2022-02-10,18,1061,1238,1347,1592,4326,9564
2022-02-11,18,4124,1693,3645,1943,3731,15136
2022-02-12,18,2099,2775,1947,1533,2179,10533
2022-02-13,18,2202,1633,2171,3147,3408,12561
2022-02-14,18,4872,1691,2588,3227,5402,17780
2022-02-15,18,3471,1025,2279,1955,5960,14690
2022-02-16,18,1004,1138,1750,2008,2260,8160
2022-02-17,18,3148,2880,1697,2471,5566,15762
2022-02-18,18,2275,1394,2578,2537,5199,13983
2022-02-19,18,2962,2884,2559,4176,5767,18348
2022-02-20,18,1735,985,3867,1536,3355,11478
2022-02-21,18,2815,2083,1540,3838,4328,14604
2022-02-22,18,2206,2273,3397,3168,3459,14503
2022-02-23,18,4625,2030,3392,3514,3743,17304
2022-02-24,18,1343,2215,2251,3589,2973,12371
2022-02-25,18,3833,861,3242,2972,2944,13852
2022-02-26,18,4974,1779,1578,1510,2501,12342
2022-02-27,18,1024,2705,3683,4337,3395,15144
2022-02-28,18,1987,2644,2308,1750,5247,13936
2022-03-01,18,1825,1256,2931,3286,5825,15123
2022-03-02,18,4647,2186,2505,2780,4913,17031
2022-03-03,18,4400,2672,3023,3660,5682,19437
2022-03-04,18,3513,2818,1983,1927,2098,12339
2022-03-05,18,3021,2515,1986,2248,4952,14722
2022-03-06,18,3978,1768,1537,1642,3650,12575
2022-03-07,18,3009,2679,3665,1812,2804,13969
2022-03-08,18,4938,1542,3164,4237,5145,19026
2022-03-09,18,3661,1153,1384,1905,5709,13812
2022-03-10,18,2357,1674,2866,2462,2301,11660
2022-03-11,18,1759,1005,3365,1997,4157,12283
2022-03-12,18,3407,2961,3180,4116,5641,19305
2022-03-13,18,2823,1413,1844,4150,2780,13010
2022-03-14,18,3306,2453,1939,4366,4015,16079
2022-03-15,18,2277,2311,2767,4134,4949,16438
2022-03-16,18,3959,2575,1883,4418,2763,15598
2022-03-17,18,3256,1156,1746,2131,5888,14177
2022-03-18,18,1932,2327,2111,2366,2554,11290
2022-03-19,18,1945,2167,1546,1526,3741,10925
2022-03-20,18,4828,1855,3619,2319,4106,16727
2022-03-21,18,1025,1655,2980,3072,3379,12111
2022-03-22,18,4276,2345,1308,2875,5227,16031
2022-03-23,18,1689,2599,2404,2051,2231,10974
2022-03-24,18,1838,909,2476,2780,4885,12888
2022-03-25,18,1088,2427,2022,2992,3405,11934
2022-03-26,18,4201,2091,3496,1684,5380,16852
2022-03-27,18,2701,1209,3730,1678,3463,12781
2022-03-28,18,3095,2664,3612,4181,4843,18395
2022-03-29,18,4221,2319,1972,2069,4497,15078
2022-03-30,18,3516,1382,3407,2600,2519,13424
2022-03-31,18,1941,1181,2664,1921,2258,9965
2022-04-01,18,3883,1510,1549,1890,4226,13058
2022-04-02,18,4780,2951,2179,2276,4603,16789
2022-04-03,18,3354,1786,1902,3312,2502,12856
2022-04-04,18,4321,1286,2464,2509,3192,13772
2022-04-05,18,2544,2273,2028,3784,2820,13449
2022-04-06,18,1090,2083,2136,3991,3624,12924
2022-04-07,18,4370,2237,2065,3512,5001,17185
2022-04-08,18,2404,1149,2649,2972,5478,14652
2022-04-09,18,1031,2337,1481,3870,4815,13534
2022-04-10,18,4305,2288,2222,3537,5777,18129
2022-04-11,18,3061,2826,1787,4461,2157,14292
2022-04-12,18,4604,2420,3300,4292,5891,20507
2022-04-13,18,3344,1735,2184,2392,5984,15639
2022-04-14,18,2376,2587,2240,2675,2472,12350
2022-04-15,18,2914,2316,1704,3267,3831,14032
2022-04-16,18,1258,1181,3061,3120,5957,14577
2022-04-17,18,3417,2619,3922,3518,3252,16728
2022-04-18,18,3401,1971,3058,1717,3584,13731
2022-04-19,18,2395,2498,3372,1640,2912,12817
2022-04-20,18,3843,1503,3910,2225,3479,14960
2022-04-21,18,1310,2581,3313,4121,4072,15397
2022-04-22,18,2543,1701,2639,4460,4663,16006
2022-04-23,18,4692,1763,2638,1943,2428,13464
2022-04-24,18,1065,2794,2676,1942,5513,13990
2022-04-25,18,3247,997,3166,2720,4543,14673
2022-04-26,18,3102,2689,1281,2978,2447,12497
2022-04-27,18,1372,1608,3983,1744,4535,13242
2022-04-28,18,2841,2890,2181,2474,2216,12602
2022-04-29,18,4934,2297,1424,2419,4966,16040
2022-04-30,18,1752,2825,1522,2002,3107,11208
2022-05-01,18,4542,1072,2677,2700,4228,15219
2022-05-02,18,3031,2135,3748,3755,3905,16574
2022-05-03,18,1472,2823,1533,4314,4324,14466
2022-05-04,18,4337,1247,2740,2835,2965,14124
2022-05-05,18,3107,1181,3809,3706,2146,13949
2022-05-06,18,3730,1707,3512,3207,5318,17474
2022-05-07,18,3708,2467,1672,3239,5334,16420
2022-05-08,18,4297,1590,2125,2933,3977,14922
2022-05-09,18,2131,1585,3186,3217,3371,13490
2022-05-10,18,3413,1569,1441,2742,3007,12172
2022-05-11,18,3837,2426,3174,1786,3067,14290
2022-05-12,18,4935,2463,3972,1703,3612,16685
2022-05-13,18,3944,1967,3403,2277,3405,14996
2022-05-14,18,4389,1030,2914,3576,3128,15037
2022-05-15,18,1169,2716,1897,3095,4595,13472
2022-05-16,18,1978,2755,1235,1637,5832,13437
2022-05-17,18,4003,1270,2964,3310,3910,15457
2022-05-18,18,4448,2276,3864,3186,5258,19032
2022-05-19,18,4772,1783,2354,2038,4170,15117
2022-05-20,18,4827,968,2104,3414,4270,15583
2022-05-21,18,2506,2367,2989,3979,2635,14476
2022-05-22,18,4535,2505,1400,3867,5835,18142
2022-05-23,18,4637,2938,1924,4129,4399,18027
2022-05-24,18,4282,826,2610,2288,5160,15166
2022-05-25,18,1010,1653,3394,2077,3204,11338
2022-05-26,18,1562,2353,1905,2730,3010,11560
2022-05-27,18,3015,1237,3124,3847,4882,16105
2022-05-28,18,4565,1504,1621,3913,2149,13752
2022-05-29,18,1246,1962,1502,3957,5702,14369
2022-05-30,18,1192,1513,3010,4391,4536,14642
2022-05-31,18,1033,2074,3822,2739,4310,13978
2022-06-01,18,1394,2288,3255,3667,3491,14095
2022-06-02,18,3231,1135,2368,2178,4707,13619
2022-06-03,18,1697,2508,1771,2195,4353,12524
2022-06-04,18,1265,2808,2811,2464,3586,12934
2022-06-05,18,2416,2885,2798,2827,3597,14523
2022-06-06,18,1587,808,2768,3990,2736,11889
2022-06-07,18,1651,2239,2550,3600,3661,13701
2022-06-08,18,2589,1455,3484,3289,4903,15720
2022-06-09,18,2870,2827,2119,4085,3783,15684
2022-06-10,18,2307,864,3044,4357,2834,13406
2022-06-11,18,2962,846,1501,2738,2633,10680
2022-06-12,18,3609,1363,1670,2776,3029,12447
2022-06-13,18,2718,2318,1299,2425,5824,14584
2022-06-14,18,3052,1222,3456,3210,3512,14452
2022-06-15,18,3007,1918,1568,3662,4075,14230
2022-06-16,18,4069,2351,3447,4303,5224,19394
2022-06-17,18,4854,1454,3209,3832,2710,16059
2022-06-18,18,3022,1145,1311,1830,2728,10036
2022-06-19,18,4875,2733,3865,2001,4281,17755
2022-06-20,18,3636,2312,1390,4046,5957,17341
2022-06-21,18,4578,1825,1904,4094,2858,15259
2022-06-22,18,4667,2900,1819,2263,2831,14480
2022-06-23,18,4821,2016,2777,3632,5009,18255
2022-06-24,18,2344,1299,2589,3515,5665,15412
2022-06-25,18,2621,2185,3715,4471,3949,16941
2022-06-26,18,1185,1917,1292,2673,5425,12492
2022-06-27,18,2374,2009,1902,2423,4306,13014
2022-06-28,18,4731,2787,3975,3060,3820,18373
2022-06-29,18,2763,2190,1457,3631,5876,15917
2022-06-30,18,4765,1963,3355,2528,3363,15974
2022-07-01,18,1727,2009,2224,3935,3602,13497
2022-07-02,18,2778,2909,2596,3524,3879,15686
2022-07-03,18,4043,1036,1652,1984,2656,11371
2022-07-04,18,3771,1010,3884,3110,3776,15551
2022-07-05,18,2605,1374,2035,2061,3173,11248
2022-07-06,18,2555,1519,3289,3605,4133,15101
2022-07-07,18,1807,2519,1493,1600,2606,10025
2022-07-08,18,2938,2351,3159,2745,3427,14620
2022-07-09,18,2129,2094,1999,3515,2514,12251
2022-07-10,18,3409,1970,3600,3220,2722,14921
2022-07-11,18,3418,1895,3219,4359,2532,15423
2022-07-12,18,3879,1682,3374,2850,5092,16877
2022-07-13,18,2155,1993,1389,3941,5257,14735
2022-07-14,18,1064,2285,3612,4286,4031,15278
2022-07-15,18,4677,1738,2032,2844,2220,13511
2022-07-16,18,1848,2176,3595,3846,4687,16152
2022-07-17,18,1928,2552,3860,2325,4205,14870
2022-07-18,18,2028,1322,1272,4364,3457,12443
2022-07-19,18,4758,2439,2426,3287,5036,17946
2022-07-20,18,1457,1201,3464,2171,5220,13513
2022-07-21,18,2712,1174,1436,2623,4760,12705
2022-07-22,18,2960,815,3425,2648,2876,12724
2022-07-23,18,2232,2944,1200,3457,2707,12540
2022-07-24,18,1433,1874,2452,1536,5572,12867
2022-07-25,18,4245,959,3710,2178,3363,14455
2022-07-26,18,4212,1302,1797,3066,5586,15963
2022-07-27,18,3561,1020,1457,4269,4283,14590
2022-07-28,18,4713,2218,3993,2129,4857,17910
2022-07-29,18,1482,2423,1594,4458,2336,12293
2022-07-30,18,3922,948,2696,4181,5375,17122
2022-07-31,18,3228,1621,1761,4430,2560,13600
2022-08-01,18,3537,1622,3617,3993,2292,15061
2022-08-02,18,1774,1172,1777,4205,2166,11094
2022-08-03,18,2778,2742,2457,3343,4541,15861
2022-08-04,18,1512,959,2093,1646,3173,9383
2022-08-05,18,1225,1448,2538,4227,3611,13049
2022-08-06,18,1146,1962,1279,2618,2168,9173
2022-08-07,18,4004,2332,1328,3766,5159,16589
2022-08-08,18,3612,819,2982,4401,4918,16732
2022-08-09,18,1273,2531,1392,2036,3458,10690
2022-08-10,18,3515,937,1476,2232,2661,10821
2022-08-11,18,3187,2922,3157,1799,3138,14203
2022-08-12,18,1181,908,2822,2761,4824,12496
2022-08-13,18,1872,2128,2507,4151,4411,15069
2022-08-14,18,4196,1621,1379,3291,4412,14899
2022-08-15,18,1517,2717,3185,3285,3328,14032
2022-08-16,18,1541,1444,1409,2319,5128,11841
2022-08-17,18,3744,2710,1344,2158,2724,12680
2022-08-18,18,2687,1980,3905,3829,4223,16624
2022-08-19,18,4591,1266,1946,1789,5239,14831
2022-08-20,18,1607,1452,2566,1671,5266,12562
2022-08-21,18,1034,2592,3450,3706,5165,15947
2022-08-22,18,3265,2589,2042,2368,2348,12612
2022-08-23,18,1242,1006,3242,3688,4611,13789
2022-08-24,18,2772,2892,3717,3382,4008,16771
2022-08-25,18,4681,1235,1514,3178,4152,14760
2022-08-26,18,3323,863,1269,2230,3118,10803
2022-08-27,18,1045,1321,3375,2401,5115,13257
2022-08-28,18,1533,1149,3319,1880,5923,13804
2022-08-29,18,4993,2973,3709,3251,4052,18978
2022-08-30,18,3307,2542,2918,1525,3199,13491
2022-08-31,18,2219,2703,1560,3080,4355,13917
2022-09-01,18,1626,2211,2406,1696,2113,10052
2022-09-02,18,1426,1685,3232,3385,3170,12898
2022-09-03,18,4916,1112,2503,2777,3569,14877
2022-09-04,18,3440,1606,2229,3187,4061,14523
2022-09-05,18,1613,1119,2438,2447,3850,11467
2022-09-06,18,3254,812,2649,2623,4331,13669
2022-09-07,18,4587,1652,1663,3568,5425,16895
2022-09-08,18,4635,871,1742,3490,3509,14247
2022-09-09,18,3606,2131,2490,2077,3459,13763
2022-09-10,18,2000,1031,2810,2146,2507,10494
2022-09-11,18,4703,2161,3310,2700,5561,18435
2022-09-12,18,1538,2018,2983,1940,4109,12588
2022-09-13,18,3370,1694,2996,2185,4873,15118
2022-09-14,18,4004,974,3925,1769,3008,13680
2022-09-15,18,1492,2913,2941,3564,2877,13787
2022-09-16,18,4070,1432,1694,3996,4964,16156
2022-09-17,18,1827,1842,3653,4383,5946,17651
2022-09-18,18,1818,2750,2616,1927,2578,11689
2022-09-19,18,1762,2270,2974,2746,3955,13707
2022-09-20,18,4605,834,3184,3795,4113,16531
2022-09-21,18,2045,2559,1477,2512,5966,14559
2022-09-22,18,3302,821,2152,4245,2315,12835
2022-09-23,18,3556,1946,2950,2772,4717,15941
2022-09-24,18,3755,2295,1929,3577,4453,16009
2022-09-25,18,3309,1650,3185,3594,5028,16766
2022-09-26,18,1153,2336,2970,4169,4250,14878
2022-09-27,18,3772,822,2309,2603,5161,14667
2022-09-28,18,2219,2975,2816,4312,3147,15469
2022-09-29,18,1031,1661,1889,2736,2340,9657
2022-09-30,18,1942,2302,1948,4425,3806,14423
2022-10-01,18,4097,2650,2189,2699,5900,17535
2022-10-02,18,1980,1595,3488,4439,2535,14037
2022-10-03,18,4840,2822,1935,3945,3945,17487
2022-10-04,18,2930,1310,3282,2817,3525,13864
2022-10-05,18,3485,1245,3762,2034,3684,14210
2022-10-06,18,1989,1736,2347,3936,3069,13077
2022-10-07,18,2953,2973,2684,3193,3689,15492
2022-10-08,18,4222,1090,1396,2157,2281,11146
2022-10-09,18,3096,2161,1741,3853,3310,14161
2022-10-10,18,1244,2493,1549,1699,4936,11921
2022-10-11,18,2824,2752,2265,3458,2165,13464
2022-10-12,18,1439,1107,1859,3424,4804,12633
2022-10-13,18,2095,2947,1917,3244,3822,14025
2022-10-14,18,3366,1913,3142,2186,3785,14392
2022-10-15,18,1529,2549,3634,3529,5296,16537
2022-10-16,18,1033,2692,1711,3247,3807,12490
2022-10-17,18,4250,2049,2082,1992,3596,13969
2022-10-18,18,4156,809,1302,2022,5892,14181
2022-10-19,18,1605,2247,2056,3234,5647,14789
2022-10-20,18,4887,998,3378,1553,4531,15347
2022-10-21,18,3648,1740,1625,4140,4919,16072
2022-10-22,18,4504,1443,2504,1812,5592,15855
2022-10-23,18,4848,2770,1691,3342,4159,16810
2022-10-24,18,1109,1865,3413,2218,3309,11914
2022-10-25,18,2900,2075,3422,2626,3843,14866
2022-10-26,18,1615,2087,3242,2479,5468,14891
2022-10-27,18,2218,2016,2513,2866,4148,13761
2022-10-28,18,4960,2891,1536,4428,2011,15826
2022-10-29,18,4366,893,1445,3351,2408,12463
2022-10-30,18,2580,2414,2303,4181,5038,16516
2022-10-31,18,4188,2533,3603,3965,4952,19241
2022-11-01,18,2501,1873,3260,3926,2148,13708
2022-11-02,18,4061,2461,3504,3023,5652,18701
2022-11-03,18,1444,2375,1620,3716,5902,15057
2022-11-04,18,1257,1726,1992,4462,4243,13680
2022-11-05,18,2041,1266,3887,1563,3791,12548
2022-11-06,18,2711,2492,3368,4439,3507,16517
2022-11-07,18,2493,1790,2405,3236,2914,12838
2022-11-08,18,1476,1148,2062,2278,3866,10830
2022-11-09,18,2181,1885,2032,2954,4618,13670
2022-11-10,18,3761,2093,3538,2147,3238,14777
2022-11-11,18,2708,2683,1486,1990,3029,11896
2022-11-12,18,1614,2946,3905,1939,5675,16079
2022-11-13,18,1885,2803,2893,2753,5461,15795
2022-11-14,18,3448,2087,2052,3661,3748,14996
2022-11-15,18,3611,1270,3507,3484,5623,17495
2022-11-16,18,4607,2209,3548,4262,4739,19365
2022-11-17,18,1849,2238,3142,3597,4686,15512
2022-11-18,18,2989,2481,2623,1592,5892,15577
2022-11-19,18,3003,2692,2219,3763,3153,14830
2022-11-20,18,1950,1992,1758,2388,5098,13186
2022-11-21,18,3074,2627,1393,1982,3126,12202
2022-11-22,18,2289,2099,3869,4188,4910,17355
2022-11-23,18,3048,2238,2639,2209,2327,12461
2022-11-24,18,1134,2442,2286,2698,3152,11712
2022-11-25,18,3322,1683,3001,2946,2939,13891
2022-11-26,18,4184,2064,1267,1627,5517,14659
2022-11-27,18,3868,2436,1242,3793,5372,16711
2022-11-28,18,3475,2958,3743,2245,2985,15406
2022-11-29,18,4517,901,1967,2161,2564,12110
2022-11-30,18,3580,1201,2779,3249,2472,13281
2022-12-01,18,3113,2851,1682,4096,3792,15534
2022-12-02,18,2652,1962,2294,3018,2609,12535
2022-12-03,18,4975,2405,2977,2379,5566,18302
2022-12-04,18,3255,2390,3393,4429,2566,16033
2022-12-05,18,1126,1061,2584,4249,5593,14613
2022-12-06,18,1833,885,2481,3828,2470,11497
2022-12-07,18,2753,2792,3923,4362,3414,17244
2022-12-08,18,3914,2713,3565,2340,2616,15148
2022-12-09,18,1008,870,3787,4072,2269,12006
2022-12-10,18,2198,1136,3946,1596,4106,12982
2022-12-11,18,2747,1086,2665,4474,4712,15684
2022-12-12,18,4613,2006,2102,2660,3130,14511
2022-12-13,18,1138,2142,2154,2882,4193,12509
2022-12-14,18,1506,2344,2122,1717,3500,11189
2022-12-15,18,1216,2206,2756,2792,4105,13075
2022-12-16,18,2966,2936,3378,1685,2528,13493
2022-12-17,18,1673,864,2345,2787,4748,12417
2022-12-18,18,2112,2510,1824,1637,3762,11845
2022-12-19,18,4635,1309,2412,4010,5033,17399
2022-12-20,18,1713,1374,1893,4302,5161,14443
2022-12-21,18,1651,2650,3212,1618,5267,14398
2022-12-22,18,2703,1932,2951,1939,2856,12381
2022-12-23,18,1464,1752,3752,2629,2774,12371
2022-12-24,18,2314,1241,1577,3009,3062,11203
2022-12-25,18,2042,2915,3940,3152,2858,14907
2022-12-26,18,3312,1730,3101,2875,3309,14327
2022-12-27,18,4191,1174,3903,2641,5300,17209
2022-12-28,18,2494,867,1408,3078,2472,10319
2022-12-29,18,1526,1534,3832,2339,3368,12599
2022-12-30,18,1773,1946,3430,3759,5698,16606
2022-12-31,18,3418,2421,3849,2411,3023,15122
2023-01-01,18,2744,2978,3925,3995,3859,17501
2023-01-02,18,1667,1578,1618,4290,2127,11280
2023-01-03,18,1976,2002,3473,4392,5840,17683
2023-01-04,18,2986,1404,1200,4200,3253,13043
2023-01-05,18,1151,1841,2708,4165,2604,12469
2023-01-06,18,4677,1119,3368,2176,4795,16135
2023-01-07,18,1891,1666,3514,4051,2649,13771
2023-01-08,18,3566,2449,1212,4302,3847,15376
2023-01-09,18,2158,2482,3517,2147,2532,12836
2023-01-10,18,3570,812,3360,2513,2421,12676
2023-01-11,18,1154,1343,3010,1896,2961,10364
2023-01-12,18,2107,2982,2946,1877,4802,14714
2023-01-13,18,4066,1566,3781,1745,2750,13908
2023-01-14,18,3628,1120,2378,3896,4739,15761
2023-01-15,18,2880,1208,3082,3913,2790,13873
2023-01-16,18,4576,1948,3452,3679,5430,19085
2023-01-17,18,2869,2624,2707,2501,5096,15797
2023-01-18,18,4831,2147,3464,1786,4948,17176
2023-01-19,18,3566,2842,2328,2634,2310,13680
2023-01-20,18,2276,2536,2203,4278,2316,13609
2023-01-21,18,4326,1125,1236,4075,4186,14948
2023-01-22,18,4722,2366,2467,1696,2426,13677
2023-01-23,18,3120,1948,2275,4190,4217,15750
2023-01-24,18,3539,1486,2637,2768,3562,13992
2023-01-25,18,1257,1608,2871,2308,3794,11838
2023-01-26,18,3394,1740,1413,2911,3344,12802
2023-01-27,18,4262,2268,3603,4066,5393,19592
2023-01-28,18,2291,1373,3457,2402,4230,13753
2023-01-29,18,3111,1790,1793,2364,2887,11945
2023-01-30,18,3597,2432,2828,3057,2756,14670
2023-01-31,18,2522,1286,2641,2355,5592,14396
2023-02-01,18,1674,2812,1222,2384,4087,12179
2023-02-02,18,3198,1976,1489,1748,4023,12434
2023-02-03,18,4818,2421,3461,3123,5857,19680
2023-02-04,18,1196,1852,3364,4165,2081,12658
2023-02-05,18,4606,1657,2175,1926,2889,13253
2023-02-06,18,3534,2928,2688,3989,3049,16188
2023-02-07,18,1391,1188,2568,2367,5403,12917
2023-02-08,18,3750,1683,2492,2927,2520,13372
2023-02-09,18,4474,1868,2652,4068,4769,17831
2023-02-10,18,2671,2712,2184,2425,2627,12619
2023-02-11,18,3184,2035,1492,4430,4792,15933
2023-02-12,18,1734,1130,3781,3098,2313,12056
2023-02-13,18,4020,1783,3616,1549,3447,14415
2023-02-14,18,2906,1346,2970,1971,2313,11506
2023-02-15,18,1833,851,1503,2369,5499,12055
2023-02-16,18,3623,2713,2186,3761,2980,15263
2023-02-17,18,1379,831,3823,2797,5710,14540
2023-02-18,18,2872,938,2102,3281,4366,13559
2023-02-19,18,2304,1823,3683,2366,3146,13322
2023-02-20,18,1503,1972,3654,3228,5693,16050
2023-02-21,18,2324,2484,2352,1936,2279,11375
2023-02-22,18,3390,2611,1885,4331,4721,16938
2023-02-23,18,1713,2748,2934,2051,3332,12778
2023-02-24,18,2498,1043,3269,2458,2512,11780
2023-02-25,18,1421,2710,2097,3919,4090,14237
2023-02-26,18,4088,1645,3401,3385,2721,15240
2023-02-27,18,2904,2663,1470,3590,5420,16047
2023-02-28,18,1576,2216,3097,4408,4179,15476
2023-03-01,18,4194,1265,2116,2625,3203,13403
2023-03-02,18,1267,2283,2558,2220,3183,11511
2023-03-03,18,2697,1555,3728,4123,4603,16706
2023-03-04,18,4805,1096,2372,2463,5335,16071
2023-03-05,18,4877,1040,2872,4499,3393,16681
2023-03-06,18,3831,1018,3193,4304,2665,15011
2023-03-07,18,3635,2776,2444,1975,2690,13520
2023-03-08,18,3208,1313,1988,2714,3829,13052
2023-03-09,18,4910,1924,3873,1727,2540,14974
2023-03-10,18,3061,1765,2798,3469,3061,14154
2023-03-11,18,4622,1515,2338,1822,3145,13442
2023-03-12,18,4046,2117,2939,3403,3363,15868
2023-03-13,18,1267,1414,1530,2605,3374,10190
2023-03-14,18,4271,1558,2167,2248,5836,16080
2023-03-15,18,4150,1157,1918,2919,2481,12625
2023-03-16,18,2075,2179,1560,3267,2915,11996
2023-03-17,18,2768,1046,3634,2150,5639,15237
2023-03-18,18,1316,1443,3702,2109,3749,12319
2023-03-19,18,2825,2308,2989,4266,2608,14996
2023-03-20,18,4061,1913,3730,3987,5544,19235
2023-03-21,18,3084,1342,3520,1993,5363,15302
2023-03-22,18,3148,2380,2491,1910,3230,13159
2023-03-23,18,3476,1850,3675,1785,5819,16605
2023-03-24,18,4963,1123,2232,4103,3350,15771
2023-03-25,18,4982,1488,1373,3956,4674,16473
2023-03-26,18,3337,2924,3549,2142,5794,17746
2023-03-27,18,2628,2317,3696,1770,5881,16292
2023-03-28,18,3344,1116,2428,2845,2967,12700
2023-03-29,18,3734,1880,3516,2326,4527,15983
2023-03-30,18,1625,1897,2797,1778,3471,11568
2023-03-31,18,1863,2541,2954,3862,3323,14543
2023-04-01,18,2265,2806,3463,2962,5298,16794
2023-04-02,18,2931,2221,3477,3448,2912,14989
2023-04-03,18,2046,1794,2398,3273,3616,13127
2023-04-04,18,4792,1358,1698,4439,3974,16261
2023-04-05,18,3041,2145,2707,2792,5920,16605
2023-04-06,18,1144,1267,2692,3888,5662,14653
2023-04-07,18,4326,1242,2683,1758,4635,14644
2023-04-08,18,1257,2082,3144,3977,5500,15960
2023-04-09,18,1993,1448,1720,1702,5894,12757
2023-04-10,18,2081,2818,1242,2697,4967,13805
2023-04-11,18,2065,885,2102,3370,5447,13869
2023-04-12,18,3814,1373,1370,4408,4980,15945
2023-04-13,18,3039,2593,2196,1857,5856,15541
2023-04-14,18,3923,2840,2683,1817,3314,14577
2023-04-15,18,2686,2434,2759,1816,3177,12872
2023-04-16,18,1309,2110,2966,4301,3593,14279
2023-04-17,18,1279,1640,3394,3046,4649,14008
2023-04-18,18,4172,2327,3260,2812,4019,16590
2023-04-19,18,1946,1568,2596,3638,3739,13487
2023-04-20,18,1420,2957,2534,3524,3631,14066
2023-04-21,18,1858,2488,2013,3480,3678,13517
2023-04-22,18,4198,916,3430,1886,3373,13803
2023-04-23,18,3244,2791,1359,4476,3301,15171
2023-04-24,18,4429,1787,2176,3299,2084,13775
2023-04-25,18,2734,2914,1549,3921,3839,14957
2023-04-26,18,1178,1255,1312,1729,4262,9736
2023-04-27,18,2892,1842,3655,2619,2107,13115
2023-04-28,18,4915,1130,2138,3408,5327,16918
2023-04-29,18,4821,2108,3492,3363,4843,18627
2023-04-30,18,2819,1312,2074,2551,2079,10835
2023-05-01,18,1202,1071,3854,4464,3595,14186
2023-05-02,18,3930,1518,3348,3926,4326,17048
2023-05-03,18,1163,1463,2517,3864,3899,12906
2023-05-04,18,3864,1841,3247,4091,4955,17998
2023-05-05,18,4366,1714,2651,2478,4590,15799
2023-05-06,18,2979,2094,2992,1725,2140,11930
2023-05-07,18,1343,2694,2378,2309,5879,14603
2023-05-08,18,1854,1617,1886,2049,3780,11186
2023-05-09,18,4275,1919,3358,2443,3782,15777
2023-05-10,18,1036,1046,2188,1506,4795,10571
2023-05-11,18,2567,2608,1298,2383,4715,13571
2023-05-12,18,4130,938,1494,3128,2673,12363
2023-05-13,18,2831,1916,2951,1535,4442,13675
2023-05-14,18,1127,1813,3084,1520,5156,12700
2023-05-15,18,3697,2139,3097,2639,3363,14935
2023-05-16,18,1017,942,3247,1687,5045,11938
2023-05-17,18,2602,2884,2866,3192,3566,15110
2023-05-18,18,2148,2979,3828,3748,2951,15654
2023-05-19,18,1702,1517,2755,2799,4816,13589
2023-05-20,18,2209,1844,2043,2090,3616,11802
2023-05-21,18,4571,2361,3369,2412,4452,17165
2023-05-22,18,3774,1190,3816,2321,5248,16349
2023-05-23,18,2133,2971,1201,2504,5041,13850
2023-05-24,18,3335,2168,1747,2941,5097,15288
2023-05-25,18,4901,2546,3206,2965,5137,18755
2023-05-26,18,4446,1297,1695,3889,5420,16747
2023-05-27,18,3712,1244,3872,1704,2120,12652
2023-05-28,18,4662,1877,1283,1500,3500,12822
2023-05-29,18,2946,2365,2357,2920,3556,14144
2023-05-30,18,2539,1686,3081,2330,2320,11956
2023-05-31,18,4288,888,3794,3434,5462,17866
2023-06-01,18,1372,1712,2552,4084,4753,14473
2023-06-02,18,2841,2558,1813,3601,3357,14170
2023-06-03,18,2854,2058,2020,3869,3211,14012
2023-06-04,18,4125,2018,1272,2913,3840,14168
2023-06-05,18,2222,1735,3030,4020,3970,14977
2023-06-06,18,1348,1683,2766,3104,2726,11627
2023-06-07,18,3832,1950,2338,3271,3612,15003
2023-06-08,18,4068,1054,2850,3841,4603,16416
2023-06-09,18,2627,2443,1374,2915,4138,13497
2023-06-10,18,1613,2412,2714,3258,3391,13388
2023-06-11,18,4263,2651,2120,1542,4935,15511
2023-06-12,18,2757,1189,2088,2423,3304,11761
2023-06-13,18,4414,1925,3310,1923,5875,17447
2023-06-14,18,2309,927,1624,3732,3845,12437
2023-06-15,18,2215,1662,2017,2907,3439,12240
2023-06-16,18,3442,2679,2967,3985,4784,17857
2023-06-17,18,1662,1407,3080,2310,2723,11182
2023-06-18,18,1893,885,3613,3824,5940,16155
2023-06-19,18,3785,1578,3248,2017,5300,15928
2023-06-20,18,3473,1470,1420,3059,4747,14169
2023-06-21,18,1930,2147,3727,2513,2460,12777
2023-06-22,18,2457,845,2794,3817,4829,14742
2023-06-23,18,3821,1447,2161,2286,3190,12905
2023-06-24,18,4135,2502,1680,1505,2600,12422
2023-06-25,18,1370,1831,2868,2799,5014,13882
2023-06-26,18,2711,1246,2574,2840,2046,11417
2023-06-27,18,4553,1513,3816,3128,5059,18069
2023-06-28,18,3583,1214,1798,3071,3338,13004
2023-06-29,18,3005,2440,2081,1727,4108,13361
2023-06-30,18,1833,2123,2353,4073,4096,14478
2023-07-01,18,3998,2328,3215,2998,5100,17639
2023-07-02,18,2923,1760,2144,3352,3643,13822
2023-07-03,18,4686,2452,1316,1988,4018,14460
2023-07-04,18,3548,1462,3831,1889,4492,15222
2023-07-05,18,4839,2805,1442,3271,3673,16030
2023-07-06,18,3620,1554,2740,3062,2952,13928
2023-07-07,18,2967,1782,1291,3641,2710,12391
2023-07-08,18,1429,1492,2284,2941,5992,14138
2023-07-09,18,1219,2689,2076,1999,5198,13181
2023-07-10,18,4052,2281,2351,2665,2380,13729
2023-07-11,18,1597,2844,1797,1937,5753,13928
2023-07-12,18,1882,2506,2885,2991,4979,15243
2023-07-13,18,3081,2598,2505,2060,3139,13383
2023-07-14,18,3092,1086,2839,1740,2726,11483
2023-07-15,18,2518,2398,2537,2686,3670,13809
2023-07-16,18,2108,895,3786,3541,3247,13577
2023-07-17,18,4247,2235,2919,3569,4845,17815
2023-07-18,18,2094,2229,2065,1566,5508,13462
2023-07-19,18,1529,2546,1371,2110,5900,13456
2023-07-20,18,4614,813,1644,3331,3555,13957
2023-07-21,18,4984,2978,3771,3923,2017,17673
2023-07-22,18,2855,1411,2395,2184,2704,11549
2023-07-23,18,2479,1695,1665,1567,4939,12345
2023-07-24,18,2983,2658,1409,4381,2759,14190
2023-07-25,18,3598,1429,1612,3820,2504,12963
2023-07-26,18,1561,1054,1524,4106,5436,13681
2023-07-27,18,3455,1311,3059,1808,5999,15632
2023-07-28,18,1392,1902,3837,3323,5233,15687
2023-07-29,18,3127,2948,2047,2351,3320,13793
2023-07-30,18,2353,2534,1333,3471,5562,15253
2023-07-31,18,4448,1298,3321,3063,3133,15263
2023-08-01,18,1745,919,2985,2818,3287,11754
2023-08-02,18,3104,998,3081,1762,2995,11940
2023-08-03,18,3901,1315,3048,3279,2973,14516
2023-08-04,18,3644,2504,2134,1753,2603,12638
2023-08-05,18,1666,2241,1552,3893,5509,14861
2023-08-06,18,1737,951,3986,2554,2040,11268
2023-08-07,18,3221,1422,2309,2107,5609,14668
2023-08-08,18,3967,2208,1942,2441,2262,12820
2023-08-09,18,2916,1286,2753,2888,2141,11984
2023-08-10,18,1281,1366,1742,3006,5005,12400
2023-08-11,18,3645,2863,1622,4430,5017,17577
2023-08-12,18,2463,1179,3915,3997,4201,15755
2023-08-13,18,4046,914,2052,2286,4350,13648
2023-08-14,18,3345,889,1922,2054,3296,11506
2023-08-15,18,3614,2603,1280,1726,5582,14805
2023-08-16,18,3775,810,2933,2705,5387,15610
2023-08-17,18,2481,1463,2802,4399,4997,16142
2023-08-18,18,2669,2761,1519,3982,4894,15825
2023-08-19,18,2834,2281,3022,3210,5561,16908
2023-08-20,18,1255,2991,3971,3586,2530,14333
2023-08-21,18,4738,1379,2440,3355,3524,15436
2023-08-22,18,4382,2686,2492,3573,4243,17376
2023-08-23,18,1808,2860,2903,2438,5579,15588
2023-08-24,18,2166,1127,1341,4076,3604,12314
2023-08-25,18,2138,1274,3623,3062,5066,15163
2023-08-26,18,1576,2329,3189,2356,3343,12793
2023-08-27,18,1381,809,1480,3300,3402,10372
2023-08-28,18,2700,1464,1778,1609,2928,10479
2023-08-29,18,1417,1163,1326,3627,5427,12960
2023-08-30,18,2731,1462,1664,1912,5648,13417
2023-08-31,18,3607,1925,2891,3152,2139,13714
2023-09-01,18,4643,1818,1463,2545,5688,16157
2023-09-02,18,1534,2750,1771,2962,2016,11033
2023-09-03,18,2774,2808,3074,3861,5608,18125
2023-09-04,18,4567,1348,2561,3413,2247,14136
2023-09-05,18,3729,821,1726,2604,2312,11192
2023-09-06,18,3110,1016,2113,4244,4757,15240
2023-09-07,18,2227,2190,3782,3907,5425,17531
2023-09-08,18,3227,1323,2735,1519,2772,11576
2023-09-09,18,3989,1104,1876,2619,5824,15412
2023-09-10,18,3888,1926,3199,3045,2974,15032
2023-09-11,18,3620,2445,2554,1790,3664,14073
2023-09-12,18,4774,962,3244,3741,4456,17177
2023-09-13,18,4772,1443,3849,2294,5251,17609
2023-09-14,18,4892,1010,2497,2166,4965,15530
2023-09-15,18,2646,2536,2730,2417,4160,14489
2023-09-16,18,2746,1477,2704,1793,4668,13388
2023-09-17,18,3091,1067,2433,2989,3522,13102
2023-09-18,18,2005,1120,3860,3921,5141,16047
2023-09-19,18,1106,1064,1276,2895,2509,8850
2023-09-20,18,3401,1479,1953,3282,3211,13326
2023-09-21,18,3942,2980,1437,4409,5239,18007
2023-09-22,18,2762,1772,3463,2211,4379,14587
2023-09-23,18,4557,2858,3013,2626,4989,18043
2023-09-24,18,4036,1180,2199,2464,5168,15047
2023-09-25,18,2200,2328,2149,3394,3575,13646
2023-09-26,18,1870,1512,3932,3125,5080,15519
2023-09-27,18,4647,2160,3028,2941,3628,16404
2023-09-28,18,4564,1588,3545,3646,3790,17133
2023-09-29,18,3994,2776,1543,3508,2024,13845
2023-09-30,18,3777,1301,2340,3323,3427,14168
2023-10-01,18,3096,2470,1442,2100,4830,13938
2023-10-02,18,4572,1859,1651,2315,5535,15932
2023-10-03,18,4994,1714,3581,4438,4557,19284
2023-10-04,18,2360,1701,3193,3339,2555,13148
2023-10-05,18,1492,2049,1522,4268,3827,13158
2023-10-06,18,4262,1195,2882,2312,5019,15670
2023-10-07,18,1427,1496,1619,2926,2019,9487
2023-10-08,18,1380,1186,3114,3576,3150,12406
2023-10-09,18,2690,1743,1427,3791,3316,12967
2023-10-10,18,3565,2954,2612,3514,4348,16993
2023-10-11,18,4730,2527,3313,3952,2156,16678
2023-10-12,18,3288,1266,2385,1586,5336,13861
2023-10-13,18,2937,816,2754,4240,3037,13784
2023-10-14,18,3213,975,1739,2690,2536,11153
2023-10-15,18,1709,1670,3574,2616,5149,14718
2023-10-16,18,2461,1746,2133,3412,4090,13842
2023-10-17,18,3866,1722,1220,3447,2915,13170
2023-10-18,18,2589,2337,2230,3446,4531,15133
2023-10-19,18,2803,2422,2785,2619,4498,15127
2023-10-20,18,2268,2361,2212,3585,3007,13433
2023-10-21,18,2045,2657,3384,2717,3334,14137
2023-10-22,18,1284,1017,2188,3053,5077,12619
2023-10-23,18,1991,801,2884,3977,2565,12218
2023-10-24,18,1007,1375,3510,3245,2219,11356
2023-10-25,18,3767,2604,1491,4083,2970,14915
2023-10-26,18,4159,2406,1912,3964,4465,16906
2023-10-27,18,2800,1994,1727,3220,5857,15598
2023-10-28,18,1892,1811,2844,2172,2641,11360
2023-10-29,18,3775,2543,1630,2112,5055,15115
2023-10-30,18,3297,2784,3367,3970,3002,16420
2023-10-31,18,2017,2186,1278,2281,4090,11852
2023-11-01,18,2036,1650,1463,3743,5172,14064
2023-11-02,18,3078,1355,1745,3426,4011,13615
2023-11-03,18,4762,1759,3148,4296,3214,17179
2023-11-04,18,2275,1509,2021,3835,4521,14161
2023-11-05,18,3715,1715,1654,3841,5104,16029
2023-11-06,18,2541,2983,2620,4345,4336,16825
2023-11-07,18,4192,1815,2278,2232,5610,16127
2023-11-08,18,3359,1336,2779,3933,5175,16582
2023-11-09,18,3216,2789,2117,2868,3221,14211
2023-11-10,18,1294,2271,3751,3457,4233,15006
2023-11-11,18,2592,1577,2178,2999,3632,12978
2023-11-12,18,2977,1712,3867,2952,5430,16938
2023-11-13,18,4072,1850,3288,4260,4820,18290
2023-11-14,18,3561,1200,3729,4303,3817,16610
2023-11-15,18,3238,829,3304,3937,3616,14924
2023-11-16,18,3135,1893,2207,2610,2392,12237
2023-11-17,18,1640,2405,2542,2220,5817,14624
2023-11-18,18,3466,1962,3972,2622,4634,16656
2023-11-19,18,2537,1163,3277,3142,3733,13852
2023-11-20,18,3431,942,2574,2520,5639,15106
2023-11-21,18,3182,960,3478,1863,4593,14076
2023-11-22,18,4852,2762,2251,3721,5329,18915
2023-11-23,18,2137,2921,1513,2093,4508,13172
2023-11-24,18,2588,987,3494,3672,5492,16233
2023-11-25,18,1209,2328,1957,3261,3743,12498
2023-11-26,18,3665,1952,2467,3003,4229,15316
2023-11-27,18,2990,1071,2931,3899,3325,14216
2023-11-28,18,2773,1074,3684,2285,5812,15628
2023-11-29,18,1994,2818,1715,2959,5257,14743
2023-11-30,18,4263,1254,3997,3226,2197,14937
2023-12-01,18,4767,2251,1564,1994,2189,12765
2023-12-02,18,2870,1803,1341,2840,5507,14361
2023-12-03,18,4002,1658,1316,3067,3322,13365
2023-12-04,18,2575,1336,1309,4404,3319,12943
2023-12-05,18,3089,1557,2815,3148,2674,13283
2023-12-06,18,3113,1355,1261,2291,2858,10878
2023-12-07,18,2246,2785,2585,3543,5336,16495
2023-12-08,18,4260,2110,3333,1602,3886,15191
2023-12-09,18,4330,2096,3358,4063,2571,16418
2023-12-10,18,3379,2517,2484,4071,4201,16652
2023-12-11,18,2001,1399,3587,3293,2504,12784
2023-12-12,18,3123,2367,3672,3461,4214,16837
2023-12-13,18,3104,2970,3107,2698,4849,16728
2023-12-14,18,3665,2995,2312,1734,4673,15379
2023-12-15,18,3486,1047,1619,4064,4733,14949
2023-12-16,18,2906,1368,2026,3955,5669,15924
2023-12-17,18,1232,1364,2223,2447,3024,10290
2023-12-18,18,2701,2386,2006,3595,5750,16438
2023-12-19,18,3538,2371,2348,4486,2396,15139
2023-12-20,18,3974,2733,2901,3569,4709,17886
2023-12-21,18,3159,881,3451,4047,2197,13735
2023-12-22,18,4941,2230,3868,2276,2109,15424
2023-12-23,18,4642,1113,3396,3060,3335,15546
2023-12-24,18,2843,2092,2633,3688,2855,14111
2023-12-25,18,1678,2532,1318,4113,3643,13284
2023-12-26,18,4184,2782,3681,4355,3513,18515
2023-12-27,18,2907,1232,3371,3398,2367,13275
2023-12-28,18,2442,1626,2112,3306,4983,14469
2023-12-29,18,1420,1298,1569,4041,4154,12482
2023-12-30,18,1830,1468,2879,1978,3920,12075
2023-12-31,18,1731,2958,3604,2368,4552,15213
2022-01-01,19,4026,2254,1533,3362,2328,13503
2022-01-02,19,1885,1640,3753,1792,5787,14857
2022-01-03,19,4216,1185,1633,1719,3909,12662
2022-01-04,19,2213,1941,1577,1529,5619,12879
2022-01-05,19,1212,1188,3006,2189,3179,10774
2022-01-06,19,4117,1607,3477,3128,2522,14851
2022-01-07,19,1225,997,2399,2328,2024,8973
2022-01-08,19,4390,2753,3674,4090,5062,19969
2022-01-09,19,1784,2234,3260,1916,3242,12436
2022-01-10,19,2773,2785,1923,3398,3738,14617
2022-01-11,19,4526,1779,3977,1535,3779,15596
2022-01-12,19,4025,2365,1226,2758,4843,15217
2022-01-13,19,1986,2467,2334,4463,3112,14362
2022-01-14,19,3332,2406,3520,2164,2135,13557
2022-01-15,19,1737,1919,3534,4063,3469,14722
2022-01-16,19,1174,2662,1696,2505,5281,13318
2022-01-17,19,2853,1111,1531,2414,5394,13303
2022-01-18,19,2557,1907,3908,3628,5807,17807
2022-01-19,19,3597,1726,3339,2912,3122,14696
2022-01-20,19,1788,2852,2004,2024,5273,13941
2022-01-21,19,4320,2528,2207,3912,3647,16614
2022-01-22,19,1576,2714,2055,2226,3170,11741
2022-01-23,19,1993,1934,2919,2390,4236,13472
2022-01-24,19,4085,2088,2632,3137,3770,15712
2022-01-25,19,3420,2294,3016,3290,3290,15310
2022-01-26,19,3992,882,1691,3426,5704,15695
2022-01-27,19,1973,2452,3195,1648,5369,14637
2022-01-28,19,4943,2926,2195,1597,3869,15530
2022-01-29,19,3906,1820,1349,2774,4614,14463
2022-01-30,19,4778,1701,3948,4216,3110,17753
2022-01-31,19,4808,1688,2255,2760,5785,17296
2022-02-01,19,3211,2159,3112,2172,3818,14472
2022-02-02,19,1303,1164,1996,4283,4608,13354
2022-02-03,19,3058,1559,3230,3298,5307,16452
2022-02-04,19,3037,2834,2246,1575,3658,13350
2022-02-05,19,1872,2114,1391,1928,2088,9393
2022-02-06,19,1209,2178,1228,4437,4830,13882
2022-02-07,19,1470,2567,3256,3455,4257,15005
2022-02-08,19,3225,868,2465,4471,5546,16575
2022-02-09,19,1464,1320,3102,3408,4728,14022
2022-02-10,19,2135,1397,2083,2353,4686,12654
2022-02-11,19,4026,2517,2111,2628,3066,14348
2022-02-12,19,4445,1673,2654,1807,3730,14309
2022-02-13,19,4097,2915,1521,4010,5927,18470
2022-02-14,19,4741,1061,1966,3614,5425,16807
2022-02-15,19,1956,1292,3835,2739,4120,13942
2022-02-16,19,1182,2126,3899,3088,5482,15777
2022-02-17,19,1894,1809,3404,3825,5977,16909
2022-02-18,19,3459,1235,1881,3163,4897,14635
2022-02-19,19,3870,2763,1591,1513,2180,11917
2022-02-20,19,1817,1241,3446,1638,3078,11220
2022-02-21,19,3825,1697,1777,2324,2776,12399
2022-02-22,19,2494,2732,3520,2274,3139,14159
2022-02-23,19,4710,1938,2030,2263,5398,16339
2022-02-24,19,4107,1523,2232,3317,2254,13433
2022-02-25,19,3487,1086,2659,3021,4572,14825
2022-02-26,19,2702,2424,3776,1587,5112,15601
2022-02-27,19,2607,2168,3760,4051,4692,17278
2022-02-28,19,3884,2069,1787,3640,3499,14879
2022-03-01,19,2600,2849,3665,3441,5819,18374
2022-03-02,19,1852,1046,2191,3380,5164,13633
2022-03-03,19,1885,2259,2633,3006,4970,14753
2022-03-04,19,4490,2018,1655,4460,5146,17769
2022-03-05,19,2049,2144,3448,2307,2075,12023
2022-03-06,19,2821,2867,1234,4136,5316,16374
2022-03-07,19,3267,1549,3785,2013,3544,14158
2022-03-08,19,3831,2835,3740,3607,4028,18041
2022-03-09,19,1201,966,1216,3348,2150,8881
2022-03-10,19,4813,1456,3593,4080,3047,16989
2022-03-11,19,3069,2022,2720,4386,3414,15611
2022-03-12,19,2830,1013,2630,3726,4524,14723
2022-03-13,19,3318,2899,2250,2349,2841,13657
2022-03-14,19,3579,811,3352,1628,5088,14458
2022-03-15,19,4688,2509,2664,3968,5850,19679
2022-03-16,19,1080,2350,3698,3193,5393,15714
2022-03-17,19,4956,1306,1878,3019,3490,14649
2022-03-18,19,2145,2179,2991,2716,5957,15988
2022-03-19,19,2648,1692,3031,3187,2323,12881
2022-03-20,19,3291,922,2919,1901,3379,12412
2022-03-21,19,1263,1857,2497,3869,3038,12524
2022-03-22,19,2753,1098,1885,2572,4473,12781
2022-03-23,19,4753,2141,1200,2544,2476,13114
2022-03-24,19,1694,2051,1351,2503,4555,12154
2022-03-25,19,3663,1361,2022,2443,5908,15397
2022-03-26,19,2614,2558,1208,3248,2083,11711
2022-03-27,19,4945,2599,1619,3693,3282,16138
2022-03-28,19,3650,1816,2118,2197,4096,13877
2022-03-29,19,1132,1990,2818,2726,4627,13293
2022-03-30,19,2074,2535,3828,3892,5846,18175
2022-03-31,19,1683,950,3868,2900,5042,14443
2022-04-01,19,1630,2456,3120,3844,5641,16691
2022-04-02,19,3899,968,2576,4479,4319,16241
2022-04-03,19,4265,955,1414,3835,3247,13716
2022-04-04,19,1222,1792,3448,3806,4695,14963
2022-04-05,19,1795,1079,3986,1625,4854,13339
2022-04-06,19,3032,2282,2696,4010,2892,14912
2022-04-07,19,3420,2035,1948,3331,4177,14911
2022-04-08,19,3717,1608,3119,2419,5288,16151
2022-04-09,19,4443,2285,1202,1667,4355,13952
2022-04-10,19,1286,1168,2076,4410,4808,13748
2022-04-11,19,1507,2828,1329,1778,3913,11355
2022-04-12,19,4973,1135,3031,3057,5123,17319
2022-04-13,19,4227,1771,3547,3248,4837,17630
2022-04-14,19,4133,2801,2880,3790,3528,17132
2022-04-15,19,2011,1080,2103,3295,4742,13231
2022-04-16,19,2655,1591,1368,1554,5145,12313
2022-04-17,19,3727,1885,1423,4214,4931,16180
2022-04-18,19,3547,2678,2404,3876,4453,16958
2022-04-19,19,2585,2433,3211,1533,4700,14462
2022-04-20,19,1111,2234,3336,3344,4953,14978
2022-04-21,19,2511,805,3648,2895,2178,12037
2022-04-22,19,2047,2269,2726,3968,2503,13513
2022-04-23,19,3276,1584,1484,2146,2162,10652
2022-04-24,19,3035,1974,1895,3004,5526,15434
2022-04-25,19,4264,1702,2343,4024,2348,14681
2022-04-26,19,4710,2386,3665,1623,5971,18355
2022-04-27,19,3122,2268,1695,2345,2018,11448
2022-04-28,19,3175,2166,2765,3804,3016,14926
2022-04-29,19,2878,1333,3125,4242,3721,15299
2022-04-30,19,3010,1997,1936,3309,2254,12506
2022-05-01,19,2113,2483,1362,3322,4429,13709
2022-05-02,19,3155,2088,3417,3819,2564,15043
2022-05-03,19,1886,1205,3898,3444,3480,13913
2022-05-04,19,3908,905,3887,3013,5542,17255
2022-05-05,19,4617,1783,1316,1912,4784,14412
2022-05-06,19,4105,1075,1288,3158,5082,14708
2022-05-07,19,4710,1817,2003,2557,5656,16743
2022-05-08,19,1117,2076,2403,1701,4135,11432
2022-05-09,19,2205,1978,2966,3664,3701,14514
2022-05-10,19,3321,2991,2366,1753,2000,12431
2022-05-11,19,4542,1640,1705,2230,3407,13524
2022-05-12,19,2862,2141,1959,1581,2870,11413
2022-05-13,19,4702,2026,1550,1688,4890,14856
2022-05-14,19,3662,2941,3755,3436,5887,19681
2022-05-15,19,4853,1438,3386,3035,3858,16570
2022-05-16,19,3310,1357,2670,1978,4816,14131
2022-05-17,19,4376,2628,3756,2132,3478,16370
2022-05-18,19,4700,2149,3389,1983,3789,16010
2022-05-19,19,3096,2766,1751,3988,2845,14446
2022-05-20,19,1944,1272,1734,3980,4077,13007
2022-05-21,19,1982,2063,1232,3992,5182,14451
2022-05-22,19,3767,1568,2995,3587,5223,17140
2022-05-23,19,1956,1411,3973,1722,4628,13690
2022-05-24,19,3210,2300,2524,2774,3333,14141
2022-05-25,19,4568,2548,1723,3249,4635,16723
2022-05-26,19,4252,1986,1255,4243,4134,15870
2022-05-27,19,4338,2816,1979,2501,5762,17396
2022-05-28,19,4979,1798,2495,4458,2735,16465
2022-05-29,19,4541,1686,3405,3675,3462,16769
2022-05-30,19,4118,1042,2678,1644,3010,12492
2022-05-31,19,2908,1884,3019,1658,5505,14974
2022-06-01,19,1723,2132,2798,3378,4469,14500
2022-06-02,19,3995,2935,2225,2140,4650,15945
2022-06-03,19,3087,2582,1258,4474,5354,16755
2022-06-04,19,3385,2541,3980,4405,4002,18313
2022-06-05,19,4876,1941,3210,3465,4310,17802
2022-06-06,19,3976,2831,3463,3120,3975,17365
2022-06-07,19,3222,1275,3410,3649,4882,16438
2022-06-08,19,4421,2338,2471,3626,5407,18263
2022-06-09,19,3012,1717,1983,2537,4036,13285
2022-06-10,19,1975,1738,2224,4196,2144,12277
2022-06-11,19,3602,2596,2641,3033,3433,15305
2022-06-12,19,2790,1934,2524,4414,4670,16332
2022-06-13,19,1521,1289,3857,4246,4710,15623
2022-06-14,19,2198,2324,2877,2344,4161,13904
2022-06-15,19,4403,1936,1998,3030,2938,14305
2022-06-16,19,3317,1280,3941,4346,5268,18152
2022-06-17,19,3461,892,2365,4352,5202,16272
2022-06-18,19,2307,2353,1569,2047,3893,12169
2022-06-19,19,2522,2465,2723,3142,2612,13464
2022-06-20,19,1376,2885,3129,3467,3532,14389
2022-06-21,19,1794,1252,1668,4426,4192,13332
2022-06-22,19,2905,2796,2454,3775,3992,15922
2022-06-23,19,2552,2119,2233,4053,5054,16011
2022-06-24,19,2400,2986,2938,4232,2111,14667
2022-06-25,19,4290,961,3131,2614,4751,15747
2022-06-26,19,4280,1278,2460,2863,5239,16120
2022-06-27,19,3697,2631,3886,3929,4837,18980
2022-06-28,19,3311,2293,3948,2577,4752,16881
2022-06-29,19,1905,1487,2421,3835,3626,13274
2022-06-30,19,1728,2365,2896,3970,3157,14116
2022-07-01,19,4061,2865,1969,2404,2390,13689
2022-07-02,19,4558,2285,1872,2506,3506,14727
2022-07-03,19,3487,2974,2828,1513,4315,15117
2022-07-04,19,2737,2126,3252,3301,4323,15739
2022-07-05,19,1693,1981,3932,3012,5920,16538
2022-07-06,19,2028,1150,2449,2484,2771,10882
2022-07-07,19,3899,2788,2682,1737,5308,16414
2022-07-08,19,2726,2029,3925,1548,3439,13667
2022-07-09,19,1810,848,3723,3571,5514,15466
2022-07-10,19,2474,823,3869,1646,4375,13187
2022-07-11,19,1649,1294,3690,1787,5788,14208
2022-07-12,19,1618,1757,2141,3886,4068,13470
2022-07-13,19,2719,2227,3762,2812,2132,13652
2022-07-14,19,4000,2362,3132,2902,4085,16481
2022-07-15,19,1422,2058,3484,1607,5894,14465
2022-07-16,19,4702,2842,3421,2888,4819,18672
2022-07-17,19,4046,2148,2286,3237,4978,16695
2022-07-18,19,3105,1018,1813,1992,5441,13369
2022-07-19,19,3742,997,3134,4149,3797,15819
2022-07-20,19,4093,1738,1628,4076,4395,15930
2022-07-21,19,1161,1111,2635,2259,2806,9972
2022-07-22,19,4843,964,2341,3462,2438,14048
2022-07-23,19,3647,1428,3443,2471,5435,16424
2022-07-24,19,2711,1272,1296,3326,5960,14565
2022-07-25,19,1149,1436,1839,3917,5353,13694
2022-07-26,19,3370,2463,1565,2809,2095,12302
2022-07-27,19,1262,2896,2046,2437,2641,11282
2022-07-28,19,2997,2282,2429,3532,2262,13502
2022-07-29,19,4016,2759,1611,4078,2302,14766
2022-07-30,19,3299,974,3922,2235,2323,12753
2022-07-31,19,4498,1065,2461,2147,2502,12673
2022-08-01,19,1896,1357,3205,2287,3678,12423
2022-08-02,19,2888,822,2385,3211,4463,13769
2022-08-03,19,1621,800,2666,2289,4659,12035
2022-08-04,19,3486,2876,3606,2064,5608,17640
2022-08-05,19,3096,1449,3859,2756,5039,16199
2022-08-06,19,2623,1817,2057,4218,3174,13889
2022-08-07,19,1358,2549,1510,2395,5902,13714
2022-08-08,19,4468,2023,3975,4269,3276,18011
2022-08-09,19,2718,1280,2468,3505,4780,14751
2022-08-10,19,2242,2080,1883,2839,2863,11907
2022-08-11,19,2550,1017,2043,3119,3805,12534
2022-08-12,19,1716,811,1760,3604,3499,11390
2022-08-13,19,1924,1245,2037,1561,3449,10216
2022-08-14,19,3061,2803,3804,2285,3043,14996
2022-08-15,19,2151,1568,1460,2261,4730,12170
2022-08-16,19,2701,1089,1485,4197,2307,11779
2022-08-17,19,4098,2875,3875,2595,5916,19359
2022-08-18,19,1265,1335,2848,2278,4381,12107
2022-08-19,19,2519,1661,3033,2568,3898,13679
2022-08-20,19,3554,1793,3319,2282,5168,16116
2022-08-21,19,3874,1841,3872,2903,3791,16281
2022-08-22,19,2419,2904,3745,2833,2012,13913
2022-08-23,19,2640,1062,3599,3045,3461,13807
2022-08-24,19,4402,2790,2445,3056,2921,15614
2022-08-25,19,3501,2058,2111,4389,3068,15127
2022-08-26,19,2205,1665,1735,2567,5976,14148
2022-08-27,19,2034,1286,3549,2119,5111,14099
2022-08-28,19,1562,2296,3347,2608,2666,12479
2022-08-29,19,3631,802,3853,4397,4178,16861
2022-08-30,19,3330,1083,3881,3303,2254,13851
2022-08-31,19,2850,1999,3117,4262,3370,15598
2022-09-01,19,3160,865,3362,3551,5761,16699
2022-09-02,19,3543,922,3541,3111,5181,16298
2022-09-03,19,2386,1302,3921,2936,3653,14198
2022-09-04,19,1010,2573,1448,2958,4033,12022
2022-09-05,19,1825,2234,2133,2583,3486,12261
2022-09-06,19,1590,2587,2839,3219,3609,13844
2022-09-07,19,2905,883,1560,2035,3962,11345
2022-09-08,19,1095,2002,1546,2506,2779,9928
2022-09-09,19,4048,1543,2472,3312,2843,14218
2022-09-10,19,1049,982,3832,1632,3207,10702
2022-09-11,19,4634,2061,1878,3233,5899,17705
2022-09-12,19,2941,1033,1701,1725,2064,9464
2022-09-13,19,3014,2974,2332,1595,3356,13271
2022-09-14,19,1053,2799,2729,1547,4885,13013
2022-09-15,19,1550,978,1900,2697,4262,11387
2022-09-16,19,3142,842,2461,2942,4139,13526
2022-09-17,19,3260,2784,1733,4123,2037,13937
2022-09-18,19,1362,2824,3937,1618,4775,14516
2022-09-19,19,3111,1791,2466,1968,3352,12688
2022-09-20,19,4631,2817,3811,2627,5337,19223
2022-09-21,19,4590,2152,2981,3247,5629,18599
2022-09-22,19,3171,1321,3462,2088,2052,12094
2022-09-23,19,3216,1903,2382,3613,2598,13712
2022-09-24,19,2249,2986,1445,4149,4998,15827
2022-09-25,19,4301,2370,1745,2217,4745,15378
2022-09-26,19,1119,1569,3725,3931,4545,14889
2022-09-27,19,4000,2911,2788,2943,5227,17869
2022-09-28,19,1747,1238,3897,3743,4236,14861
2022-09-29,19,2423,1713,3905,3908,2026,13975
2022-09-30,19,3472,1393,3343,4479,3528,16215
2022-10-01,19,3322,837,3719,2606,2687,13171
2022-10-02,19,4566,1160,3811,3436,2379,15352
2022-10-03,19,3900,1012,3835,1768,3029,13544
2022-10-04,19,2064,2093,3820,3126,2298,13401
2022-10-05,19,3877,2171,2094,3627,5964,17733
2022-10-06,19,3621,2828,3963,2097,2922,15431
2022-10-07,19,3964,988,1259,2490,5073,13774
2022-10-08,19,2351,967,2594,4477,3940,14329
2022-10-09,19,3283,1370,2568,2598,3876,13695
2022-10-10,19,1277,1709,1520,3041,3636,11183
2022-10-11,19,3044,1944,1549,3373,4841,14751
2022-10-12,19,2487,2086,2430,2972,2737,12712
2022-10-13,19,1291,2249,3105,4011,3777,14433
2022-10-14,19,3682,2420,2802,1696,2123,12723
2022-10-15,19,4050,1963,3471,3799,3314,16597
2022-10-16,19,4015,2177,1518,3326,2454,13490
2022-10-17,19,4105,2134,2925,3430,3397,15991
2022-10-18,19,4127,1298,1799,2678,4354,14256
2022-10-19,19,3600,1744,3198,3212,5330,17084
2022-10-20,19,2952,2726,1903,1986,3001,12568
2022-10-21,19,3145,2782,3315,1504,4447,15193
2022-10-22,19,1485,843,1382,4457,5655,13822
2022-10-23,19,4995,2906,3223,3319,2531,16974
2022-10-24,19,1541,1924,2609,1623,4597,12294
2022-10-25,19,3338,2094,2008,1607,3638,12685
2022-10-26,19,3207,1262,1486,3366,3057,12378
2022-10-27,19,1745,1101,2010,2962,5259,13077
2022-10-28,19,2574,989,3685,2684,2640,12572
2022-10-29,19,4146,1469,1221,4364,4484,15684
2022-10-30,19,4713,1776,2777,3699,2942,15907
2022-10-31,19,1452,2136,2880,1766,2722,10956
2022-11-01,19,2572,2841,2908,1865,4267,14453
2022-11-02,19,4943,847,1876,1697,3536,12899
2022-11-03,19,1747,2515,1331,1527,4716,11836
2022-11-04,19,1481,2795,1732,3380,3390,12778
2022-11-05,19,1944,1648,2682,3904,3179,13357
2022-11-06,19,2316,2966,1830,1853,2075,11040
2022-11-07,19,4435,1997,1687,2560,4625,15304
2022-11-08,19,2929,2523,3381,2621,5052,16506
2022-11-09,19,1811,1136,3259,4409,5642,16257
2022-11-10,19,3284,967,2252,2928,3480,12911
2022-11-11,19,2174,2111,2913,4479,2666,14343
2022-11-12,19,2367,2753,2166,2487,5285,15058
2022-11-13,19,4819,2193,2234,3844,5499,18589
2022-11-14,19,1338,2256,2107,1598,2328,9627
2022-11-15,19,4712,2162,3918,3802,3688,18282
2022-11-16,19,2250,2322,3930,3879,4680,17061
2022-11-17,19,1474,1067,1271,3409,5560,12781
2022-11-18,19,4466,963,1753,1765,2585,11532
2022-11-19,19,4574,2330,2892,1741,3213,14750
2022-11-20,19,1909,1653,1635,3651,3747,12595
2022-11-21,19,3438,2792,3721,2750,2104,14805
2022-11-22,19,2196,2830,2214,1971,4296,13507
2022-11-23,19,2607,1935,3080,2237,2326,12185
2022-11-24,19,2760,1867,3890,2808,2917,14242
2022-11-25,19,4393,1312,2085,3870,4073,15733
2022-11-26,19,1767,2132,2412,3581,4919,14811
2022-11-27,19,2920,1785,2150,3299,5486,15640
2022-11-28,19,1440,1800,3850,2632,3473,13195
2022-11-29,19,4023,930,3027,3075,5215,16270
2022-11-30,19,4073,1365,3711,4102,2301,15552
2022-12-01,19,2186,2433,3480,1675,5018,14792
2022-12-02,19,4692,2440,2044,4154,2506,15836
2022-12-03,19,1341,2765,3590,3337,2931,13964
2022-12-04,19,1987,942,2608,2524,2542,10603
2022-12-05,19,4484,2281,2577,1694,5124,16160
2022-12-06,19,1280,1090,1979,4366,3359,12074
2022-12-07,19,2941,1693,3008,4472,4164,16278
2022-12-08,19,2176,1281,2477,1611,3714,11259
2022-12-09,19,4564,1421,1435,4342,3324,15086
2022-12-10,19,3758,1387,3939,4024,3222,16330
2022-12-11,19,2090,2727,1865,4455,5711,16848
2022-12-12,19,4683,1381,2286,3059,5903,17312
2022-12-13,19,3438,1142,1928,3240,3699,13447
2022-12-14,19,2853,1768,3610,2512,3537,14280
2022-12-15,19,3465,2250,3778,3497,5407,18397
2022-12-16,19,3708,986,2952,3869,4977,16492
2022-12-17,19,4335,2029,1306,1984,2055,11709
2022-12-18,19,4753,1924,2719,1742,2746,13884
2022-12-19,19,2004,1470,2853,3544,4188,14059
2022-12-20,19,1871,2327,1701,2748,3531,12178
2022-12-21,19,1761,2621,2908,3243,4602,15135
2022-12-22,19,1732,2407,2302,2308,3742,12491
2022-12-23,19,3346,1490,2735,4405,2107,14083
2022-12-24,19,3030,1480,3058,1742,3440,12750
2022-12-25,19,1935,2399,2041,4018,2592,12985
2022-12-26,19,2788,2134,3117,1852,5371,15262
2022-12-27,19,2664,2730,1349,1521,5462,13726
2022-12-28,19,1852,870,2707,4049,4544,14022
2022-12-29,19,3061,2862,3094,1985,5531,16533
2022-12-30,19,2255,1506,2730,2464,2261,11216
2022-12-31,19,1139,2423,2790,3623,3411,13386
2023-01-01,19,3031,1517,3894,3914,5552,17908
2023-01-02,19,4780,2249,1531,3620,5854,18034
2023-01-03,19,4599,1083,1337,2152,4492,13663
2023-01-04,19,2727,1510,1870,2916,2813,11836
2023-01-05,19,4316,2941,2857,3013,4394,17521
2023-01-06,19,1059,1793,2418,4105,3395,12770
2023-01-07,19,4505,2252,1369,2647,2800,13573
2023-01-08,19,2535,1275,3652,3796,3897,15155
2023-01-09,19,2615,2645,2273,2047,5821,15401
2023-01-10,19,3900,2687,1745,4270,3106,15708
2023-01-11,19,2315,1302,1699,3765,3318,12399
2023-01-12,19,3071,2026,1842,3942,4812,15693
2023-01-13,19,1270,1529,2882,2899,5093,13673
2023-01-14,19,2344,1870,3962,2476,5914,16566
2023-01-15,19,1448,1811,1816,4204,3216,12495
2023-01-16,19,4799,2826,2340,4137,5532,19634
2023-01-17,19,4192,1624,2791,2345,4313,15265
2023-01-18,19,1035,2914,3207,3390,3592,14138
2023-01-19,19,4418,980,2180,2533,2979,13090
2023-01-20,19,2660,2495,3775,2901,4698,16529
2023-01-21,19,2875,1295,3924,1918,3522,13534
2023-01-22,19,3659,2073,2004,2315,3839,13890
2023-01-23,19,3619,1244,2432,2925,4490,14710
2023-01-24,19,3805,2321,2781,4209,5553,18669
2023-01-25,19,4910,800,1500,3608,5612,16430
2023-01-26,19,4579,1666,1994,1797,5341,15377
2023-01-27,19,2192,974,2788,1601,3023,10578
2023-01-28,19,4596,1013,3627,3437,4645,17318
2023-01-29,19,1305,1423,2275,2638,4756,12397
2023-01-30,19,1058,2166,2208,1730,5823,12985
2023-01-31,19,2684,2039,2732,3781,5166,16402
2023-02-01,19,4219,1349,2722,3787,3359,15436
2023-02-02,19,4301,1870,3543,3890,3381,16985
2023-02-03,19,1910,2794,2385,3189,2641,12919
2023-02-04,19,3964,2940,2012,3461,2332,14709
2023-02-05,19,1508,979,3315,4071,5071,14944
2023-02-06,19,2006,2044,3694,3984,3418,15146
2023-02-07,19,1970,2149,2677,2131,2427,11354
2023-02-08,19,2904,2862,2113,2080,5890,15849
2023-02-09,19,3692,1145,1273,2235,4321,12666
2023-02-10,19,4491,1507,3886,2162,2355,14401
2023-02-11,19,3571,2206,2919,1772,3709,14177
2023-02-12,19,3339,1969,2786,1856,2561,12511
2023-02-13,19,2175,2690,1831,3943,4468,15107
2023-02-14,19,2572,2894,2340,2997,3409,14212
2023-02-15,19,3422,988,3692,2621,5921,16644
2023-02-16,19,3357,1470,1935,2263,2307,11332
2023-02-17,19,2794,1847,3373,2649,5060,15723
2023-02-18,19,1379,2527,1886,1875,3887,11554
2023-02-19,19,3103,2585,3749,4487,3352,17276
2023-02-20,19,2605,1991,2998,2478,4136,14208
2023-02-21,19,4979,1421,3932,3465,2319,16116
2023-02-22,19,3364,828,3064,3783,3962,15001
2023-02-23,19,1984,2277,2287,2564,5565,14677
2023-02-24,19,3539,2389,2696,3655,4590,16869
2023-02-25,19,2496,2624,3332,1500,2127,12079
2023-02-26,19,4102,1274,3542,2355,4442,15715
2023-02-27,19,3356,2082,1464,4499,2558,13959
2023-02-28,19,3968,2579,1628,2947,3312,14434
2023-03-01,19,1433,2894,3259,2443,5462,15491
2023-03-02,19,2052,2129,3698,1645,2911,12435
2023-03-03,19,4768,1196,2927,3133,2999,15023
2023-03-04,19,2624,1078,3752,2401,4795,14650
2023-03-05,19,1825,2726,3793,3699,2221,14264
2023-03-06,19,4002,1813,1858,1581,2267,11521
2023-03-07,19,4081,1451,1593,2955,5162,15242
2023-03-08,19,3739,2128,3740,4241,2045,15893
2023-03-09,19,2569,880,3099,2557,5407,14512
2023-03-10,19,3365,1041,1799,3064,3798,13067
2023-03-11,19,3761,869,2292,2647,4424,13993
2023-03-12,19,4205,2979,2518,2716,3564,15982
2023-03-13,19,1813,2644,3379,2398,2565,12799
2023-03-14,19,4220,2598,2801,1741,3326,14686
2023-03-15,19,3723,1018,2236,2955,2616,12548
2023-03-16,19,1577,1556,1712,3610,5160,13615
2023-03-17,19,3942,1047,2980,2829,3587,14385
2023-03-18,19,4647,2955,2034,2510,4695,16841
2023-03-19,19,4558,2890,3675,1949,5162,18234
2023-03-20,19,2354,1867,3711,3487,4775,16194
2023-03-21,19,3739,1189,2358,3694,4435,15415
2023-03-22,19,1063,2510,2731,3361,5461,15126
2023-03-23,19,3410,1311,2853,2127,2311,12012
2023-03-24,19,1829,841,1253,3374,3568,10865
2023-03-25,19,4996,1330,3067,3495,3504,16392
2023-03-26,19,1890,2394,2523,2859,5990,15656
2023-03-27,19,4451,867,1835,3453,4602,15208
2023-03-28,19,1000,1284,2618,2480,5412,12794
2023-03-29,19,4620,2476,3846,3359,4426,18727
2023-03-30,19,4194,2185,1778,3196,3640,14993
2023-03-31,19,2008,1197,1486,2156,4575,11422
2023-04-01,19,2951,1717,3522,4268,2699,15157
2023-04-02,19,4119,1876,3214,1663,4498,15370
2023-04-03,19,4248,1625,1926,3991,5000,16790
2023-04-04,19,3689,2479,3627,3807,3922,17524
2023-04-05,19,4163,1105,2267,4278,5941,17754
2023-04-06,19,3663,1692,2366,2579,3670,13970
2023-04-07,19,2452,2912,3458,3059,4800,16681
2023-04-08,19,3574,941,3756,2581,2987,13839
2023-04-09,19,1194,1908,3273,3632,2427,12434
2023-04-10,19,2172,2122,3356,3223,2549,13422
2023-04-11,19,4716,897,2589,4110,5485,17797
2023-04-12,19,3843,2750,3904,3696,4357,18550
2023-04-13,19,3933,913,2278,1923,4432,13479
2023-04-14,19,3991,2050,1283,4261,2289,13874
2023-04-15,19,1286,1521,3918,3285,2194,12204
2023-04-16,19,2638,2016,3035,1682,4084,13455
2023-04-17,19,1251,2048,1589,3161,2150,10199
2023-04-18,19,1357,2991,3840,3823,3993,16004
2023-04-19,19,1046,2792,2367,2528,2839,11572
2023-04-20,19,4014,1778,2807,4078,2275,14952
2023-04-21,19,2415,2511,3415,2880,3206,14427
2023-04-22,19,1167,920,1314,4042,4143,11586
2023-04-23,19,4709,1885,2801,3456,4266,17117
2023-04-24,19,1346,2785,2794,3412,3867,14204
2023-04-25,19,3579,940,2224,4077,4612,15432
2023-04-26,19,1248,2498,3425,3133,3880,14184
2023-04-27,19,4538,910,3391,2748,5255,16842
2023-04-28,19,1395,2370,2184,2232,3913,12094
2023-04-29,19,3546,1528,2684,3196,5036,15990
2023-04-30,19,2819,2972,2809,2371,5580,16551
2023-05-01,19,1017,2811,2071,3216,5120,14235
2023-05-02,19,1110,2854,2383,2321,4783,13451
2023-05-03,19,3417,894,1983,3856,3145,13295
2023-05-04,19,4553,846,2961,3100,3535,14995
2023-05-05,19,3042,1511,2233,2247,4873,13906
2023-05-06,19,2445,1447,2248,2040,4061,12241
2023-05-07,19,3304,1980,3550,2446,5229,16509
2023-05-08,19,4813,806,3545,1557,2251,12972
2023-05-09,19,3791,1975,3332,1951,4301,15350
2023-05-10,19,2426,1172,3736,4460,4234,16028
2023-05-11,19,1769,1496,2026,2004,2761,10056
2023-05-12,19,4540,2526,3895,3917,4567,19445
2023-05-13,19,2705,1104,2969,2845,5769,15392
2023-05-14,19,3097,2754,2314,3350,5662,17177
2023-05-15,19,4409,1499,2763,2545,3163,14379
2023-05-16,19,3663,2947,1326,3060,5368,16364
2023-05-17,19,2050,1724,2548,4071,5184,15577
2023-05-18,19,4666,2752,2090,2603,4379,16490
2023-05-19,19,1994,2726,1873,1557,5795,13945
2023-05-20,19,3847,1467,3158,4059,3430,15961
2023-05-21,19,4648,1521,2497,1570,4542,14778
2023-05-22,19,2359,1527,1522,3466,4901,13775
2023-05-23,19,4589,1773,1684,3712,4494,16252
2023-05-24,19,4821,1257,2975,4485,2706,16244
2023-05-25,19,4151,1872,1357,3693,2181,13254
2023-05-26,19,4080,2041,1231,1849,4024,13225
2023-05-27,19,4932,2166,1778,3311,4123,16310
2023-05-28,19,3130,2681,3189,1756,2474,13230
2023-05-29,19,4651,1230,1780,1636,4006,13303
2023-05-30,19,1726,2701,1211,4108,5979,15725
2023-05-31,19,3349,1705,1253,3943,5824,16074
2023-06-01,19,4694,1333,3767,3919,3815,17528
2023-06-02,19,1114,812,3627,2749,3080,11382
2023-06-03,19,2498,847,3173,3312,2234,12064
2023-06-04,19,1654,1389,3163,3503,5235,14944
2023-06-05,19,4203,1084,1277,3140,3663,13367
2023-06-06,19,3858,2800,2677,2507,5211,17053
2023-06-07,19,1776,1339,3852,2253,3790,13010
2023-06-08,19,1616,1869,3976,3193,3763,14417
2023-06-09,19,1954,1085,2148,1716,4648,11551
2023-06-10,19,2493,1353,3839,2695,2658,13038
2023-06-11,19,3689,1635,3780,3885,2071,15060
2023-06-12,19,3137,1719,1446,3743,4089,14134
2023-06-13,19,4125,1182,1358,3631,2605,12901
2023-06-14,19,3033,2557,1363,2568,2500,12021
2023-06-15,19,1780,1402,1799,4030,2253,11264
2023-06-16,19,3485,1691,2790,2886,5236,16088
2023-06-17,19,1093,1797,1204,3376,3169,10639
2023-06-18,19,2525,1315,3353,2848,2925,12966
2023-06-19,19,2568,1243,3417,3316,2476,13020
2023-06-20,19,4120,2804,1477,3350,3925,15676
2023-06-21,19,3896,2411,3079,3520,3864,16770
2023-06-22,19,4354,885,2013,3692,4405,15349
2023-06-23,19,3682,802,3294,1872,3536,13186
2023-06-24,19,4246,2125,1686,3731,2812,14600
2023-06-25,19,3250,2802,2468,2336,4351,15207
2023-06-26,19,2075,1807,1790,2636,3454,11762
2023-06-27,19,4942,2698,1814,3370,5295,18119
2023-06-28,19,2217,2397,2388,3426,5962,16390
2023-06-29,19,3668,1320,1688,3412,3581,13669
2023-06-30,19,2140,1241,3821,2132,4026,13360
2023-07-01,19,2237,2283,2342,3704,5876,16442
2023-07-02,19,4880,2938,1623,2961,5785,18187
2023-07-03,19,4905,944,2422,2508,5320,16099
2023-07-04,19,2957,1173,3458,4038,4769,16395
2023-07-05,19,3896,863,1822,4336,4985,15902
2023-07-06,19,3950,978,1689,3283,3874,13774
2023-07-07,19,1139,1660,3564,1808,4530,12701
2023-07-08,19,2478,823,3138,3736,2702,12877
2023-07-09,19,4472,2268,3374,3641,2769,16524
2023-07-10,19,2724,2197,2906,2177,4184,14188
2023-07-11,19,3987,1319,1822,2494,2480,12102
2023-07-12,19,1050,2844,2133,2162,4723,12912
2023-07-13,19,2493,1115,2421,3636,4150,13815
2023-07-14,19,4154,1537,3784,4357,4284,18116
2023-07-15,19,3818,2733,1301,2730,2315,12897
2023-07-16,19,3374,2963,2117,2442,3161,14057
2023-07-17,19,3930,2415,3449,3191,5705,18690
2023-07-18,19,1633,1125,2671,3391,4712,13532
2023-07-19,19,2647,2290,3392,3362,2103,13794
2023-07-20,19,1153,1418,3394,2533,5865,14363
2023-07-21,19,1820,2042,3091,1676,4512,13141
2023-07-22,19,4681,1746,1457,2931,4615,15430
2023-07-23,19,3737,1830,3991,2062,2015,13635
2023-07-24,19,3284,2161,3037,2494,3381,14357
2023-07-25,19,4638,2002,2312,4494,5606,19052
2023-07-26,19,3511,1974,3206,1958,3776,14425
2023-07-27,19,1848,1716,1704,1618,2659,9545
2023-07-28,19,3478,2347,2816,4008,3516,16165
2023-07-29,19,2373,1851,1719,4247,4482,14672
2023-07-30,19,2648,2891,2661,3794,4776,16770
2023-07-31,19,1649,1177,2628,3375,2900,11729
2023-08-01,19,2105,1755,3239,2601,2696,12396
2023-08-02,19,1154,1021,2443,1526,5692,11836
2023-08-03,19,1362,1193,2124,3089,3775,11543
2023-08-04,19,4383,1779,3033,3706,2680,15581
2023-08-05,19,3334,2885,3415,2347,5402,17383
2023-08-06,19,3089,2725,1928,4191,3962,15895
2023-08-07,19,4687,1433,3478,3999,2391,15988
2023-08-08,19,3097,1048,1686,4198,4628,14657
2023-08-09,19,2880,2423,2020,3453,4651,15427
2023-08-10,19,4117,2421,2453,2164,4252,15407
2023-08-11,19,2065,2672,2729,3428,3887,14781
2023-08-12,19,1316,2291,2646,2109,5674,14036
2023-08-13,19,2543,2585,1928,3757,5669,16482
2023-08-14,19,4046,2425,1616,3809,5607,17503
2023-08-15,19,3349,1109,3626,4282,2643,15009
2023-08-16,19,2667,1916,2275,1617,2660,11135
2023-08-17,19,4420,2162,3598,3450,3058,16688
2023-08-18,19,1938,1025,2336,4487,5045,14831
2023-08-19,19,2511,2779,2401,3402,5977,17070
2023-08-20,19,2786,1784,2578,3088,3900,14136
2023-08-21,19,2233,1584,2965,4148,2284,13214
2023-08-22,19,3194,1905,2007,1575,3606,12287
2023-08-23,19,1949,2946,2031,3114,2707,12747
2023-08-24,19,1128,1337,3425,2936,5373,14199
2023-08-25,19,4212,1784,2083,2268,3454,13801
2023-08-26,19,2745,2470,3655,1742,4697,15309
2023-08-27,19,3199,1354,3857,2558,4502,15470
2023-08-28,19,2333,1912,3640,3523,3264,14672
2023-08-29,19,4237,1381,3160,4055,4651,17484
2023-08-30,19,1456,1421,2016,3688,3637,12218
2023-08-31,19,1748,1682,1818,2239,4749,12236
2023-09-01,19,3337,2066,3902,1947,3011,14263
2023-09-02,19,1465,2251,2972,3399,3206,13293
2023-09-03,19,3946,2374,2260,2567,5759,16906
2023-09-04,19,1207,1335,3876,4046,5544,16008
2023-09-05,19,2930,1591,2486,2439,2176,11622
2023-09-06,19,2230,2017,2108,2943,5249,14547
2023-09-07,19,3393,1807,2480,3989,2443,14112
2023-09-08,19,3043,833,3177,2922,5954,15929
2023-09-09,19,2487,1393,3198,3827,3357,14262
2023-09-10,19,1803,2953,2348,2217,5279,14600
2023-09-11,19,3625,1662,1203,3186,2368,12044
2023-09-12,19,2431,2589,1968,1870,5939,14797
2023-09-13,19,4619,1218,3022,3275,3172,15306
2023-09-14,19,1992,1286,3216,2162,4735,13391
2023-09-15,19,2347,1912,2357,1904,2061,10581
2023-09-16,19,3922,1506,3972,1994,2773,14167
2023-09-17,19,4605,2026,3268,4185,5347,19431
2023-09-18,19,2776,823,1896,3922,4024,13441
2023-09-19,19,3180,2631,1343,2903,5488,15545
2023-09-20,19,1985,1118,3723,3736,3097,13659
2023-09-21,19,4784,2721,3334,2114,5066,18019
2023-09-22,19,1843,1916,3595,2190,2237,11781
2023-09-23,19,1196,1370,3478,4251,2811,13106
2023-09-24,19,1427,2864,2508,2993,5295,15087
2023-09-25,19,3893,2204,2017,3663,2533,14310
2023-09-26,19,4431,2752,2258,2021,2531,13993
2023-09-27,19,2948,1645,3442,2003,2025,12063
2023-09-28,19,4657,2581,3050,2001,2474,14763
2023-09-29,19,1674,2762,3104,1644,2819,12003
2023-09-30,19,1861,2077,2755,1924,5311,13928
2023-10-01,19,1886,1863,3293,2564,3100,12706
2023-10-02,19,2419,2468,3800,4473,3567,16727
2023-10-03,19,4179,1822,1200,4079,3690,14970
2023-10-04,19,2039,2171,1637,4148,4101,14096
2023-10-05,19,2692,1101,2624,3383,5728,15528
2023-10-06,19,4966,1393,3450,1790,2885,14484
2023-10-07,19,2950,2508,3971,2443,5514,17386
2023-10-08,19,1184,1794,2496,3741,2696,11911
2023-10-09,19,1260,1638,3178,3217,4203,13496
2023-10-10,19,2086,2367,1718,4288,4046,14505
2023-10-11,19,2492,1102,2739,2559,3053,11945
2023-10-12,19,1562,1052,1528,1797,2589,8528
2023-10-13,19,4696,2664,3072,4378,4455,19265
2023-10-14,19,2735,2147,2851,4289,2694,14716
2023-10-15,19,2925,2744,1418,4065,5280,16432
2023-10-16,19,3273,2608,1603,2449,5488,15421
2023-10-17,19,3912,2624,2154,3784,2834,15308
2023-10-18,19,3308,1889,3488,3484,4525,16694
2023-10-19,19,3328,989,3989,1803,4109,14218
2023-10-20,19,4699,936,3575,1748,3518,14476
2023-10-21,19,1825,2883,3882,2010,5840,16440
2023-10-22,19,3845,2911,3993,3620,2917,17286
2023-10-23,19,4809,2392,1975,3268,4614,17058
2023-10-24,19,3364,2307,2163,2493,3189,13516
2023-10-25,19,4807,982,3234,2782,5079,16884
2023-10-26,19,3362,897,2488,3563,4649,14959
2023-10-27,19,1242,2957,1202,3200,5268,13869
2023-10-28,19,2990,1890,1648,4364,4677,15569
2023-10-29,19,3173,2941,3924,2434,4779,17251
2023-10-30,19,3640,1304,1734,1657,5771,14106
2023-10-31,19,1591,1061,3289,1827,4791,12559
2023-11-01,19,3215,2686,3472,2344,4979,16696
2023-11-02,19,3831,2036,2761,2908,4185,15721
2023-11-03,19,2906,1561,3723,1755,2111,12056
2023-11-04,19,4821,939,3183,3218,3860,16021
2023-11-05,19,1284,1209,1405,1514,4608,10020
2023-11-06,19,3624,1014,2156,3349,4288,14431
2023-11-07,19,4868,1358,2414,2605,5368,16613
2023-11-08,19,3149,1394,2288,2411,5334,14576
2023-11-09,19,4031,1706,3163,3269,5885,18054
2023-11-10,19,2821,1326,2870,1827,4213,13057
2023-11-11,19,3197,1151,2387,3038,3414,13187
2023-11-12,19,2502,1089,3517,2979,4453,14540
2023-11-13,19,1013,1091,1444,3670,4827,12045
2023-11-14,19,1502,1276,3109,2137,3201,11225
2023-11-15,19,3683,1651,1833,4347,2362,13876
2023-11-16,19,3971,2964,3075,4361,2326,16697
2023-11-17,19,3579,1352,3502,2676,2508,13617
2023-11-18,19,4034,2193,3949,3543,5979,19698
2023-11-19,19,1043,2389,1656,3240,4929,13257
2023-11-20,19,3346,1729,3547,1865,2750,13237
2023-11-21,19,3188,2342,1457,4205,3825,15017
2023-11-22,19,4835,1291,2953,1917,2314,13310
2023-11-23,19,1838,2662,1723,4201,2243,12667
2023-11-24,19,1465,1508,3407,3536,3112,13028
2023-11-25,19,4813,937,3775,2348,5787,17660
2023-11-26,19,4369,2699,3666,2616,3167,16517
2023-11-27,19,3042,1941,2004,4089,2005,13081
2023-11-28,19,1555,2824,1536,2126,4522,12563
2023-11-29,19,1186,2554,1979,3465,4354,13538
2023-11-30,19,4092,2722,3971,2032,5411,18228
2023-12-01,19,3841,2238,3334,1963,5147,16523
2023-12-02,19,2543,2975,2041,1816,2073,11448
2023-12-03,19,3922,2579,1710,4343,5983,18537
2023-12-04,19,4312,1231,3293,3627,2974,15437
2023-12-05,19,1402,2950,3786,3336,3516,14990
2023-12-06,19,1432,988,2825,2784,5740,13769
2023-12-07,19,1052,1745,1359,4080,5571,13807
2023-12-08,19,4939,2400,2784,2192,2278,14593
2023-12-09,19,2727,1444,3676,4487,2633,14967
2023-12-10,19,2664,2961,3337,3676,3188,15826
2023-12-11,19,1234,1164,3522,1958,3500,11378
2023-12-12,19,2958,1395,1305,3348,2137,11143
2023-12-13,19,1073,1186,3860,2960,3352,12431
2023-12-14,19,3269,816,1681,3413,4810,13989
2023-12-15,19,4622,1304,2503,3658,2615,14702
2023-12-16,19,4308,1666,3532,4155,2781,16442
2023-12-17,19,2256,1096,2879,1659,4229,12119
2023-12-18,19,2018,1764,2394,2854,3572,12602
2023-12-19,19,1225,1292,2318,1620,3102,9557
2023-12-20,19,4778,835,2238,2866,3802,14519
2023-12-21,19,4968,1210,1213,3105,5256,15752
2023-12-22,19,2738,1831,2030,3275,3075,12949
2023-12-23,19,4204,1650,2543,3854,4926,17177
2023-12-24,19,4286,805,3203,1840,4044,14178
2023-12-25,19,2923,2190,1210,3260,3868,13451
2023-12-26,19,3702,2613,1314,2868,5301,15798
2023-12-27,19,2566,1816,2741,2115,2754,11992
2023-12-28,19,4790,876,2122,3936,5922,17646
2023-12-29,19,4297,2623,1855,2033,2773,13581
2023-12-30,19,3679,2771,3649,3886,2014,15999
2023-12-31,19,3233,968,1449,3295,2666,11611
2022-01-01,20,1822,2102,1617,2504,2999,11044
2022-01-02,20,2380,1446,2813,4078,3919,14636
2022-01-03,20,4007,2845,2758,1842,4124,15576
2022-01-04,20,1195,2697,2875,2757,2400,11924
2022-01-05,20,1678,1094,3262,3130,2811,11975
2022-01-06,20,2525,2560,3839,2715,3030,14669
2022-01-07,20,1199,968,2477,2335,3866,10845
2022-01-08,20,3055,2053,3948,2269,4828,16153
2022-01-09,20,2117,2018,3241,2865,4020,14261
2022-01-10,20,2137,1007,3030,2457,2421,11052
2022-01-11,20,1282,1645,2287,3355,2697,11266
2022-01-12,20,4477,1128,3157,2929,4896,16587
2022-01-13,20,4273,2865,3642,2829,5296,18905
2022-01-14,20,2227,2967,3344,4317,5233,18088
2022-01-15,20,3024,2185,2008,2315,5105,14637
2022-01-16,20,2557,1079,3392,2395,2228,11651
2022-01-17,20,3935,1835,2334,2075,2107,12286
2022-01-18,20,2212,2256,2177,4354,2317,13316
2022-01-19,20,2598,2723,2667,3358,5049,16395
2022-01-20,20,2359,2525,2726,2209,4677,14496
2022-01-21,20,1697,1570,3711,2363,5520,14861
2022-01-22,20,3458,1552,1736,1546,4672,12964
2022-01-23,20,3357,1473,1293,4094,3750,13967
2022-01-24,20,2115,1693,2976,4252,4590,15626
2022-01-25,20,3506,1692,1691,4003,2947,13839
2022-01-26,20,3155,1585,1596,4289,6000,16625
2022-01-27,20,2188,2289,2893,2773,3328,13471
2022-01-28,20,1946,1800,1682,2722,5174,13324
2022-01-29,20,4301,851,3839,1755,2657,13403
2022-01-30,20,2434,1765,3489,2529,4046,14263
2022-01-31,20,3943,1432,3068,2333,3315,14091
2022-02-01,20,2825,1549,2715,4137,3009,14235
2022-02-02,20,2976,2774,1679,4038,5180,16647
2022-02-03,20,2497,2261,2147,2865,5235,15005
2022-02-04,20,1895,2524,1383,1693,2009,9504
2022-02-05,20,4338,1905,1665,4070,4500,16478
2022-02-06,20,3556,1771,2510,3202,3418,14457
2022-02-07,20,2188,2857,1654,2630,5557,14886
2022-02-08,20,1506,1679,3244,2931,2361,11721
2022-02-09,20,2299,2864,2933,1665,2359,12120
2022-02-10,20,1693,1588,2914,2063,5772,14030
2022-02-11,20,1342,861,1257,1776,5411,10647
2022-02-12,20,3651,2219,1483,3278,3378,14009
2022-02-13,20,2417,2016,2587,4271,5861,17152
2022-02-14,20,4504,1855,2300,4018,3536,16213
2022-02-15,20,4491,2917,3399,3325,2963,17095
2022-02-16,20,2972,1435,2283,1747,5454,13891
2022-02-17,20,2667,1509,2270,1903,2095,10444
2022-02-18,20,4721,1967,2569,1825,5667,16749
2022-02-19,20,3656,1922,1995,4295,3892,15760
2022-02-20,20,2241,2829,1530,4450,4097,15147
2022-02-21,20,3186,1457,3676,3723,2490,14532
2022-02-22,20,3573,2970,3694,2152,3835,16224
2022-02-23,20,4162,1463,2687,4114,2234,14660
2022-02-24,20,1253,1269,2036,3659,5697,13914
2022-02-25,20,1018,2340,2887,3163,3401,12809
2022-02-26,20,4133,2477,3260,1827,4853,16550
2022-02-27,20,4119,1483,3403,3551,4474,17030
2022-02-28,20,1327,1282,2370,4036,3210,12225
2022-03-01,20,3952,2184,3680,2946,2471,15233
2022-03-02,20,1721,2304,1256,2294,2839,10414
2022-03-03,20,2337,1047,2578,4212,2187,12361
2022-03-04,20,1698,1874,2953,1728,2448,10701
2022-03-05,20,2668,1291,2954,3239,2925,13077
2022-03-06,20,4298,1364,3959,3336,2569,15526
2022-03-07,20,2764,1647,1688,2039,2103,10241
2022-03-08,20,2315,2425,2088,1750,5797,14375
2022-03-09,20,2133,2771,1916,4491,3537,14848
2022-03-10,20,2950,1251,3399,3199,4856,15655
2022-03-11,20,1471,1851,1845,4312,5494,14973
2022-03-12,20,2016,2845,2661,1743,3205,12470
2022-03-13,20,4515,1369,2902,3245,2699,14730
2022-03-14,20,2210,1048,2731,3865,4914,14768
2022-03-15,20,2924,1891,1860,2146,4160,12981
2022-03-16,20,4791,2805,3687,3136,2618,17037
2022-03-17,20,3403,953,3976,1789,2891,13012
2022-03-18,20,1432,1537,1214,2682,4777,11642
2022-03-19,20,3832,2248,2556,2302,4048,14986
2022-03-20,20,4107,2330,1689,1518,3183,12827
2022-03-21,20,2471,2928,2228,3093,5500,16220
2022-03-22,20,2448,2654,3212,2543,4913,15770
2022-03-23,20,2536,1282,2897,3489,4888,15092
2022-03-24,20,3742,1527,3327,3058,2271,13925
2022-03-25,20,3468,2222,3546,1836,3528,14600
2022-03-26,20,4829,2668,1335,3671,2390,14893
2022-03-27,20,1112,2541,3718,2088,4073,13532
2022-03-28,20,1133,2724,2937,3821,5242,15857
2022-03-29,20,1705,1806,1217,2302,5616,12646
2022-03-30,20,1762,1293,2423,2761,4674,12913
2022-03-31,20,4312,1825,2078,2548,3627,14390
2022-04-01,20,3439,2903,3388,4498,4296,18524
2022-04-02,20,2263,1322,3994,3629,5454,16662
2022-04-03,20,3849,1374,2630,3928,4903,16684
2022-04-04,20,2744,1505,1882,2816,5085,14032
2022-04-05,20,1290,1281,2020,3126,4037,11754
2022-04-06,20,4970,2617,2845,1753,4428,16613
2022-04-07,20,2878,1663,2933,2713,3631,13818
2022-04-08,20,2228,2940,3329,3820,3180,15497
2022-04-09,20,3477,1066,3733,3711,4675,16662
2022-04-10,20,4189,1195,3980,1681,4068,15113
2022-04-11,20,2917,2785,1719,4254,2927,14602
2022-04-12,20,2130,2594,2815,4453,3434,15426
2022-04-13,20,4835,1342,3905,4399,4242,18723
2022-04-14,20,2290,2637,3126,3307,5617,16977
2022-04-15,20,4906,1905,1951,2814,2619,14195
2022-04-16,20,1924,2143,1452,3366,5371,14256
2022-04-17,20,2368,1646,2983,3940,3477,14414
2022-04-18,20,3757,2355,3058,3041,4953,17164
2022-04-19,20,1327,1759,1331,2334,2420,9171
2022-04-20,20,1463,2924,3214,3552,4865,16018
2022-04-21,20,1089,1287,2867,2556,5122,12921
2022-04-22,20,1897,2461,2222,4274,3489,14343
2022-04-23,20,3642,2941,2898,3535,5926,18942
2022-04-24,20,4517,2939,2135,2686,4713,16990
2022-04-25,20,4933,1864,1531,2338,2074,12740
2022-04-26,20,1815,2964,2396,2476,2866,12517
2022-04-27,20,1759,1228,1559,4345,4016,12907
2022-04-28,20,4639,1880,3092,1503,3531,14645
2022-04-29,20,2756,2875,3495,2370,3166,14662
2022-04-30,20,2142,2149,3850,4017,3676,15834
2022-05-01,20,2517,1229,1223,2482,4729,12180
2022-05-02,20,2071,1420,3696,2053,5778,15018
2022-05-03,20,4585,1051,2093,3439,2325,13493
2022-05-04,20,1432,2943,2815,3708,3494,14392
2022-05-05,20,3214,1958,3716,2740,4353,15981
2022-05-06,20,3013,2455,2588,4046,3554,15656
2022-05-07,20,3233,1085,1899,4085,2312,12614
2022-05-08,20,3181,2866,2026,2327,4202,14602
2022-05-09,20,4179,2464,1656,2308,4873,15480
2022-05-10,20,2328,2469,1792,4393,3876,14858
2022-05-11,20,4023,2021,3574,4119,2044,15781
2022-05-12,20,4704,2890,2135,3282,5436,18447
2022-05-13,20,2256,2661,1930,3830,4616,15293
2022-05-14,20,1324,2292,1388,2072,5594,12670
2022-05-15,20,4780,2328,3133,3116,3529,16886
2022-05-16,20,2653,2627,2710,2965,4676,15631
2022-05-17,20,1114,1184,2719,3839,2918,11774
2022-05-18,20,4138,1571,2617,3112,3483,14921
2022-05-19,20,2387,950,2913,3104,5490,14844
2022-05-20,20,3888,1922,3922,1844,2489,14065
2022-05-21,20,4745,2180,3381,1741,3900,15947
2022-05-22,20,3098,2155,3090,4230,4570,17143
2022-05-23,20,1187,2335,2564,4040,5653,15779
2022-05-24,20,3289,1640,3140,2232,3251,13552
2022-05-25,20,4924,1130,3694,4149,5368,19265
2022-05-26,20,3913,1897,3831,2411,5311,17363
2022-05-27,20,3888,2149,1511,1931,5455,14934
2022-05-28,20,1310,2568,1788,3544,3247,12457
2022-05-29,20,4589,2833,3104,3593,5930,20049
2022-05-30,20,4518,2926,3988,3537,3575,18544
2022-05-31,20,3727,2929,1331,4360,5924,18271
2022-06-01,20,1305,1467,1944,3977,5293,13986
2022-06-02,20,4823,2288,3190,2884,4277,17462
2022-06-03,20,2011,845,2112,4293,5380,14641
2022-06-04,20,4112,2901,3920,2804,2979,16716
2022-06-05,20,3298,1233,3374,1545,5946,15396
2022-06-06,20,1212,2999,3539,3483,4514,15747
2022-06-07,20,4988,2956,1453,3941,3049,16387
2022-06-08,20,2311,1768,3517,3119,5418,16133
2022-06-09,20,3962,2557,3305,3995,4216,18035
2022-06-10,20,2756,2880,2874,2007,5241,15758
2022-06-11,20,2663,1371,2574,4096,3302,14006
2022-06-12,20,2870,1389,2914,1866,4993,14032
2022-06-13,20,3158,2219,2298,3761,4950,16386
2022-06-14,20,1021,2887,2875,3810,3035,13628
2022-06-15,20,1364,1437,1344,3185,2767,10097
2022-06-16,20,2915,1612,3262,3776,4756,16321
2022-06-17,20,4455,2675,3174,1502,5939,17745
2022-06-18,20,1545,2610,2437,3995,5861,16448
2022-06-19,20,1114,2228,3343,3203,2237,12125
2022-06-20,20,2294,1205,1724,2764,4938,12925
2022-06-21,20,3256,2838,3517,2656,3028,15295
2022-06-22,20,4993,1202,1649,2827,3280,13951
2022-06-23,20,4790,2062,3886,4217,3967,18922
2022-06-24,20,3538,2514,2502,2877,3921,15352
2022-06-25,20,3093,2202,1946,3336,4462,15039
2022-06-26,20,4026,1119,3713,2267,5507,16632
2022-06-27,20,3281,994,2907,2886,3201,13269
2022-06-28,20,1972,1675,2777,2370,4633,13427
2022-06-29,20,4028,2266,2422,2319,2295,13330
2022-06-30,20,2842,2581,2098,3673,4418,15612
2022-07-01,20,2235,1409,3623,3971,2313,13551
2022-07-02,20,3064,1244,1970,2671,3306,12255
2022-07-03,20,1275,2887,1555,3650,3197,12564
2022-07-04,20,2230,2399,2746,3303,2231,12909
2022-07-05,20,1429,2127,3012,3306,3650,13524
2022-07-06,20,2058,2864,1884,1840,5408,14054
2022-07-07,20,3275,2820,1284,4473,5648,17500
2022-07-08,20,1014,1307,2790,3411,4586,13108
2022-07-09,20,4585,2784,3553,1867,5432,18221
2022-07-10,20,4082,2007,3769,2212,3429,15499
2022-07-11,20,3529,1849,2395,1947,5515,15235
2022-07-12,20,3275,1477,2341,3680,2601,13374
2022-07-13,20,1145,2485,2787,3759,2358,12534
2022-07-14,20,2723,2493,1610,1850,3586,12262
2022-07-15,20,2778,2823,3664,2356,2203,13824
2022-07-16,20,4889,2231,3196,3615,2500,16431
2022-07-17,20,1364,2604,3618,2323,3568,13477
2022-07-18,20,3915,1556,2039,3817,3233,14560
2022-07-19,20,1449,1517,2701,3307,3214,12188
2022-07-20,20,3984,1606,1944,3317,2864,13715
2022-07-21,20,1046,1056,1301,2293,3115,8811
2022-07-22,20,4945,2929,1365,3853,2631,15723
2022-07-23,20,4438,1351,2294,3598,4059,15740
2022-07-24,20,4296,1098,3498,2740,5943,17575
2022-07-25,20,1380,2240,3642,3612,2274,13148
2022-07-26,20,3244,2886,3033,2747,2343,14253
2022-07-27,20,4036,882,3455,4266,4351,16990
2022-07-28,20,4244,2330,3349,3984,2014,15921
2022-07-29,20,3562,1182,1596,2462,2742,11544
2022-07-30,20,1664,2867,2420,4034,2721,13706
2022-07-31,20,4311,2887,3588,2965,3120,16871
2022-08-01,20,1182,2563,2510,3480,5343,15078
2022-08-02,20,1131,1329,2171,1886,5767,12284
2022-08-03,20,4236,2625,1800,4031,3986,16678
2022-08-04,20,3207,2385,1996,4500,2475,14563
2022-08-05,20,2550,1185,3142,3193,3528,13598
2022-08-06,20,4882,2657,3347,4065,3735,18686
2022-08-07,20,3194,2434,2360,2654,5021,15663
2022-08-08,20,4688,1793,2382,2317,4942,16122
2022-08-09,20,2337,2665,3496,3317,4451,16266
2022-08-10,20,2456,2246,3295,1926,2447,12370
2022-08-11,20,1053,1333,1283,2026,4803,10498
2022-08-12,20,4055,2805,3914,4279,4484,19537
2022-08-13,20,1740,1382,2650,4277,3359,13408
2022-08-14,20,4810,2804,1612,2259,5654,17139
2022-08-15,20,3453,2818,1443,3169,5197,16080
2022-08-16,20,2503,1744,2312,3023,3628,13210
2022-08-17,20,3897,1231,2553,4349,4086,16116
2022-08-18,20,2837,1760,2431,1742,3942,12712
2022-08-19,20,4019,1394,2614,2369,5765,16161
2022-08-20,20,3285,2583,1802,2253,2373,12296
2022-08-21,20,3097,1089,1982,3510,2577,12255
2022-08-22,20,4830,2325,2228,3301,5241,17925
2022-08-23,20,2129,2150,1684,3990,5477,15430
2022-08-24,20,1973,2867,2922,2512,3457,13731
2022-08-25,20,2114,1057,1888,4059,2789,11907
2022-08-26,20,2885,2335,2878,1697,4162,13957
2022-08-27,20,1391,2879,1418,2950,4993,13631
2022-08-28,20,1840,1903,2125,2523,2398,10789
2022-08-29,20,4915,1726,3652,1906,4905,17104
2022-08-30,20,3669,1307,1440,2632,4594,13642
2022-08-31,20,4616,926,3372,2153,3337,14404
2022-09-01,20,1340,1506,2410,1762,5949,12967
2022-09-02,20,1058,1591,1348,3494,4885,12376
2022-09-03,20,4876,2244,3951,3708,4041,18820
2022-09-04,20,3025,2705,3350,3251,2980,15311
2022-09-05,20,2136,2563,1428,1989,3416,11532
2022-09-06,20,2046,2964,1857,3817,2150,12834
2022-09-07,20,2121,2014,3810,4312,3845,16102
2022-09-08,20,3783,1531,3859,4193,5593,18959
2022-09-09,20,4177,1649,1696,3727,2147,13396
2022-09-10,20,2370,1745,2915,3726,4330,15086
2022-09-11,20,3331,1591,3881,1848,3600,14251
2022-09-12,20,4991,1431,3853,3773,2536,16584
2022-09-13,20,1260,1852,3956,2557,2117,11742
2022-09-14,20,1624,922,3807,1937,3130,11420
2022-09-15,20,3314,2326,1308,2309,2972,12229
2022-09-16,20,3645,2969,3641,1748,3480,15483
2022-09-17,20,1488,2986,2303,3673,2829,13279
2022-09-18,20,1842,2236,3013,2687,2568,12346
2022-09-19,20,2092,1502,2097,1915,5417,13023
2022-09-20,20,1642,1431,2542,2297,4821,12733
2022-09-21,20,1141,2230,3257,3061,3833,13522
2022-09-22,20,4879,1122,1544,3530,2683,13758
2022-09-23,20,3193,1862,3948,2251,5074,16328
2022-09-24,20,1526,1349,3077,4233,2966,13151
2022-09-25,20,3197,1061,3358,2299,3288,13203
2022-09-26,20,1332,2838,1367,2023,2448,10008
2022-09-27,20,2379,1690,3807,4098,3969,15943
2022-09-28,20,1461,2086,1761,2153,3359,10820
2022-09-29,20,3435,1700,1625,2543,5494,14797
2022-09-30,20,2790,2984,2793,2874,4793,16234
2022-10-01,20,4378,2090,1410,4444,3725,16047
2022-10-02,20,1282,2763,3683,2469,4767,14964
2022-10-03,20,2179,2831,1468,2678,5621,14777
2022-10-04,20,1500,2137,2118,1922,5457,13134
2022-10-05,20,1789,2734,3977,2318,4857,15675
2022-10-06,20,1587,2011,3488,3537,3028,13651
2022-10-07,20,2543,904,1898,3646,4741,13732
2022-10-08,20,4305,1227,1952,2043,3610,13137
2022-10-09,20,4057,1775,1630,1841,4957,14260
2022-10-10,20,1653,1419,1266,2425,4665,11428
2022-10-11,20,3258,1774,3256,4232,4366,16886
2022-10-12,20,4999,2914,3203,2719,3132,16967
2022-10-13,20,3662,2131,2104,3741,3572,15210
2022-10-14,20,4146,1049,2001,3808,4520,15524
2022-10-15,20,4823,2679,2417,3235,4172,17326
2022-10-16,20,1833,949,3762,3774,4748,15066
2022-10-17,20,2285,2141,1216,4212,2513,12367
2022-10-18,20,3203,2116,1540,3384,3492,13735
2022-10-19,20,4557,1082,2010,3922,4611,16182
2022-10-20,20,1135,2596,1518,4389,2264,11902
2022-10-21,20,2891,2470,2502,2135,4135,14133
2022-10-22,20,1160,1260,1396,3852,3795,11463
2022-10-23,20,4193,2937,2384,3682,3495,16691
2022-10-24,20,3424,2350,2984,3109,4128,15995
2022-10-25,20,2255,2447,3671,3944,4908,17225
2022-10-26,20,2898,2908,3686,2851,2275,14618
2022-10-27,20,3237,922,3083,1501,5361,14104
2022-10-28,20,1528,1386,3351,2107,2818,11190
2022-10-29,20,3883,1001,1412,3583,2077,11956
2022-10-30,20,2237,1659,2737,4004,4903,15540
2022-10-31,20,1937,1001,2053,4194,4845,14030
2022-11-01,20,1944,1560,3565,2940,5196,15205
2022-11-02,20,2862,816,2703,3714,4708,14803
2022-11-03,20,4525,988,3312,3049,4870,16744
2022-11-04,20,2812,2840,1506,3225,3707,14090
2022-11-05,20,4687,2417,2416,2148,2600,14268
2022-11-06,20,4320,2330,3691,2081,5199,17621
2022-11-07,20,3212,2627,2361,1567,5632,15399
2022-11-08,20,1472,1927,1694,3792,3960,12845
2022-11-09,20,1322,2520,2510,2752,3036,12140
2022-11-10,20,3527,2451,1249,2583,2024,11834
2022-11-11,20,4834,1210,3618,4423,4752,18837
2022-11-12,20,4222,1563,2437,3251,4308,15781
2022-11-13,20,4525,2446,3955,2172,3347,16445
2022-11-14,20,1101,1835,3510,1929,3330,11705
2022-11-15,20,4523,969,3067,4008,5494,18061
2022-11-16,20,3113,2985,1321,2629,5786,15834
2022-11-17,20,4130,1440,1610,2585,4314,14079
2022-11-18,20,4484,1160,2240,3941,4173,15998
2022-11-19,20,1227,1032,2602,1980,5736,12577
2022-11-20,20,4197,1147,3139,2461,5503,16447
2022-11-21,20,1892,1720,2055,2763,3398,11828
2022-11-22,20,3416,1387,2793,4280,3074,14950
2022-11-23,20,4715,832,2616,1673,4723,14559
2022-11-24,20,4535,1047,2038,2729,4561,14910
2022-11-25,20,2280,2826,3062,2334,2210,12712
2022-11-26,20,4975,2651,2300,3127,3756,16809
2022-11-27,20,1159,2365,1642,3214,3080,11460
2022-11-28,20,2241,1464,3105,3168,5530,15508
2022-11-29,20,2723,1410,2271,3458,5262,15124
2022-11-30,20,2129,2847,1412,1567,5396,13351
2022-12-01,20,1235,2786,1304,3520,3662,12507
2022-12-02,20,1297,2505,3502,2439,2333,12076
2022-12-03,20,1872,1974,2614,3585,5070,15115
2022-12-04,20,2605,1486,1921,3871,5966,15849
2022-12-05,20,4210,2834,3503,1928,4541,17016
2022-12-06,20,4901,918,3580,3866,2952,16217
2022-12-07,20,3445,2105,1442,2699,3797,13488
2022-12-08,20,3887,1268,3189,2588,5304,16236
2022-12-09,20,3034,2670,1289,4221,3820,15034
2022-12-10,20,4568,2813,3055,1915,5048,17399
2022-12-11,20,2157,2346,2758,2526,2448,12235
2022-12-12,20,1705,922,2707,2346,3543,11223
2022-12-13,20,1052,1601,1984,4405,4933,13975
2022-12-14,20,3395,2391,1292,3221,4593,14892
2022-12-15,20,2365,2024,3185,2203,4907,14684
2022-12-16,20,1350,2787,2810,3262,2407,12616
2022-12-17,20,3383,991,2457,1865,3401,12097
2022-12-18,20,3735,1891,3822,1952,5125,16525
2022-12-19,20,2732,2128,2899,2468,3357,13584
2022-12-20,20,2801,1667,2034,3731,3089,13322
2022-12-21,20,3206,2315,3533,1511,3326,13891
2022-12-22,20,3237,2544,2695,2712,4203,15391
2022-12-23,20,1721,2593,1542,2302,3905,12063
2022-12-24,20,1197,985,3024,4328,2574,12108
2022-12-25,20,3373,1856,1848,4068,5200,16345
2022-12-26,20,4979,911,2455,2398,4880,15623
2022-12-27,20,2545,2878,1791,4498,2178,13890
2022-12-28,20,3677,1284,3589,3765,2695,15010
2022-12-29,20,1783,2571,1482,2456,3396,11688
2022-12-30,20,4988,2236,2973,4011,3568,17776
2022-12-31,20,4953,2872,2841,3560,4916,19142
2023-01-01,20,4461,2630,2351,2596,2969,15007
2023-01-02,20,2510,2134,1221,3682,2361,11908
2023-01-03,20,2553,2417,2318,4058,4917,16263
2023-01-04,20,1837,2296,1297,2288,5298,13016
2023-01-05,20,2362,2694,1739,2129,4529,13453
2023-01-06,20,1105,2318,2241,2460,4736,12860
2023-01-07,20,4978,2157,1346,3031,2071,13583
2023-01-08,20,2977,2869,1758,3759,5491,16854
2023-01-09,20,3955,1397,2434,3112,4824,15722
2023-01-10,20,2785,2102,3986,3497,3331,15701
2023-01-11,20,2821,1105,3234,3740,2030,12930
2023-01-12,20,2052,1151,3040,2974,2368,11585
2023-01-13,20,3712,973,2029,2241,4520,13475
2023-01-14,20,4646,2545,1877,2769,2586,14423
2023-01-15,20,2563,2706,1391,2036,4432,13128
2023-01-16,20,3236,1105,3996,3938,3346,15621
2023-01-17,20,1840,2153,2440,1763,5572,13768
2023-01-18,20,2310,2791,2666,2512,3863,14142
2023-01-19,20,2084,2106,3540,3589,4040,15359
2023-01-20,20,4843,2578,1549,3938,5353,18261
2023-01-21,20,1743,2778,2793,4342,5380,17036
2023-01-22,20,1646,904,3734,1664,3844,11792
2023-01-23,20,2927,2803,3458,3168,3848,16204
2023-01-24,20,4719,1795,2498,2652,2604,14268
2023-01-25,20,3027,2708,3914,1952,4785,16386
2023-01-26,20,1571,1303,2437,2322,4242,11875
2023-01-27,20,3226,1405,3008,1505,3939,13083
2023-01-28,20,2768,1029,2789,4277,4259,15122
2023-01-29,20,1499,2413,3579,2379,5690,15560
2023-01-30,20,3681,2126,1419,4165,5225,16616
2023-01-31,20,4548,1656,3317,3173,3845,16539
2023-02-01,20,3412,2990,2258,4480,4356,17496
2023-02-02,20,4987,2822,1252,2129,5068,16258
2023-02-03,20,3801,2709,1726,2991,5755,16982
2023-02-04,20,2331,2220,2816,4089,4434,15890
2023-02-05,20,3014,1148,2610,4253,2081,13106
2023-02-06,20,3155,2339,1612,3376,3315,13797
2023-02-07,20,1131,2456,3289,2660,5516,15052
2023-02-08,20,3292,1558,2779,2344,2820,12793
2023-02-09,20,2129,2165,2049,3908,5278,15529
2023-02-10,20,3398,1059,2839,1915,2753,11964
2023-02-11,20,2566,1559,3515,1922,4347,13909
2023-02-12,20,4241,2261,3290,2137,5425,17354
2023-02-13,20,2231,1251,3342,2746,4512,14082
2023-02-14,20,3377,1078,3970,2496,2909,13830
2023-02-15,20,4065,2046,2572,1624,4775,15082
2023-02-16,20,2241,2268,2086,1530,3957,12082
2023-02-17,20,3415,2487,2394,2499,4585,15380
2023-02-18,20,2487,1116,3361,4062,5264,16290
2023-02-19,20,3193,1148,3586,3996,2618,14541
2023-02-20,20,4025,1435,1825,1899,2532,11716
2023-02-21,20,3202,2440,1693,3848,2491,13674
2023-02-22,20,4873,1698,2887,3269,5499,18226
2023-02-23,20,4475,924,1729,2337,4908,14373
2023-02-24,20,2002,1637,2193,3043,2606,11481
2023-02-25,20,1820,1368,3013,4221,3104,13526
2023-02-26,20,1679,1927,1320,4044,3436,12406
2023-02-27,20,3143,1313,3390,2580,2170,12596
2023-02-28,20,3673,1930,3868,2727,5105,17303
2023-03-01,20,2592,1942,3249,3017,3000,13800
2023-03-02,20,4833,863,2003,2721,2937,13357
2023-03-03,20,3823,1621,2231,1640,2855,12170
2023-03-04,20,4321,976,1569,2081,4479,13426
2023-03-05,20,4323,1898,3951,1653,2539,14364
2023-03-06,20,1637,1248,1646,3298,3637,11466
2023-03-07,20,2420,1901,3084,3577,4227,15209
2023-03-08,20,1993,1537,3252,3251,2331,12364
2023-03-09,20,2904,2118,2618,1634,4182,13456
2023-03-10,20,3036,1801,2132,3204,4474,14647
2023-03-11,20,3578,2062,2962,2959,5645,17206
2023-03-12,20,1725,2166,1885,2439,3982,12197
2023-03-13,20,1792,1684,3919,4394,5427,17216
2023-03-14,20,4911,2670,3624,2590,2953,16748
2023-03-15,20,1304,2007,1261,4029,3316,11917
2023-03-16,20,1426,1430,2667,1532,4439,11494
2023-03-17,20,3761,2051,3161,2717,3998,15688
2023-03-18,20,1300,1489,1237,1507,2403,7936
2023-03-19,20,4170,1272,3490,1821,3427,14180
2023-03-20,20,3982,826,3715,2078,4927,15528
2023-03-21,20,1058,1800,3896,2120,4385,13259
2023-03-22,20,1475,885,2996,4166,3244,12766
2023-03-23,20,4006,1707,2098,2767,5215,15793
2023-03-24,20,1275,2883,1342,1667,2134,9301
2023-03-25,20,2523,1262,2241,2175,2664,10865
2023-03-26,20,3502,2981,3734,3577,4302,18096
2023-03-27,20,3725,2779,1443,4085,5835,17867
2023-03-28,20,2325,977,2883,2728,2870,11783
2023-03-29,20,2851,2567,1991,2995,3609,14013
2023-03-30,20,1637,839,2089,3461,2149,10175
2023-03-31,20,2336,1392,1290,2550,3988,11556
2023-04-01,20,2438,2248,3894,3236,2914,14730
2023-04-02,20,2635,1667,2302,4225,2985,13814
2023-04-03,20,2136,2252,3583,3009,5325,16305
2023-04-04,20,1548,2711,3375,3432,4209,15275
2023-04-05,20,2797,998,2472,4056,2249,12572
2023-04-06,20,4809,2836,2156,1586,3016,14403
2023-04-07,20,1252,2497,2395,4182,2776,13102
2023-04-08,20,4856,2620,2382,3521,4217,17596
2023-04-09,20,4404,2132,1931,3730,4793,16990
2023-04-10,20,3006,2310,1762,2207,4502,13787
2023-04-11,20,4866,2775,2467,4417,4229,18754
2023-04-12,20,2113,1995,3142,2629,5306,15185
2023-04-13,20,2078,1959,2977,4266,2028,13308
2023-04-14,20,1045,1884,3042,4485,5083,15539
2023-04-15,20,1912,842,2636,4486,3576,13452
2023-04-16,20,2219,2250,3872,2392,3213,13946
2023-04-17,20,1607,2255,2017,3328,5190,14397
2023-04-18,20,4522,1628,2778,1991,3557,14476
2023-04-19,20,4439,873,2334,2807,3489,13942
2023-04-20,20,4718,1432,3006,2436,4574,16166
2023-04-21,20,1377,2420,3229,2786,3420,13232
2023-04-22,20,1068,1278,1447,3432,2154,9379
2023-04-23,20,4680,2381,3090,2608,2068,14827
2023-04-24,20,2648,2519,1500,3413,3368,13448
2023-04-25,20,1348,2207,3243,4337,3059,14194
2023-04-26,20,3137,912,3059,2652,2293,12053
2023-04-27,20,4547,1424,2663,4242,2813,15689
2023-04-28,20,3334,2840,3223,3281,4555,17233
2023-04-29,20,2620,1477,2468,2274,5956,14795
2023-04-30,20,3184,1763,1810,3025,5718,15500
2023-05-01,20,4883,981,1931,3701,3617,15113
2023-05-02,20,3653,1129,3972,3790,5517,18061
2023-05-03,20,1374,1585,1826,1756,4598,11139
2023-05-04,20,1295,1515,1861,2997,3041,10709
2023-05-05,20,1051,1884,2216,3075,5223,13449
2023-05-06,20,4724,2150,3637,2314,3237,16062
2023-05-07,20,1644,3000,3785,3238,5160,16827
2023-05-08,20,1627,1825,2425,4381,3810,14068
2023-05-09,20,3771,1424,1337,2037,2362,10931
2023-05-10,20,3107,2502,1641,3200,3098,13548
2023-05-11,20,4572,2955,1488,2671,3014,14700
2023-05-12,20,4294,1618,3835,4390,2649,16786
2023-05-13,20,4655,1644,3272,3276,5652,18499
2023-05-14,20,1650,1442,3073,1979,3035,11179
2023-05-15,20,3731,1255,2052,3530,5939,16507
2023-05-16,20,4770,1404,3406,2143,3263,14986
2023-05-17,20,3967,2016,3215,3134,3062,15394
2023-05-18,20,2883,2452,2614,2416,4607,14972
2023-05-19,20,2511,2878,1439,3502,5890,16220
2023-05-20,20,2365,991,3983,2346,4833,14518
2023-05-21,20,2421,2738,3440,2960,4535,16094
2023-05-22,20,4391,2590,3979,3085,2524,16569
2023-05-23,20,4642,2087,1763,4090,3561,16143
2023-05-24,20,1741,2491,2603,3887,2947,13669
2023-05-25,20,1214,1195,3612,2846,5452,14319
2023-05-26,20,3090,1905,2186,3732,3116,14029
2023-05-27,20,3860,1700,2698,2263,3631,14152
2023-05-28,20,2786,2605,2173,3294,2028,12886
2023-05-29,20,3163,2544,3872,2613,4538,16730
2023-05-30,20,1817,1069,2533,2031,3559,11009
2023-05-31,20,1821,1783,2545,3558,2816,12523
2023-06-01,20,3306,2741,3587,2689,2242,14565
2023-06-02,20,1535,2463,3169,3433,5593,16193
2023-06-03,20,2268,990,3824,4444,5635,17161
2023-06-04,20,4745,1989,3394,2255,2882,15265
2023-06-05,20,2371,1357,3683,3219,4355,14985
2023-06-06,20,3185,2116,3180,4462,4883,17826
2023-06-07,20,2179,2022,3927,2547,3425,14100
2023-06-08,20,2967,1761,2047,1825,5712,14312
2023-06-09,20,1855,2624,3219,2130,5387,15215
2023-06-10,20,1539,2378,2581,2465,3462,12425
2023-06-11,20,4310,2256,3385,2672,5000,17623
2023-06-12,20,3615,2750,1481,3155,5966,16967
2023-06-13,20,3503,1548,1349,3682,5262,15344
2023-06-14,20,2146,2682,3246,3413,3925,15412
2023-06-15,20,3384,1622,2335,2960,3345,13646
2023-06-16,20,4910,2463,3273,1662,4558,16866
2023-06-17,20,4125,2296,3999,2546,5007,17973
2023-06-18,20,1743,2546,2084,2361,2444,11178
2023-06-19,20,3806,2274,2040,4022,4446,16588
2023-06-20,20,2527,2973,1647,2356,3714,13217
2023-06-21,20,1406,1541,1344,3596,2983,10870
2023-06-22,20,4877,1774,1455,3125,2334,13565
2023-06-23,20,2055,1754,2311,2891,4658,13669
2023-06-24,20,4160,1932,3083,2118,4280,15573
2023-06-25,20,3781,1569,1815,3318,5284,15767
2023-06-26,20,2176,2795,1426,2734,3961,13092
2023-06-27,20,1986,1873,2263,4403,5562,16087
2023-06-28,20,4080,835,1937,2927,2608,12387
2023-06-29,20,2010,937,2984,2332,5486,13749
2023-06-30,20,4655,2784,2840,3668,3504,17451
2023-07-01,20,1512,2156,3629,4051,2647,13995
2023-07-02,20,2511,2028,3057,2544,4048,14188
2023-07-03,20,2106,1336,2455,4048,2910,12855
2023-07-04,20,1556,1932,3632,4405,3239,14764
2023-07-05,20,2768,1554,1991,4492,3567,14372
2023-07-06,20,1438,1076,3959,3942,4438,14853
2023-07-07,20,3251,2090,3192,2190,2050,12773
2023-07-08,20,4809,2046,2848,4136,4008,17847
2023-07-09,20,1432,2319,1649,3382,2221,11003
2023-07-10,20,4623,2728,3158,2763,5738,19010
2023-07-11,20,2889,1151,3349,3279,2558,13226
2023-07-12,20,4074,2416,1384,3402,3046,14322
2023-07-13,20,1409,2992,1955,2514,2038,10908
2023-07-14,20,4841,1897,2057,3078,2979,14852
2023-07-15,20,4854,1695,2635,4464,4881,18529
2023-07-16,20,4450,2597,1292,2095,5878,16312
2023-07-17,20,4640,1192,1318,2556,4210,13916
2023-07-18,20,4454,1764,2781,3139,2735,14873
2023-07-19,20,2010,1489,1676,3968,5111,14254
2023-07-20,20,3450,2934,3726,1879,4529,16518
2023-07-21,20,1033,2681,1818,1619,5464,12615
2023-07-22,20,3309,2660,2972,4014,5077,18032
2023-07-23,20,3793,1869,1894,2193,4719,14468
2023-07-24,20,2946,2786,2066,3957,2000,13755
2023-07-25,20,3548,1811,2169,3314,4866,15708
2023-07-26,20,3168,2668,1864,2656,3436,13792
2023-07-27,20,1263,1109,3808,1743,5642,13565
2023-07-28,20,1790,1063,3235,4021,5789,15898
2023-07-29,20,4204,1493,1751,3996,5391,16835
2023-07-30,20,1972,2487,1395,3653,5505,15012
2023-07-31,20,4754,1324,3478,3435,5018,18009
2023-08-01,20,1661,2664,3806,2193,4748,15072
2023-08-02,20,1979,2868,2336,1907,5431,14521
2023-08-03,20,1879,874,1631,3977,4344,12705
2023-08-04,20,3697,2280,2579,4062,2918,15536
2023-08-05,20,3782,2098,3556,2772,5789,17997
2023-08-06,20,3138,2059,1441,3229,4181,14048
2023-08-07,20,3763,2094,3306,4079,4421,17663
2023-08-08,20,2342,2329,3383,4109,3128,15291
2023-08-09,20,1114,2482,3699,1892,5115,14302
2023-08-10,20,2510,1781,2554,1583,5184,13612
2023-08-11,20,2145,1207,3279,2698,3512,12841
2023-08-12,20,1810,1588,2256,1764,3526,10944
2023-08-13,20,3909,2404,1433,1697,5014,14457
2023-08-14,20,2924,2117,1703,1599,3047,11390
2023-08-15,20,2711,1359,2733,3542,2294,12639
2023-08-16,20,3528,1737,1641,3873,5912,16691
2023-08-17,20,3339,2392,2543,3610,2941,14825
2023-08-18,20,1846,999,2481,1501,2320,9147
2023-08-19,20,3169,1899,2689,2682,5414,15853
2023-08-20,20,1192,1888,2434,1904,3668,11086
2023-08-21,20,2278,872,3331,2076,5140,13697
2023-08-22,20,3790,1791,1598,3925,5111,16215
2023-08-23,20,1790,2048,3578,1825,2838,12079
2023-08-24,20,1279,1417,2996,4464,2709,12865
2023-08-25,20,2358,2995,1721,3162,2275,12511
2023-08-26,20,1159,1715,2365,3837,4941,14017
2023-08-27,20,2438,1540,2738,3970,3331,14017
2023-08-28,20,4124,2635,2786,3612,3433,16590
2023-08-29,20,2197,2547,1720,3104,3081,12649
2023-08-30,20,1169,2894,3359,1767,2711,11900
2023-08-31,20,2019,1985,2508,3761,2511,12784
2023-09-01,20,3067,1071,2347,2040,4584,13109
2023-09-02,20,4543,2223,2464,1501,2940,13671
2023-09-03,20,3927,1686,2505,1972,5572,15662
2023-09-04,20,2506,1222,2142,1966,2135,9971
2023-09-05,20,2733,1154,1394,1935,5592,12808
2023-09-06,20,2095,800,3836,4220,4999,15950
2023-09-07,20,4718,925,3781,1588,4265,15277
2023-09-08,20,4724,1778,2065,3552,4282,16401
2023-09-09,20,4728,1674,1826,4225,5657,18110
2023-09-10,20,1853,1339,2513,4219,5348,15272
2023-09-11,20,3616,2219,1205,3485,2210,12735
2023-09-12,20,1996,1653,1556,2809,3936,11950
2023-09-13,20,3967,1849,2032,2677,4245,14770
2023-09-14,20,1909,2798,1254,2311,2317,10589
2023-09-15,20,2289,2339,1716,3773,4725,14842
2023-09-16,20,1000,1619,2266,3296,4753,12934
2023-09-17,20,1183,1720,1676,1628,2048,8255
2023-09-18,20,1619,1475,2204,3023,2845,11166
2023-09-19,20,2947,1036,1933,2830,4966,13712
2023-09-20,20,1428,2563,3864,1793,2620,12268
2023-09-21,20,2469,2639,1477,1916,3404,11905
2023-09-22,20,1492,2113,2776,2113,2455,10949
2023-09-23,20,1487,2870,3545,1555,5023,14480
2023-09-24,20,2582,2444,3636,2439,2000,13101
2023-09-25,20,1256,1268,2577,1688,3518,10307
2023-09-26,20,2703,2639,2212,4358,3809,15721
2023-09-27,20,1362,847,3272,3769,2909,12159
2023-09-28,20,1685,952,2812,3383,3950,12782
2023-09-29,20,4911,1299,2724,2864,3228,15026
2023-09-30,20,3048,819,2026,1809,5481,13183
2023-10-01,20,3893,1067,3450,3418,3908,15736
2023-10-02,20,2288,2141,2889,2194,2137,11649
2023-10-03,20,3704,1353,1308,2053,5885,14303
2023-10-04,20,4900,2759,3970,3900,3592,19121
2023-10-05,20,3285,1848,3620,4102,4465,17320
2023-10-06,20,3859,2652,3760,2948,5832,19051
2023-10-07,20,3896,2504,1810,3782,5063,17055
2023-10-08,20,4532,2339,3561,3047,4679,18158
2023-10-09,20,3443,1172,3900,3983,5852,18350
2023-10-10,20,1312,2170,2125,2108,3401,11116
2023-10-11,20,5000,2410,2130,2932,3435,15907
2023-10-12,20,3601,2422,1612,1725,3826,13186
2023-10-13,20,1262,2481,1315,3707,4675,13440
2023-10-14,20,2481,2184,2193,2468,2032,11358
2023-10-15,20,2218,2671,3660,4417,2618,15584
2023-10-16,20,2868,1391,2233,3032,5173,14697
2023-10-17,20,1536,1856,1322,2371,3377,10462
2023-10-18,20,2391,1412,3997,3709,3055,14564
2023-10-19,20,1032,1570,2307,3485,4174,12568
2023-10-20,20,4569,2574,1512,4397,3177,16229
2023-10-21,20,2741,2825,3280,1703,3254,13803
2023-10-22,20,3628,2768,3617,4441,5061,19515
2023-10-23,20,2438,2633,1644,1867,3269,11851
2023-10-24,20,3884,2916,1820,2314,3967,14901
2023-10-25,20,2329,2816,3662,3302,4935,17044
2023-10-26,20,3040,2599,2556,2527,3269,13991
2023-10-27,20,2592,1044,3116,4092,4191,15035
2023-10-28,20,1960,800,3117,1903,2278,10058
2023-10-29,20,1945,1895,1372,1955,2026,9193
2023-10-30,20,1359,2037,3406,3451,5754,16007
2023-10-31,20,2900,2517,2255,4200,2895,14767
2023-11-01,20,2691,1549,2883,3052,5427,15602
2023-11-02,20,1016,1704,3678,1663,4747,12808
2023-11-03,20,3818,2951,2996,2371,3553,15689
2023-11-04,20,1243,2041,2273,1543,2259,9359
2023-11-05,20,1440,1398,2137,2652,3088,10715
2023-11-06,20,1957,2792,3498,3146,2029,13422
2023-11-07,20,1092,2843,3797,1862,3849,13443
2023-11-08,20,4563,1813,3974,1741,3475,15566
2023-11-09,20,3982,1964,1433,3331,5235,15945
2023-11-10,20,1077,863,1404,1654,4549,9547
2023-11-11,20,3603,966,3229,3648,5381,16827
2023-11-12,20,3385,2535,1918,1812,4659,14309
2023-11-13,20,4070,2489,3011,3588,2228,15386
2023-11-14,20,3777,1866,3515,3377,2390,14925
2023-11-15,20,2266,876,3885,4071,5749,16847
2023-11-16,20,1750,1103,3016,3720,4414,14003
2023-11-17,20,1267,2448,1278,4125,2587,11705
2023-11-18,20,4716,2186,1499,2786,5810,16997
2023-11-19,20,3715,2432,3943,4192,3690,17972
2023-11-20,20,4782,1399,2799,2381,3611,14972
2023-11-21,20,3770,1202,1843,1509,4237,12561
2023-11-22,20,4601,2651,2855,1810,2673,14590
2023-11-23,20,1764,2123,2807,4043,3962,14699
2023-11-24,20,3287,1769,1413,3297,5394,15160
2023-11-25,20,3536,2488,2882,4049,3352,16307
2023-11-26,20,3259,1145,2644,4297,5996,17341
2023-11-27,20,1086,2056,2631,2213,2508,10494
2023-11-28,20,1932,2642,3772,3542,4516,16404
2023-11-29,20,4932,2101,2320,2943,4686,16982
2023-11-30,20,4298,2002,2217,1930,5752,16199
2023-12-01,20,2304,2394,2752,4328,2474,14252
2023-12-02,20,3454,1588,2901,2332,2199,12474
2023-12-03,20,2042,2827,3667,3505,3568,15609
2023-12-04,20,1165,1287,3575,2144,3906,12077
2023-12-05,20,3113,1651,1721,4227,5143,15855
2023-12-06,20,3058,1301,1268,3802,2894,12323
2023-12-07,20,3461,2136,1235,3773,3321,13926
2023-12-08,20,3501,2186,1830,2164,5927,15608
2023-12-09,20,1503,910,3244,2316,5042,13015
2023-12-10,20,2731,950,3597,3294,3131,13703
2023-12-11,20,2553,2288,2234,1872,5439,14386
2023-12-12,20,3860,1898,2029,3625,2526,13938
2023-12-13,20,2285,2495,3074,3282,2768,13904
2023-12-14,20,1253,1605,2128,3561,2108,10655
2023-12-15,20,2353,1898,1432,2117,5358,13158
2023-12-16,20,3490,1088,1536,1961,4664,12739
2023-12-17,20,4845,2258,1555,3106,5227,16991
2023-12-18,20,2669,1182,3990,4324,3027,15192
2023-12-19,20,3836,2210,1846,2242,3565,13699
2023-12-20,20,1364,2221,1338,1678,3611,10212
2023-12-21,20,2753,1890,2973,3635,2027,13278
2023-12-22,20,3226,940,2833,1937,5557,14493
2023-12-23,20,3460,2046,2463,2733,2117,12819
2023-12-24,20,2638,1155,2640,2634,3816,12883
2023-12-25,20,4538,2533,3864,3258,2189,16382
2023-12-26,20,1607,2927,1783,1622,3174,11113
2023-12-27,20,3331,2498,2703,2245,2586,13363
2023-12-28,20,4938,1154,1391,2080,2123,11686
2023-12-29,20,3636,2573,2728,2063,2099,13099
2023-12-30,20,4845,1009,2189,2710,2388,13141
2023-12-31,20,1439,2156,2362,1850,5853,13660
2022-01-01,21,2142,848,2991,2511,3776,12268
2022-01-02,21,4315,2045,2708,4092,2345,15505
2022-01-03,21,2398,2500,1295,2437,3396,12026
2022-01-04,21,4006,2340,1773,2059,4346,14524
2022-01-05,21,2923,885,1629,4292,5099,14828
2022-01-06,21,2821,1243,2035,2087,4747,12933
2022-01-07,21,1071,1112,3343,2927,5620,14073
2022-01-08,21,1585,1535,3068,3688,5972,15848
2022-01-09,21,2999,2191,2194,3818,4962,16164
2022-01-10,21,2587,2988,3949,3932,2104,15560
2022-01-11,21,4596,1366,2506,1813,4968,15249
2022-01-12,21,3191,1746,2228,1657,5278,14100
2022-01-13,21,2891,1115,3796,4269,2380,14451
2022-01-14,21,2741,2934,1762,2307,3207,12951
2022-01-15,21,4615,2989,1278,2156,4771,15809
2022-01-16,21,3367,823,2836,3852,2390,13268
2022-01-17,21,2705,2788,3052,2626,3131,14302
2022-01-18,21,2071,2065,3058,2346,3092,12632
2022-01-19,21,4098,1746,1524,2381,4456,14205
2022-01-20,21,2667,1528,2148,3746,5935,16024
2022-01-21,21,2413,1339,2385,3750,4178,14065
2022-01-22,21,2687,1914,3163,4042,2824,14630
2022-01-23,21,1135,2024,3160,2694,2733,11746
2022-01-24,21,1192,2314,1571,2171,2552,9800
2022-01-25,21,1014,1916,1206,2691,3222,10049
2022-01-26,21,3925,1276,2876,3350,2363,13790
2022-01-27,21,1941,2363,2774,3307,5635,16020
2022-01-28,21,3350,1272,1425,3919,5396,15362
2022-01-29,21,3455,1486,2143,2450,4120,13654
2022-01-30,21,3532,2583,2925,2603,4200,15843
2022-01-31,21,2404,2730,3993,3735,5333,18195
2022-02-01,21,3195,1998,1871,4339,5564,16967
2022-02-02,21,2554,2959,3770,2901,4966,17150
2022-02-03,21,4642,2129,1747,2715,5240,16473
2022-02-04,21,4884,1949,3010,2959,5441,18243
2022-02-05,21,4664,2173,2355,2301,2373,13866
2022-02-06,21,3052,2316,3961,1990,4109,15428
2022-02-07,21,4626,1095,1948,2461,2856,12986
2022-02-08,21,4194,1440,3881,4286,3762,17563
2022-02-09,21,4087,1408,2743,1780,3501,13519
2022-02-10,21,4194,1973,3220,2469,5937,17793
2022-02-11,21,2556,2451,3024,2468,3780,14279
2022-02-12,21,1315,2507,1937,4379,5618,15756
2022-02-13,21,1809,1439,1363,3616,2028,10255
2022-02-14,21,2882,1082,1420,1514,5936,12834
2022-02-15,21,2647,1871,2285,3225,5128,15156
2022-02-16,21,4955,1560,2681,2903,2543,14642
2022-02-17,21,4237,2419,1386,2954,2768,13764
2022-02-18,21,2308,1693,2163,2967,5907,15038
2022-02-19,21,1835,1469,3090,2726,3166,12286
2022-02-20,21,3768,2927,1963,2555,3046,14259
2022-02-21,21,2827,2876,1687,1797,4160,13347
2022-02-22,21,1287,2113,3856,2826,5842,15924
2022-02-23,21,2992,2449,3500,4143,4429,17513
2022-02-24,21,4932,1807,3337,1595,4140,15811
2022-02-25,21,1508,989,2791,1820,2915,10023
2022-02-26,21,2564,1198,3028,3879,4101,14770
2022-02-27,21,3435,1753,3219,3504,3329,15240
2022-02-28,21,2311,2875,2512,3629,3485,14812
2022-03-01,21,3463,922,3696,1608,5890,15579
2022-03-02,21,4368,1996,3578,2923,3027,15892
2022-03-03,21,3958,952,3123,2092,4527,14652
2022-03-04,21,1288,2804,3976,2034,5016,15118
2022-03-05,21,3899,2057,1241,1799,4427,13423
2022-03-06,21,1398,1796,1637,3132,3831,11794
2022-03-07,21,2113,947,1787,3304,2631,10782
2022-03-08,21,4543,1438,1204,2820,5797,15802
2022-03-09,21,3509,2955,2074,3406,5198,17142
2022-03-10,21,2175,2663,1318,3077,5580,14813
2022-03-11,21,1024,1429,2553,1697,2948,9651
2022-03-12,21,1262,1874,2050,1587,5695,12468
2022-03-13,21,1550,1320,3420,1733,5924,13947
2022-03-14,21,1275,1760,3929,3693,3046,13703
2022-03-15,21,1309,1191,3577,1661,4882,12620
2022-03-16,21,4783,1453,3143,2029,3414,14822
2022-03-17,21,1568,1087,2106,1839,5578,12178
2022-03-18,21,1339,2805,2767,2850,3350,13111
2022-03-19,21,2401,2396,1795,2886,3297,12775
2022-03-20,21,3331,1255,1869,4224,2227,12906
2022-03-21,21,1104,1230,2572,3147,2297,10350
2022-03-22,21,4462,1507,1332,2236,4594,14131
2022-03-23,21,3394,881,1817,2160,5522,13774
2022-03-24,21,3598,1354,1671,2197,3181,12001
2022-03-25,21,2324,2860,3850,1783,2497,13314
2022-03-26,21,1475,1919,2995,4402,2846,13637
2022-03-27,21,3480,1797,3874,3851,5094,18096
2022-03-28,21,4962,2342,2502,3595,3093,16494
2022-03-29,21,3505,1221,1859,2956,3121,12662
2022-03-30,21,1018,1344,1422,1567,2471,7822
2022-03-31,21,4153,2498,3957,2132,5285,18025
2022-04-01,21,3254,1191,3145,2393,4958,14941
2022-04-02,21,4075,2068,1896,3318,5968,17325
2022-04-03,21,2365,2290,2659,2524,5667,15505
2022-04-04,21,4472,808,3110,4485,4706,17581
2022-04-05,21,3988,862,1922,3049,3145,12966
2022-04-06,21,3131,974,3468,3611,5407,16591
2022-04-07,21,2340,1201,2817,2923,2741,12022
2022-04-08,21,2841,2655,1285,1968,3285,12034
2022-04-09,21,1521,930,3346,2142,5150,13089
2022-04-10,21,2147,1325,2075,3503,2050,11100
2022-04-11,21,2444,1566,1244,1542,3065,9861
2022-04-12,21,2200,1444,3697,1832,2185,11358
2022-04-13,21,4261,1133,3815,2825,3587,15621
2022-04-14,21,4506,1735,2714,2531,4908,16394
2022-04-15,21,4538,2035,3440,1685,3601,15299
2022-04-16,21,1056,1918,3141,3273,5652,15040
2022-04-17,21,2008,2795,1204,3682,5131,14820
2022-04-18,21,4407,1878,1608,2860,5150,15903
2022-04-19,21,2922,1354,2605,1688,3828,12397
2022-04-20,21,1285,1365,2937,2167,3348,11102
2022-04-21,21,4646,1922,1810,3935,5081,17394
2022-04-22,21,1970,1890,2543,3593,5729,15725
2022-04-23,21,2371,1679,3876,2176,3467,13569
2022-04-24,21,1890,2740,3678,1557,4588,14453
2022-04-25,21,3352,2519,2380,2043,2385,12679
2022-04-26,21,3733,1913,3752,3685,2463,15546
2022-04-27,21,1170,2049,2816,2026,5494,13555
2022-04-28,21,3652,1602,3183,3935,5980,18352
2022-04-29,21,4718,2209,3142,1856,2966,14891
2022-04-30,21,1171,2816,1312,3416,5829,14544
2022-05-01,21,2891,1790,3935,2199,3960,14775
2022-05-02,21,4387,1784,1309,2073,2984,12537
2022-05-03,21,1382,1098,3414,2274,3414,11582
2022-05-04,21,4575,1025,1645,1768,3764,12777
2022-05-05,21,3019,832,2134,2615,5719,14319
2022-05-06,21,3918,1546,3645,1944,5408,16461
2022-05-07,21,2567,1003,2017,3896,2650,12133
2022-05-08,21,4383,1477,1232,1719,4052,12863
2022-05-09,21,2836,2658,3163,2506,2698,13861
2022-05-10,21,1797,2574,2504,2657,3800,13332
2022-05-11,21,1808,1183,1500,1939,3459,9889
2022-05-12,21,4133,1184,1793,2028,5610,14748
2022-05-13,21,3385,1004,3866,2707,5217,16179
2022-05-14,21,1323,1236,3025,2321,4427,12332
2022-05-15,21,3950,1267,2716,2053,3410,13396
2022-05-16,21,2745,2946,1926,1750,5147,14514
2022-05-17,21,1029,883,2553,1944,4069,10478
2022-05-18,21,2134,1058,2408,3439,4914,13953
2022-05-19,21,4413,2927,3460,3055,5257,19112
2022-05-20,21,3269,1129,3935,2008,4948,15289
2022-05-21,21,1128,2608,3197,4170,2536,13639
2022-05-22,21,1926,2282,2828,2085,3522,12643
2022-05-23,21,4417,1184,1493,2880,3942,13916
2022-05-24,21,4406,2355,3412,2317,3528,16018
2022-05-25,21,3798,999,1248,2298,2674,11017
2022-05-26,21,2530,2787,3198,2382,4354,15251
2022-05-27,21,2001,864,2232,3566,4035,12698
2022-05-28,21,2403,2924,2599,4291,4592,16809
2022-05-29,21,4294,1718,1283,3607,5929,16831
2022-05-30,21,1771,2177,2613,4007,5061,15629
2022-05-31,21,2551,1709,2122,1960,4455,12797
2022-06-01,21,1873,2911,1701,3651,3063,13199
2022-06-02,21,1559,2152,3630,3935,4637,15913
2022-06-03,21,3032,1137,3892,3249,5409,16719
2022-06-04,21,4348,1964,2420,2413,2602,13747
2022-06-05,21,1817,1285,2679,3819,5772,15372
2022-06-06,21,4897,1625,3855,2332,5875,18584
2022-06-07,21,3268,2574,2118,3466,3210,14636
2022-06-08,21,3933,1699,1588,3858,3594,14672
2022-06-09,21,1824,1687,2693,2989,4982,14175
2022-06-10,21,3879,1539,1798,2204,4378,13798
2022-06-11,21,3024,1533,2062,2855,5741,15215
2022-06-12,21,2059,1475,3325,4001,5665,16525
2022-06-13,21,4111,1255,2728,2749,5452,16295
2022-06-14,21,4846,2291,3042,2066,5245,17490
2022-06-15,21,2061,2015,3966,2180,5396,15618
2022-06-16,21,3867,855,3261,2140,3293,13416
2022-06-17,21,3075,1574,2711,2011,5581,14952
2022-06-18,21,1078,2063,1583,2403,4797,11924
2022-06-19,21,2617,2500,3160,4095,5466,17838
2022-06-20,21,4439,877,3077,2858,4714,15965
2022-06-21,21,1647,941,3579,4114,4466,14747
2022-06-22,21,3045,2967,3095,3462,4565,17134
2022-06-23,21,2497,2379,1682,2700,2625,11883
2022-06-24,21,2005,2432,3268,2497,3285,13487
2022-06-25,21,4052,1656,1504,2753,4342,14307
2022-06-26,21,4942,2170,1745,2618,5640,17115
2022-06-27,21,2901,2160,1640,2121,3058,11880
2022-06-28,21,1835,1413,2086,4408,2300,12042
2022-06-29,21,1733,1361,2258,4084,2600,12036
2022-06-30,21,3496,1676,2652,2037,5698,15559
2022-07-01,21,4524,2400,1960,2640,5813,17337
2022-07-02,21,2332,1761,2823,3711,4002,14629
2022-07-03,21,4165,1533,3218,1914,5935,16765
2022-07-04,21,3854,1045,1735,4123,5670,16427
2022-07-05,21,1919,1126,3258,3365,5168,14836
2022-07-06,21,1630,1213,2866,3123,5495,14327
2022-07-07,21,4812,2559,3537,3450,4811,19169
2022-07-08,21,4333,1350,1943,4132,4343,16101
2022-07-09,21,4002,2213,2320,3872,5203,17610
2022-07-10,21,3720,1934,1958,4366,3197,15175
2022-07-11,21,4992,1051,3186,4279,3516,17024
2022-07-12,21,3352,1957,2528,1901,2931,12669
2022-07-13,21,1644,822,3147,3194,3526,12333
2022-07-14,21,2250,2431,3523,2019,2803,13026
2022-07-15,21,4370,2011,3472,3635,2373,15861
2022-07-16,21,2966,2628,2981,3516,2158,14249
2022-07-17,21,3635,2286,2738,2472,5215,16346
2022-07-18,21,2672,1941,2317,3290,3152,13372
2022-07-19,21,4177,1259,2659,2517,2075,12687
2022-07-20,21,3905,2077,3866,4384,3699,17931
2022-07-21,21,4803,1503,1871,3324,4045,15546
2022-07-22,21,4427,2165,2890,2798,3209,15489
2022-07-23,21,1000,2286,1364,3930,3888,12468
2022-07-24,21,2247,2190,2290,3779,3321,13827
2022-07-25,21,4852,1871,3636,3736,5730,19825
2022-07-26,21,1493,1923,2058,1906,3888,11268
2022-07-27,21,2413,2216,1817,2950,5392,14788
2022-07-28,21,4399,1127,3205,3240,2624,14595
2022-07-29,21,1041,2110,3555,2576,2598,11880
2022-07-30,21,1813,2323,1846,2805,4100,12887
2022-07-31,21,2425,2968,3636,3265,4926,17220
2022-08-01,21,2647,1195,1834,4051,4594,14321
2022-08-02,21,4260,868,1201,2368,2930,11627
2022-08-03,21,4897,1477,3317,3153,5520,18364
2022-08-04,21,4020,1230,2870,4076,3762,15958
2022-08-05,21,2652,2580,1619,3689,5186,15726
2022-08-06,21,2072,1093,3973,2000,4722,13860
2022-08-07,21,3938,1003,2357,2494,4528,14320
2022-08-08,21,1197,1504,1723,4094,2125,10643
2022-08-09,21,4579,1356,1847,3548,5593,16923
2022-08-10,21,2559,1772,3265,4285,5702,17583
2022-08-11,21,3256,2914,2466,1934,4116,14686
2022-08-12,21,2789,1994,3445,4139,5489,17856
2022-08-13,21,1621,1132,2260,4194,4408,13615
2022-08-14,21,1595,1939,3303,1626,4154,12617
2022-08-15,21,3057,2268,3243,2077,5390,16035
2022-08-16,21,3418,1888,2101,1641,4984,14032
2022-08-17,21,4461,2759,3427,1822,2084,14553
2022-08-18,21,1635,3000,1455,2178,5124,13392
2022-08-19,21,2560,1491,3198,2319,3776,13344
2022-08-20,21,4245,1540,1808,2085,4638,14316
2022-08-21,21,3361,2189,1637,1826,4730,13743
2022-08-22,21,1725,1415,1810,2851,4458,12259
2022-08-23,21,3796,907,1356,2552,2285,10896
2022-08-24,21,3439,1621,2754,3994,2232,14040
2022-08-25,21,4209,2699,1355,2935,4512,15710
2022-08-26,21,3463,2689,2121,4217,3746,16236
2022-08-27,21,4315,2237,2582,2106,4252,15492
2022-08-28,21,3580,2680,1847,4204,4560,16871
2022-08-29,21,4710,1018,3327,4111,3860,17026
2022-08-30,21,3827,2087,3659,2559,4721,16853
2022-08-31,21,2078,1621,1802,2188,4558,12247
2022-09-01,21,2568,2698,1785,3928,4369,15348
2022-09-02,21,4150,1384,2452,3237,5574,16797
2022-09-03,21,4162,2911,3054,4309,3243,17679
2022-09-04,21,2733,1379,3862,1834,3592,13400
2022-09-05,21,2087,1288,2364,4232,2017,11988
2022-09-06,21,3431,901,3116,1815,2029,11292
2022-09-07,21,4349,2127,3605,4356,5347,19784
2022-09-08,21,1262,1307,1781,2663,4646,11659
2022-09-09,21,1880,1120,3314,1688,3712,11714
2022-09-10,21,4017,1540,2826,3339,3082,14804
2022-09-11,21,1894,2505,2090,2906,3117,12512
2022-09-12,21,4027,1885,3100,3611,4261,16884
2022-09-13,21,1014,2663,3371,2096,2515,11659
2022-09-14,21,4927,2265,3355,4311,3222,18080
2022-09-15,21,2737,2393,3073,4373,5945,18521
2022-09-16,21,4624,1055,3444,3542,3643,16308
2022-09-17,21,2766,1183,3511,2381,5661,15502
2022-09-18,21,2939,1379,2507,2933,2538,12296
2022-09-19,21,2060,1906,3393,3627,3876,14862
2022-09-20,21,2733,2394,2744,3167,3093,14131
2022-09-21,21,4773,2635,1491,1606,2773,13278
2022-09-22,21,4872,859,3681,2207,2530,14149
2022-09-23,21,1344,2299,3614,3896,5667,16820
2022-09-24,21,3431,2919,2541,4412,4017,17320
2022-09-25,21,2855,2069,1761,3421,3137,13243
2022-09-26,21,2556,1994,2285,2984,5246,15065
2022-09-27,21,4104,1564,2988,1680,3757,14093
2022-09-28,21,2291,1175,2605,3785,3263,13119
2022-09-29,21,4895,1323,1253,3312,3485,14268
2022-09-30,21,1704,2249,3794,4280,5232,17259
2022-10-01,21,3932,2351,3585,4303,4118,18289
2022-10-02,21,4123,1892,2521,1676,2448,12660
2022-10-03,21,2176,1380,1732,4110,2769,12167
2022-10-04,21,3145,1179,2806,4064,4200,15394
2022-10-05,21,3012,1608,3572,2169,3818,14179
2022-10-06,21,1147,1024,1859,1500,4545,10075
2022-10-07,21,1186,1941,1923,3450,4748,13248
2022-10-08,21,3421,1459,3687,2334,2429,13330
2022-10-09,21,3265,1652,1268,2170,5926,14281
2022-10-10,21,1482,803,3294,3553,4299,13431
2022-10-11,21,2836,2940,2706,4319,5108,17909
2022-10-12,21,3045,2389,1353,4391,4420,15598
2022-10-13,21,2743,2804,3094,3926,3703,16270
2022-10-14,21,3361,1200,2727,3806,4900,15994
2022-10-15,21,3654,2141,2870,2796,3844,15305
2022-10-16,21,3394,1297,2044,3195,3007,12937
2022-10-17,21,1745,1516,2387,2362,2204,10214
2022-10-18,21,1726,1420,2135,1814,5972,13067
2022-10-19,21,4038,1518,1408,4063,2733,13760
2022-10-20,21,2523,2835,1973,2141,5928,15400
2022-10-21,21,1144,1521,1877,3442,3678,11662
2022-10-22,21,1696,1436,1766,4185,2499,11582
2022-10-23,21,1834,2900,3569,1652,2232,12187
2022-10-24,21,4052,2018,1506,4400,3674,15650
2022-10-25,21,3177,2652,2422,3925,4749,16925
2022-10-26,21,2010,1525,1998,2886,3002,11421
2022-10-27,21,1861,2829,3744,2620,4575,15629
2022-10-28,21,3920,1886,1723,1692,3018,12239
2022-10-29,21,3006,967,3081,2879,4044,13977
2022-10-30,21,1431,2892,3141,2287,3848,13599
2022-10-31,21,4186,2764,2632,3659,3468,16709
2022-11-01,21,3153,996,3881,2265,3660,13955
2022-11-02,21,4354,2700,1857,2888,3206,15005
2022-11-03,21,4674,2018,1941,3772,2266,14671
2022-11-04,21,2973,2359,3396,1816,3592,14136
2022-11-05,21,4801,1428,2599,4130,4872,17830
2022-11-06,21,4941,2094,2563,4075,3713,17386
2022-11-07,21,4356,1051,1488,3338,5198,15431
2022-11-08,21,3220,2300,1974,2260,4045,13799
2022-11-09,21,2945,2636,1383,2360,2348,11672
2022-11-10,21,2079,2268,1937,2773,5827,14884
2022-11-11,21,3196,1079,3355,2604,2852,13086
2022-11-12,21,4574,802,2434,2867,3627,14304
2022-11-13,21,3132,1430,3740,2767,4933,16002
2022-11-14,21,4405,1092,1205,3567,4050,14319
2022-11-15,21,4350,2016,2334,2497,4276,15473
2022-11-16,21,3919,2190,3941,3730,4424,18204
2022-11-17,21,2567,1267,2337,2920,5821,14912
2022-11-18,21,2828,1142,2634,3551,3179,13334
2022-11-19,21,2407,826,1249,2580,2022,9084
2022-11-20,21,2202,1482,1784,4437,4667,14572
2022-11-21,21,4251,2308,2971,3397,5418,18345
2022-11-22,21,2775,861,2253,2168,2492,10549
2022-11-23,21,3136,1354,1714,2902,4741,13847
2022-11-24,21,2582,1086,1232,3132,2414,10446
2022-11-25,21,2324,2450,3073,2269,2679,12795
2022-11-26,21,2215,1609,2225,3890,2819,12758
2022-11-27,21,4337,2804,1812,4095,3302,16350
2022-11-28,21,1407,2818,3682,1859,4011,13777
2022-11-29,21,3497,1018,1748,1504,2238,10005
2022-11-30,21,1470,1470,2369,4060,5074,14443
2022-12-01,21,3156,1518,3703,1987,2773,13137
2022-12-02,21,2181,1821,2499,2930,3615,13046
2022-12-03,21,4687,1547,3212,4047,3376,16869
2022-12-04,21,4176,2959,3162,4023,4279,18599
2022-12-05,21,2055,1520,3671,3990,3710,14946
2022-12-06,21,4454,2691,3120,2867,3796,16928
2022-12-07,21,1251,1898,3707,2228,4782,13866
2022-12-08,21,2693,1982,3461,2166,5705,16007
2022-12-09,21,1233,1627,2652,2401,4147,12060
2022-12-10,21,2042,2793,2980,3154,3354,14323
2022-12-11,21,4677,1090,3513,2275,2906,14461
2022-12-12,21,1168,2226,1435,2884,3933,11646
2022-12-13,21,1384,2624,2217,1588,3562,11375
2022-12-14,21,2772,2499,2726,2492,4607,15096
2022-12-15,21,2166,1320,2900,2565,5039,13990
2022-12-16,21,1792,1941,1279,4242,2789,12043
2022-12-17,21,4969,2368,1569,2738,5264,16908
2022-12-18,21,1805,1768,2889,3696,5077,15235
2022-12-19,21,2666,1232,1765,1791,5888,13342
2022-12-20,21,4401,911,2685,4451,5564,18012
2022-12-21,21,4753,1886,3740,2964,3061,16404
2022-12-22,21,3177,1093,3102,1950,4990,14312
2022-12-23,21,1554,1082,1513,2696,4510,11355
2022-12-24,21,3897,1928,2057,2461,5214,15557
2022-12-25,21,2000,1945,3027,4302,5723,16997
2022-12-26,21,1076,1153,2603,1682,2802,9316
2022-12-27,21,1588,1160,3165,3384,4387,13684
2022-12-28,21,1949,1436,3193,2891,2871,12340
2022-12-29,21,2937,1969,2003,1966,2425,11300
2022-12-30,21,4562,1153,3393,3991,5607,18706
2022-12-31,21,2085,2726,2762,2191,3662,13426
2023-01-01,21,4622,1879,1667,3866,2740,14774
2023-01-02,21,3996,1376,3487,3990,3121,15970
2023-01-03,21,1974,2320,1330,3283,4421,13328
2023-01-04,21,3422,1566,1452,3317,4245,14002
2023-01-05,21,2395,2199,2406,2298,3625,12923
2023-01-06,21,1720,2265,2761,3638,5517,15901
2023-01-07,21,1404,2664,3510,4359,5505,17442
2023-01-08,21,1190,924,1333,3593,3623,10663
2023-01-09,21,1649,1351,3587,2533,5558,14678
2023-01-10,21,2958,1014,3990,1586,4169,13717
2023-01-11,21,1947,2192,1921,4392,2126,12578
2023-01-12,21,4055,2013,3195,4224,5936,19423
2023-01-13,21,3870,2792,2679,2559,5872,17772
2023-01-14,21,1983,1118,2931,1966,3362,11360
2023-01-15,21,4374,2194,2596,4271,5240,18675
2023-01-16,21,4174,1690,3173,2401,2551,13989
2023-01-17,21,3739,1653,3080,2410,2553,13435
2023-01-18,21,4190,1682,3719,3852,3852,17295
2023-01-19,21,4224,2629,3541,2489,4220,17103
2023-01-20,21,3465,1617,1752,4149,2645,13628
2023-01-21,21,1715,1171,2093,2147,3858,10984
2023-01-22,21,4694,1170,1251,2228,4971,14314
2023-01-23,21,3278,1079,3677,2162,5115,15311
2023-01-24,21,3867,2368,3898,1527,3456,15116
2023-01-25,21,3218,2439,1748,3436,4410,15251
2023-01-26,21,4626,2192,2023,4435,4570,17846
2023-01-27,21,2828,2199,1468,3032,2654,12181
2023-01-28,21,2927,1371,1971,4364,5959,16592
2023-01-29,21,1234,2669,1266,4317,4335,13821
2023-01-30,21,1321,1055,2735,2367,5763,13241
2023-01-31,21,4893,1732,2045,3971,3247,15888
2023-02-01,21,1337,1880,2454,4251,4478,14400
2023-02-02,21,2683,1703,3409,1642,4436,13873
2023-02-03,21,1429,1057,3023,4358,2706,12573
2023-02-04,21,1777,968,2059,2635,2719,10158
2023-02-05,21,1177,2917,3044,2641,3429,13208
2023-02-06,21,3822,1330,3801,1976,2553,13482
2023-02-07,21,3757,1514,3045,3363,5042,16721
2023-02-08,21,2367,1753,3682,2704,2339,12845
2023-02-09,21,1807,1329,2588,2630,4651,13005
2023-02-10,21,4865,1477,3857,1832,3795,15826
2023-02-11,21,2331,1683,2945,4264,5673,16896
2023-02-12,21,3251,2241,2450,2888,2934,13764
2023-02-13,21,1150,1470,2147,3658,3575,12000
2023-02-14,21,1411,881,2804,3086,5640,13822
2023-02-15,21,3454,2347,1331,4296,2438,13866
2023-02-16,21,1452,2165,2966,4484,4796,15863
2023-02-17,21,1721,2436,2900,3213,3347,13617
2023-02-18,21,1290,1349,2653,1506,5647,12445
2023-02-19,21,4364,2165,2469,3618,3791,16407
2023-02-20,21,3387,2264,3833,4157,2036,15677
2023-02-21,21,3210,1519,2624,3226,2053,12632
2023-02-22,21,2931,2207,1733,3494,2396,12761
2023-02-23,21,2033,1015,2716,3629,4085,13478
2023-02-24,21,2327,1069,1980,3261,4035,12672
2023-02-25,21,1303,2606,3131,2480,3089,12609
2023-02-26,21,4827,2380,3943,3036,2952,17138
2023-02-27,21,4776,986,3619,3479,3050,15910
2023-02-28,21,3736,2308,3759,1857,5726,17386
2023-03-01,21,3805,1229,2550,1617,5628,14829
2023-03-02,21,3050,1168,3760,4384,2487,14849
2023-03-03,21,3907,1735,1360,2101,3004,12107
2023-03-04,21,2518,2877,1493,4447,3951,15286
2023-03-05,21,3207,2181,2984,3901,5209,17482
2023-03-06,21,2626,1769,3256,4262,4681,16594
2023-03-07,21,2793,1777,3943,1556,5466,15535
2023-03-08,21,3119,915,3483,2585,2230,12332
2023-03-09,21,1661,1286,3401,3724,4006,14078
2023-03-10,21,2347,2531,3898,4025,3756,16557
2023-03-11,21,4531,2799,2717,3185,5594,18826
2023-03-12,21,1559,2990,3987,1856,4627,15019
2023-03-13,21,3154,1631,2453,3061,4523,14822
2023-03-14,21,2668,974,3588,1924,3734,12888
2023-03-15,21,2371,919,3433,1699,4912,13334
2023-03-16,21,3698,926,2226,4274,2360,13484
2023-03-17,21,4413,2181,2621,3896,5657,18768
2023-03-18,21,2557,1532,2077,3683,3022,12871
2023-03-19,21,2157,1066,2006,3143,2426,10798
2023-03-20,21,4589,1902,2714,2263,2589,14057
2023-03-21,21,1651,1800,1296,4239,4436,13422
2023-03-22,21,4302,2498,3043,2145,5022,17010
2023-03-23,21,3048,2789,2707,3674,4987,17205
2023-03-24,21,1049,2496,2914,3737,4292,14488
2023-03-25,21,1781,1522,2972,2298,4104,12677
2023-03-26,21,1732,863,1771,3571,3673,11610
2023-03-27,21,4560,1293,2972,4180,5207,18212
2023-03-28,21,2404,1785,1671,2213,3471,11544
2023-03-29,21,4194,2364,3832,1711,4299,16400
2023-03-30,21,3769,1151,1709,3544,2527,12700
2023-03-31,21,3667,1105,1221,3459,3538,12990
2023-04-01,21,3473,2074,1682,2509,3393,13131
2023-04-02,21,2320,1375,2720,4415,3448,14278
2023-04-03,21,3291,1710,2003,2447,2137,11588
2023-04-04,21,3590,2852,1667,2795,4450,15354
2023-04-05,21,4699,2392,3337,3992,5750,20170
2023-04-06,21,3605,2288,2030,1900,4289,14112
2023-04-07,21,3817,2236,2821,1975,2341,13190
2023-04-08,21,1615,1130,2287,3668,2678,11378
2023-04-09,21,3064,1707,2065,2033,3722,12591
2023-04-10,21,2058,1576,2131,3684,3311,12760
2023-04-11,21,4797,2876,3377,2119,3198,16367
2023-04-12,21,1031,2242,1524,2908,4870,12575
2023-04-13,21,4696,1253,1974,3536,2598,14057
2023-04-14,21,3922,1138,1666,3448,5475,15649
2023-04-15,21,4732,2922,2245,3181,4450,17530
2023-04-16,21,3477,1841,2949,3904,3798,15969
2023-04-17,21,2141,2838,2171,2180,4007,13337
2023-04-18,21,1656,1246,2052,3495,3424,11873
2023-04-19,21,4474,2809,1535,1555,3754,14127
2023-04-20,21,3829,1714,2304,2020,5080,14947
2023-04-21,21,3098,2289,2013,2646,5178,15224
2023-04-22,21,1233,2208,3990,2266,4455,14152
2023-04-23,21,2050,1283,3101,2989,4379,13802
2023-04-24,21,1676,1938,3153,3079,3427,13273
2023-04-25,21,1211,2644,2434,4143,4763,15195
2023-04-26,21,2287,1528,3422,3853,3206,14296
2023-04-27,21,4673,2801,2344,2951,5157,17926
2023-04-28,21,4108,1508,1222,2939,4026,13803
2023-04-29,21,4346,1415,1313,1835,2741,11650
2023-04-30,21,2828,906,2895,4120,3644,14393
2023-05-01,21,2438,987,1713,4479,3891,13508
2023-05-02,21,2724,1043,3093,3296,5375,15531
2023-05-03,21,2657,2172,3260,3604,2541,14234
2023-05-04,21,3726,2884,2098,3734,2728,15170
2023-05-05,21,3879,2059,3643,1637,3477,14695
2023-05-06,21,3903,910,1388,1905,3552,11658
2023-05-07,21,1167,1183,2356,3817,4354,12877
2023-05-08,21,4893,2400,2043,4098,4538,17972
2023-05-09,21,4903,1159,3726,2585,4579,16952
2023-05-10,21,4075,1397,1961,3320,4295,15048
2023-05-11,21,2993,2332,1221,2197,5100,13843
2023-05-12,21,4855,2910,1398,4112,2630,15905
2023-05-13,21,2600,1207,3110,3446,4742,15105
2023-05-14,21,4640,1083,1522,3477,5690,16412
2023-05-15,21,1969,2511,2695,3693,2367,13235
2023-05-16,21,2875,2172,3467,4024,3734,16272
2023-05-17,21,1804,2308,1741,2922,3627,12402
2023-05-18,21,4493,1683,3842,1508,4402,15928
2023-05-19,21,2442,972,3841,1514,5857,14626
2023-05-20,21,4150,1807,2970,4268,2620,15815
2023-05-21,21,2488,2402,2944,3699,2682,14215
2023-05-22,21,4894,1960,3797,1828,3620,16099
2023-05-23,21,4996,2197,3382,1549,2281,14405
2023-05-24,21,4734,1617,3080,4413,4452,18296
2023-05-25,21,4053,1443,1916,2113,3413,12938
2023-05-26,21,4989,2628,3929,4371,3156,19073
2023-05-27,21,3888,2043,3193,3749,5236,18109
2023-05-28,21,4114,2782,2606,3135,4587,17224
2023-05-29,21,2501,2140,1949,2604,5779,14973
2023-05-30,21,4386,1152,2475,2985,2911,13909
2023-05-31,21,4612,1632,2028,4296,2897,15465
2023-06-01,21,2423,1645,2193,3671,4239,14171
2023-06-02,21,2933,2716,3622,4297,5919,19487
2023-06-03,21,2042,1853,1273,3296,2595,11059
2023-06-04,21,3232,853,1380,1833,3055,10353
2023-06-05,21,4592,1526,2266,3003,3543,14930
2023-06-06,21,1265,1930,1670,3186,5521,13572
2023-06-07,21,2392,2618,3237,4401,3412,16060
2023-06-08,21,1821,1830,1632,2758,3965,12006
2023-06-09,21,2865,1927,3165,3240,5276,16473
2023-06-10,21,3836,2935,1725,3990,5031,17517
2023-06-11,21,1978,2525,1714,1644,2560,10421
2023-06-12,21,3910,1439,3855,3486,2110,14800
2023-06-13,21,1795,2289,1410,2905,5196,13595
2023-06-14,21,1387,2210,2823,3592,5517,15529
2023-06-15,21,4064,1061,2923,2126,4935,15109
2023-06-16,21,1203,2798,2823,4163,5276,16263
2023-06-17,21,1337,1128,2410,2057,5107,12039
2023-06-18,21,4389,2042,2486,4034,2614,15565
2023-06-19,21,2460,1323,2674,3448,4656,14561
2023-06-20,21,1006,950,2438,3344,2708,10446
2023-06-21,21,2967,1081,2993,3407,5760,16208
2023-06-22,21,1058,2011,1734,2770,2177,9750
2023-06-23,21,1399,1540,1794,2307,3183,10223
2023-06-24,21,2619,2379,1273,3270,4021,13562
2023-06-25,21,4145,2525,2781,3948,4809,18208
2023-06-26,21,4555,2973,2201,1616,3056,14401
2023-06-27,21,2347,2858,3407,4460,3121,16193
2023-06-28,21,3240,1934,2668,3725,2493,14060
2023-06-29,21,2486,2411,3637,2571,2861,13966
2023-06-30,21,1026,2186,2307,4322,5518,15359
2023-07-01,21,2371,1111,1981,1534,5944,12941
2023-07-02,21,4468,2130,3772,1667,5497,17534
2023-07-03,21,4577,1170,2612,4365,4831,17555
2023-07-04,21,4207,806,2193,2347,4132,13685
2023-07-05,21,2812,820,1549,3397,4832,13410
2023-07-06,21,3558,2931,3126,1699,4052,15366
2023-07-07,21,1263,2504,3042,4485,3490,14784
2023-07-08,21,1309,924,2326,3043,3179,10781
2023-07-09,21,2285,2716,3940,4283,5677,18901
2023-07-10,21,3251,1653,2681,2778,3421,13784
2023-07-11,21,4626,1999,2054,3088,5187,16954
2023-07-12,21,1010,857,3009,1508,2188,8572
2023-07-13,21,1774,2459,2450,1983,4293,12959
2023-07-14,21,2047,1395,3018,3820,4894,15174
2023-07-15,21,2915,2402,2642,2472,2583,13014
2023-07-16,21,2688,2565,1404,2783,2486,11926
2023-07-17,21,3513,1147,3685,3955,2242,14542
2023-07-18,21,4828,2204,1262,3832,4877,17003
2023-07-19,21,1864,2495,1810,3611,3193,12973
2023-07-20,21,3112,818,1952,3571,2342,11795
2023-07-21,21,1278,2770,2128,2859,2349,11384
2023-07-22,21,4129,1665,1841,3402,3434,14471
2023-07-23,21,2181,2109,1342,3778,4402,13812
2023-07-24,21,3166,2892,2542,1822,3606,14028
2023-07-25,21,4920,2112,3310,1990,4392,16724
2023-07-26,21,3750,2370,2573,3894,2811,15398
2023-07-27,21,3873,2171,3526,3279,5834,18683
2023-07-28,21,2991,2173,2961,2359,3575,14059
2023-07-29,21,4897,1098,1395,1971,5742,15103
2023-07-30,21,2061,1772,3571,3058,3377,13839
2023-07-31,21,1971,1956,2669,1877,4163,12636
2023-08-01,21,3176,1671,1222,3059,3710,12838
2023-08-02,21,3968,1475,1529,2268,3209,12449
2023-08-03,21,3235,853,3588,2062,4728,14466
2023-08-04,21,3786,2726,1429,2254,2591,12786
2023-08-05,21,4775,956,2254,3093,2254,13332
2023-08-06,21,3164,2570,3581,3162,5014,17491
2023-08-07,21,3841,2415,1514,3503,4648,15921
2023-08-08,21,1950,2161,2439,2585,3046,12181
2023-08-09,21,4932,2715,3501,3954,2569,17671
2023-08-10,21,2671,1530,3671,3144,3035,14051
2023-08-11,21,3798,1408,3441,3495,4981,17123
2023-08-12,21,3363,1891,1361,4182,2665,13462
2023-08-13,21,4305,1999,1806,4006,2926,15042
2023-08-14,21,2800,2859,2195,4198,4543,16595
2023-08-15,21,3825,2272,2326,3679,2567,14669
2023-08-16,21,2260,2061,3108,3503,5011,15943
2023-08-17,21,1591,2608,2914,2027,2197,11337
2023-08-18,21,4358,2064,3780,1601,4247,16050
2023-08-19,21,1003,1756,1738,3029,3198,10724
2023-08-20,21,4684,2903,1679,3915,3628,16809
2023-08-21,21,1982,1263,1779,3363,3765,12152
2023-08-22,21,4657,2630,3790,3597,4065,18739
2023-08-23,21,4776,2481,2236,4348,2790,16631
2023-08-24,21,4103,2300,2629,3454,2011,14497
2023-08-25,21,2894,1281,2143,3844,3685,13847
2023-08-26,21,2017,899,1760,3392,4974,13042
2023-08-27,21,2238,2737,3127,2948,4803,15853
2023-08-28,21,2293,2860,2022,2606,3809,13590
2023-08-29,21,3058,1311,1994,4476,5777,16616
2023-08-30,21,2646,1696,3821,2261,5914,16338
2023-08-31,21,1648,1223,3855,1605,3122,11453
2023-09-01,21,1924,2953,2578,4099,3478,15032
2023-09-02,21,1876,1961,3171,3138,4173,14319
2023-09-03,21,1031,1459,1324,3624,4383,11821
2023-09-04,21,4004,2729,3479,1577,2815,14604
2023-09-05,21,2818,1416,3051,2475,3397,13157
2023-09-06,21,1757,2500,2731,2694,5812,15494
2023-09-07,21,4726,1829,1221,1797,3375,12948
2023-09-08,21,2051,2420,2919,1624,4939,13953
2023-09-09,21,2983,1882,2316,3371,3782,14334
2023-09-10,21,3609,2732,2623,2606,2928,14498
2023-09-11,21,4951,2466,2827,2584,2218,15046
2023-09-12,21,1130,2821,2448,4476,5286,16161
2023-09-13,21,3362,1315,2394,2811,5967,15849
2023-09-14,21,4335,2476,3221,1820,2403,14255
2023-09-15,21,4643,2821,2747,3808,3941,17960
2023-09-16,21,4464,2241,2748,4212,5648,19313
2023-09-17,21,4785,1510,2126,3918,5225,17564
2023-09-18,21,1743,1395,3116,2381,4147,12782
2023-09-19,21,4070,1361,2210,2479,3571,13691
2023-09-20,21,4728,1268,1583,2671,4542,14792
2023-09-21,21,1966,2985,3129,3666,3581,15327
2023-09-22,21,1632,1994,3633,3315,2860,13434
2023-09-23,21,3210,1753,3332,2062,2849,13206
2023-09-24,21,4636,1494,1853,3032,5463,16478
2023-09-25,21,2088,1518,1520,3705,4311,13142
2023-09-26,21,2010,1871,2307,4361,3546,14095
2023-09-27,21,3180,1160,3574,1853,3362,13129
2023-09-28,21,3059,1589,3496,1692,3704,13540
2023-09-29,21,1659,1751,3307,3885,2552,13154
2023-09-30,21,1616,2595,2775,4262,5211,16459
2023-10-01,21,1782,2246,2666,2459,3457,12610
2023-10-02,21,2167,1088,1455,2706,5705,13121
2023-10-03,21,1476,1375,2949,3336,5004,14140
2023-10-04,21,4520,2869,2477,3148,2045,15059
2023-10-05,21,2529,2044,2463,3146,3876,14058
2023-10-06,21,1448,2001,3849,4173,5401,16872
2023-10-07,21,1538,1497,3174,4142,3787,14138
2023-10-08,21,4133,1686,1816,2282,4402,14319
2023-10-09,21,2190,1252,3154,1759,2399,10754
2023-10-10,21,1884,2151,3974,1577,4419,14005
2023-10-11,21,2503,2831,3593,4316,4545,17788
2023-10-12,21,3018,2791,2394,2531,4241,14975
2023-10-13,21,2906,2992,2029,2656,5368,15951
2023-10-14,21,1292,1550,1364,3377,4806,12389
2023-10-15,21,4056,2748,2881,4465,5332,19482
2023-10-16,21,1337,2106,3374,3637,5084,15538
2023-10-17,21,2971,2699,2923,3241,4987,16821
2023-10-18,21,3569,2472,3632,2103,3385,15161
2023-10-19,21,1467,1917,1965,3075,2075,10499
2023-10-20,21,2745,2347,3109,4426,5817,18444
2023-10-21,21,4559,2890,1616,2218,5790,17073
2023-10-22,21,2118,943,1370,3037,2612,10080
2023-10-23,21,3975,2988,1374,1627,2742,12706
2023-10-24,21,4762,1212,1803,3465,5238,16480
2023-10-25,21,1620,2413,1790,1880,5834,13537
2023-10-26,21,1216,1980,3498,4370,2837,13901
2023-10-27,21,2833,1290,2774,2123,2775,11795
2023-10-28,21,3847,2192,1578,2179,5742,15538
2023-10-29,21,3102,2573,3685,3753,2937,16050
2023-10-30,21,1406,1030,2780,2284,4068,11568
2023-10-31,21,2110,2938,2476,3343,5248,16115
2023-11-01,21,3502,2834,2504,2392,4783,16015
2023-11-02,21,1752,2930,3951,2993,4759,16385
2023-11-03,21,1981,2757,1847,2015,4856,13456
2023-11-04,21,2009,1964,3337,3603,5494,16407
2023-11-05,21,1352,2496,1747,2619,3225,11439
2023-11-06,21,4656,2003,3726,3575,4789,18749
2023-11-07,21,1749,2316,1419,3074,4617,13175
2023-11-08,21,2825,1237,3240,4223,4511,16036
2023-11-09,21,1025,1950,2989,3769,4053,13786
2023-11-10,21,3776,2554,2987,2782,3936,16035
2023-11-11,21,2992,828,3069,2951,3331,13171
2023-11-12,21,3559,2161,3209,1868,3937,14734
2023-11-13,21,3240,1690,3102,2490,2253,12775
2023-11-14,21,1919,1842,1556,3764,4406,13487
2023-11-15,21,3832,1801,2166,2916,2780,13495
2023-11-16,21,1644,1736,1537,2557,4270,11744
2023-11-17,21,1693,1603,2007,1901,5752,12956
2023-11-18,21,1635,1049,1290,3774,2945,10693
2023-11-19,21,2855,1524,3475,1622,5845,15321
2023-11-20,21,2211,928,1888,2781,3811,11619
2023-11-21,21,4876,2247,2275,2474,2028,13900
2023-11-22,21,3016,943,3112,2703,2834,12608
2023-11-23,21,4863,2234,3685,3453,5895,20130
2023-11-24,21,3039,1085,3348,4433,3576,15481
2023-11-25,21,1550,2950,3754,2572,4404,15230
2023-11-26,21,1488,1457,2851,4490,5690,15976
2023-11-27,21,3125,941,2062,4408,4972,15508
2023-11-28,21,4653,1652,3789,1943,4941,16978
2023-11-29,21,4618,2483,2646,2406,2456,14609
2023-11-30,21,4633,1905,1457,2571,4606,15172
2023-12-01,21,3523,2633,3270,4028,4454,17908
2023-12-02,21,2918,1675,2155,1917,2354,11019
2023-12-03,21,4526,2734,1639,1628,5642,16169
2023-12-04,21,1407,2142,1965,2663,2924,11101
2023-12-05,21,2893,2691,2741,2290,2286,12901
2023-12-06,21,1915,1740,2931,2633,2347,11566
2023-12-07,21,4699,831,3295,2410,2762,13997
2023-12-08,21,2003,1181,1211,2958,4513,11866
2023-12-09,21,1768,995,1248,1746,2148,7905
2023-12-10,21,3743,2100,1385,2639,2888,12755
2023-12-11,21,2957,1453,3395,4469,2008,14282
2023-12-12,21,3889,2371,1655,3980,5438,17333
2023-12-13,21,1926,2538,2993,2396,5700,15553
2023-12-14,21,3382,1751,1619,3379,2243,12374
2023-12-15,21,1572,1255,2016,2868,2274,9985
2023-12-16,21,2843,2515,2209,1857,4690,14114
2023-12-17,21,1039,1447,3101,3022,4504,13113
2023-12-18,21,3013,2353,1870,2914,3449,13599
2023-12-19,21,4844,1408,3969,2221,4471,16913
2023-12-20,21,3960,2633,2696,3859,5324,18472
2023-12-21,21,1430,915,3318,2878,4784,13325
2023-12-22,21,2629,1066,2461,1745,4016,11917
2023-12-23,21,1060,2298,3255,4294,4114,15021
2023-12-24,21,1781,1164,2011,3317,5544,13817
2023-12-25,21,1255,2922,1440,3239,4608,13464
2023-12-26,21,1716,1480,1903,3406,4243,12748
2023-12-27,21,4679,1148,2996,3814,3356,15993
2023-12-28,21,4986,2062,3935,3877,2743,17603
2023-12-29,21,4583,2923,1545,2989,4099,16139
2023-12-30,21,3299,1843,2766,1529,4066,13503
2023-12-31,21,2754,835,3652,2409,5438,15088
2022-01-01,22,1680,2630,3095,3112,4188,14705
2022-01-02,22,4866,917,2606,2718,3218,14325
2022-01-03,22,2279,821,2902,3122,4511,13635
2022-01-04,22,1421,1898,1955,1549,2713,9536
2022-01-05,22,3135,2591,2023,4188,5296,17233
2022-01-06,22,1426,2296,3126,4217,4604,15669
2022-01-07,22,4745,2533,3094,1701,3581,15654
2022-01-08,22,4709,2596,3800,4323,3034,18462
2022-01-09,22,1620,1128,1935,1667,2687,9037
2022-01-10,22,2649,2736,1652,2319,5340,14696
2022-01-11,22,3453,848,3053,4206,5573,17133
2022-01-12,22,1565,1014,3718,3222,4153,13672
2022-01-13,22,2669,863,2308,1672,4386,11898
2022-01-14,22,1828,1439,2024,2094,3090,10475
2022-01-15,22,1842,2217,2267,3939,3473,13738
2022-01-16,22,4257,1551,2169,1922,5420,15319
2022-01-17,22,1806,2323,1561,2428,5811,13929
2022-01-18,22,1329,828,3007,2048,4800,12012
2022-01-19,22,3073,914,1703,2178,5420,13288
2022-01-20,22,3416,2121,3077,1766,4892,15272
2022-01-21,22,3685,2232,3306,2199,2878,14300
2022-01-22,22,3097,2686,2535,1948,2574,12840
2022-01-23,22,2236,1511,2982,3948,2232,12909
2022-01-24,22,1205,1468,1924,3489,5553,13639
2022-01-25,22,4243,1456,1891,2688,5137,15415
2022-01-26,22,1296,1348,2749,2119,2676,10188
2022-01-27,22,3732,2144,1854,4194,5963,17887
2022-01-28,22,1783,2048,3672,2801,4206,14510
2022-01-29,22,1182,1120,2732,2924,4042,12000
2022-01-30,22,1375,961,1978,2585,5487,12386
2022-01-31,22,3881,2918,1443,2243,4633,15118
2022-02-01,22,3991,2611,3461,2578,4081,16722
2022-02-02,22,3916,938,1953,3203,5694,15704
2022-02-03,22,2175,2652,2724,4268,5186,17005
2022-02-04,22,4560,2181,2458,4396,3766,17361
2022-02-05,22,4617,902,1435,2652,5277,14883
2022-02-06,22,3602,2071,2731,2534,5743,16681
2022-02-07,22,2499,1219,1468,2316,2540,10042
2022-02-08,22,1420,2307,2519,1810,2098,10154
2022-02-09,22,4021,1433,3570,1700,5724,16448
2022-02-10,22,2964,1125,1738,3601,3074,12502
2022-02-11,22,2566,1011,2808,3566,3349,13300
2022-02-12,22,3683,2337,2129,4271,4164,16584
2022-02-13,22,1335,1855,2507,3581,5777,15055
2022-02-14,22,2952,2949,3427,1795,5114,16237
2022-02-15,22,2452,2641,2457,1812,2647,12009
2022-02-16,22,2043,1475,1482,2666,2942,10608
2022-02-17,22,4599,1583,3231,3731,5964,19108
2022-02-18,22,4634,1383,1653,2910,4226,14806
2022-02-19,22,4322,1451,3823,3841,5241,18678
2022-02-20,22,1072,1646,2306,2861,2796,10681
2022-02-21,22,3636,1381,2360,4484,3832,15693
2022-02-22,22,3685,2678,3433,3169,2393,15358
2022-02-23,22,2138,910,3859,3363,4381,14651
2022-02-24,22,1095,2207,1328,2229,5128,11987
2022-02-25,22,2898,2176,3069,3162,2355,13660
2022-02-26,22,2501,1876,1393,4221,3039,13030
2022-02-27,22,3916,1733,2591,2879,3361,14480
2022-02-28,22,4292,2342,3904,4243,3765,18546
2022-03-01,22,2430,1169,2887,1736,2887,11109
2022-03-02,22,3092,2088,1328,3484,2368,12360
2022-03-03,22,3586,1761,3782,2315,2244,13688
2022-03-04,22,2814,2387,2140,3473,5599,16413
2022-03-05,22,1141,2993,3177,3585,5526,16422
2022-03-06,22,3387,2738,3641,2907,3829,16502
2022-03-07,22,2438,2102,2203,1997,5031,13771
2022-03-08,22,3179,1317,3274,4482,4796,17048
2022-03-09,22,4143,1949,2501,1695,5766,16054
2022-03-10,22,4514,1792,2010,3996,4095,16407
2022-03-11,22,2540,1029,2487,2333,5301,13690
2022-03-12,22,3622,868,1582,3158,3181,12411
2022-03-13,22,4030,961,2794,1507,4613,13905
2022-03-14,22,3537,1584,3686,1815,5885,16507
2022-03-15,22,1172,1164,1239,1613,5436,10624
2022-03-16,22,3802,1943,2527,3121,4863,16256
2022-03-17,22,2781,2993,2162,3910,3210,15056
2022-03-18,22,4046,2846,1948,2774,3025,14639
2022-03-19,22,1686,2561,2156,3321,2868,12592
2022-03-20,22,3520,1230,3340,2259,3543,13892
2022-03-21,22,1436,2360,3554,2805,2774,12929
2022-03-22,22,2016,2825,1457,3312,5886,15496
2022-03-23,22,1626,1308,3840,2294,5589,14657
2022-03-24,22,4338,997,2692,2322,5939,16288
2022-03-25,22,1564,1775,1775,4050,5577,14741
2022-03-26,22,1526,1434,2009,2591,4519,12079
2022-03-27,22,2333,2772,1981,3023,2853,12962
2022-03-28,22,1717,963,1481,2635,4151,10947
2022-03-29,22,2195,2502,1871,1621,5104,13293
2022-03-30,22,1912,1907,2621,3210,4433,14083
2022-03-31,22,3825,837,3968,2331,4295,15256
2022-04-01,22,4907,1408,1470,1776,5558,15119
2022-04-02,22,1547,2797,3043,2282,2504,12173
2022-04-03,22,1033,1224,3060,3612,2091,11020
2022-04-04,22,3940,2508,3908,1913,4870,17139
2022-04-05,22,4540,1793,2565,3041,4575,16514
2022-04-06,22,2562,2523,3984,2149,4888,16106
2022-04-07,22,3978,2251,1963,3530,3211,14933
2022-04-08,22,2264,2474,3680,3443,2136,13997
2022-04-09,22,1838,956,2244,2750,4344,12132
2022-04-10,22,1761,1924,1425,1806,4810,11726
2022-04-11,22,4074,2559,3577,2425,3357,15992
2022-04-12,22,1414,1599,2754,2617,2259,10643
2022-04-13,22,2668,1582,3037,2441,4630,14358
2022-04-14,22,2247,1381,3390,2719,5167,14904
2022-04-15,22,4300,1961,2537,2520,5049,16367
2022-04-16,22,1384,2633,2409,3046,5432,14904
2022-04-17,22,2685,2893,2114,2611,3362,13665
2022-04-18,22,1871,2990,2036,1807,3928,12632
2022-04-19,22,1859,2891,2196,2457,3419,12822
2022-04-20,22,2559,819,3322,2229,5870,14799
2022-04-21,22,1686,2171,3936,3804,3975,15572
2022-04-22,22,3304,958,3885,2092,4172,14411
2022-04-23,22,2150,1943,1242,2155,4367,11857
2022-04-24,22,4276,871,2113,3118,5044,15422
2022-04-25,22,1138,1818,3979,3299,3363,13597
2022-04-26,22,2951,1047,3817,2623,4560,14998
2022-04-27,22,4946,2864,2470,2450,4334,17064
2022-04-28,22,2518,1655,1866,1776,5557,13372
2022-04-29,22,2447,898,3080,2519,4044,12988
2022-04-30,22,3355,1090,2225,2806,4689,14165
2022-05-01,22,3288,2158,2491,4134,2645,14716
2022-05-02,22,1036,2573,1219,3552,4398,12778
2022-05-03,22,3212,1165,2118,1845,2998,11338
2022-05-04,22,1789,1738,2858,2470,4367,13222
2022-05-05,22,3743,2603,2969,1775,2639,13729
2022-05-06,22,2824,2726,3193,1524,3169,13436
2022-05-07,22,1739,2167,3737,2825,3530,13998
2022-05-08,22,1461,1534,3657,3496,5801,15949
2022-05-09,22,4682,2425,3628,4330,4402,19467
2022-05-10,22,3254,1869,3617,2494,3140,14374
2022-05-11,22,4065,2642,2309,1966,2913,13895
2022-05-12,22,2396,1022,3959,1585,3412,12374
2022-05-13,22,4238,2663,1282,3071,2367,13621
2022-05-14,22,3099,1243,3414,2609,5494,15859
2022-05-15,22,3756,1362,3309,2172,5822,16421
2022-05-16,22,4006,2827,1488,2536,4118,14975
2022-05-17,22,4389,2074,2878,2153,5400,16894
2022-05-18,22,1049,3000,2375,3960,2385,12769
2022-05-19,22,4101,922,2376,3385,3316,14100
2022-05-20,22,2531,1683,3683,2241,3525,13663
2022-05-21,22,1356,1799,3877,2295,4196,13523
2022-05-22,22,3533,2162,1631,4473,5200,16999
2022-05-23,22,3456,2152,3484,2568,2282,13942
2022-05-24,22,1148,1283,2096,1588,5899,12014
2022-05-25,22,4894,2258,3714,2469,2123,15458
2022-05-26,22,4081,1531,2875,2996,4521,16004
2022-05-27,22,2743,2881,1268,4134,4034,15060
2022-05-28,22,3281,2975,2153,3786,2134,14329
2022-05-29,22,3642,2541,3404,1983,5900,17470
2022-05-30,22,4403,1009,2158,2446,2962,12978
2022-05-31,22,4482,2274,3986,4365,5088,20195
2022-06-01,22,1186,1202,2863,3301,5889,14441
2022-06-02,22,4570,1062,2793,3083,2667,14175
2022-06-03,22,2103,1564,3478,3430,3306,13881
2022-06-04,22,1626,1526,2400,2122,3675,11349
2022-06-05,22,3157,2139,3131,2183,4569,15179
2022-06-06,22,1130,1418,3213,3409,5388,14558
2022-06-07,22,3450,2187,1998,1635,5364,14634
2022-06-08,22,4467,2728,2081,2497,4706,16479
2022-06-09,22,2508,2002,1631,2823,3018,11982
2022-06-10,22,1346,1387,1349,2874,5062,12018
2022-06-11,22,3327,1822,3695,1968,2122,12934
2022-06-12,22,4778,1748,3929,2324,4922,17701
2022-06-13,22,2345,1947,3276,3002,4855,15425
2022-06-14,22,3723,2637,1421,4027,5127,16935
2022-06-15,22,2686,1004,2146,4107,5692,15635
2022-06-16,22,2055,1816,2155,2930,5322,14278
2022-06-17,22,3866,1962,3130,4389,4487,17834
2022-06-18,22,1539,939,3918,3465,4130,13991
2022-06-19,22,1664,2451,2961,4026,4186,15288
2022-06-20,22,4825,2453,1756,3551,5896,18481
2022-06-21,22,3433,1197,3664,1828,4475,14597
2022-06-22,22,4259,1360,2114,2981,3279,13993
2022-06-23,22,4437,1494,3394,3346,3873,16544
2022-06-24,22,2700,1584,3346,2650,3582,13862
2022-06-25,22,2912,874,3101,1817,2623,11327
2022-06-26,22,4662,2569,1606,1738,3524,14099
2022-06-27,22,2923,1525,2160,3839,2503,12950
2022-06-28,22,1168,960,1442,1697,2409,7676
2022-06-29,22,3692,908,3365,3292,5535,16792
2022-06-30,22,1213,2076,1606,2644,4280,11819
2022-07-01,22,1044,2324,1336,3515,4210,12429
2022-07-02,22,3529,2496,3195,2779,2771,14770
2022-07-03,22,2139,1050,1334,3390,4721,12634
2022-07-04,22,1614,2266,3560,4203,5030,16673
2022-07-05,22,2806,1527,2078,1851,3172,11434
2022-07-06,22,3087,1688,2515,2530,2877,12697
2022-07-07,22,3682,2757,3498,4027,3511,17475
2022-07-08,22,2255,1969,2694,2233,3205,12356
2022-07-09,22,1979,1228,3196,4271,5828,16502
2022-07-10,22,3683,2258,1461,3856,3601,14859
2022-07-11,22,1233,2853,1807,3312,2308,11513
2022-07-12,22,2766,1522,2664,3007,2424,12383
2022-07-13,22,4887,1100,1321,3231,4533,15072
2022-07-14,22,1042,1821,3410,4445,2871,13589
2022-07-15,22,2306,2378,2598,3585,5667,16534
2022-07-16,22,1838,2410,2963,3703,4540,15454
2022-07-17,22,2031,2935,3603,1658,5246,15473
2022-07-18,22,3869,2854,3684,4213,2085,16705
2022-07-19,22,2533,1177,1567,2183,4608,12068
2022-07-20,22,2704,2926,2636,1830,2387,12483
2022-07-21,22,4289,1546,3126,1917,2542,13420
2022-07-22,22,4794,1064,1944,2813,4123,14738
2022-07-23,22,4420,2239,1777,2871,5340,16647
2022-07-24,22,1549,1479,3170,2334,3973,12505
2022-07-25,22,3305,1982,2171,3811,4162,15431
2022-07-26,22,1238,1407,2250,2455,2821,10171
2022-07-27,22,2243,1681,2524,4195,2628,13271
2022-07-28,22,2552,1836,2448,3351,4178,14365
2022-07-29,22,1267,2277,2757,3957,4973,15231
2022-07-30,22,4302,2603,3849,3782,2438,16974
2022-07-31,22,4264,1810,2123,4063,4828,17088
2022-08-01,22,1600,2541,3344,3840,5784,17109
2022-08-02,22,3475,2020,1360,4223,5779,16857
2022-08-03,22,2761,963,1689,4250,5857,15520
2022-08-04,22,4315,2664,1439,4090,3317,15825
2022-08-05,22,4113,1304,2138,3438,2111,13104
2022-08-06,22,3618,1298,2954,4295,4245,16410
2022-08-07,22,1819,1951,3695,2241,4898,14604
2022-08-08,22,3265,1373,2132,3828,2951,13549
2022-08-09,22,1574,1031,3940,1966,4298,12809
2022-08-10,22,1455,2760,1557,3274,2096,11142
2022-08-11,22,4655,1143,2337,3754,3513,15402
2022-08-12,22,3975,2685,1446,3053,5944,17103
2022-08-13,22,1941,2793,3888,3039,3179,14840
2022-08-14,22,2338,2100,1866,2364,3513,12181
2022-08-15,22,2995,2559,2406,1688,3808,13456
2022-08-16,22,4246,2667,3649,2063,5607,18232
2022-08-17,22,2011,2602,3998,3436,5541,17588
2022-08-18,22,3703,1909,2262,2880,3971,14725
2022-08-19,22,3446,1456,2448,3741,4727,15818
2022-08-20,22,3108,2634,1924,2344,2279,12289
2022-08-21,22,3317,1581,3731,4364,4755,17748
2022-08-22,22,1085,1211,3490,1506,4777,12069
2022-08-23,22,2318,1484,2931,2028,3949,12710
2022-08-24,22,4059,2267,2056,3516,3071,14969
2022-08-25,22,4990,1042,3971,2551,5568,18122
2022-08-26,22,2936,2733,1639,3453,5149,15910
2022-08-27,22,2805,974,2484,3631,5380,15274
2022-08-28,22,4649,2329,3631,3262,5024,18895
2022-08-29,22,2398,2046,1778,4125,3661,14008
2022-08-30,22,4054,1037,2054,1870,3883,12898
2022-08-31,22,2448,2214,1728,3016,2038,11444
2022-09-01,22,1560,2275,2041,2613,3880,12369
2022-09-02,22,2540,1686,3776,3779,3354,15135
2022-09-03,22,2654,1823,3722,3386,4358,15943
2022-09-04,22,4975,860,1345,2954,5225,15359
2022-09-05,22,3558,1012,1678,1805,3374,11427
2022-09-06,22,3983,2217,1523,3666,3496,14885
2022-09-07,22,3681,884,2462,3339,5159,15525
2022-09-08,22,4107,1959,2504,1522,3124,13216
2022-09-09,22,2286,1843,3028,3804,3293,14254
2022-09-10,22,2847,901,2259,2518,3639,12164
2022-09-11,22,1694,1323,2033,1951,3812,10813
2022-09-12,22,3928,1244,1937,2482,4244,13835
2022-09-13,22,2954,2600,2580,3467,2876,14477
2022-09-14,22,2312,938,3813,2211,3835,13109
2022-09-15,22,1421,2046,3695,3287,4258,14707
2022-09-16,22,2948,1196,2443,2632,5737,14956
2022-09-17,22,1412,2901,3749,3792,3495,15349
2022-09-18,22,3115,1413,3331,1748,4581,14188
2022-09-19,22,4374,1572,3745,3342,5310,18343
2022-09-20,22,3728,1013,2891,3076,2637,13345
2022-09-21,22,3094,1171,3017,2330,3547,13159
2022-09-22,22,1384,1687,3012,4481,3286,13850
2022-09-23,22,3573,807,2661,4372,4473,15886
2022-09-24,22,3747,2794,3944,3026,5547,19058
2022-09-25,22,4325,1200,2443,3070,3523,14561
2022-09-26,22,4465,2851,2642,2041,3276,15275
2022-09-27,22,4926,1198,3300,3700,4697,17821
2022-09-28,22,1812,2440,3115,2255,4934,14556
2022-09-29,22,1047,2443,3720,3715,2640,13565
2022-09-30,22,4678,2792,1216,2825,5644,17155
2022-10-01,22,3550,1976,1321,2301,5984,15132
2022-10-02,22,2090,2381,2985,3247,4593,15296
2022-10-03,22,1199,2846,2534,3042,2330,11951
2022-10-04,22,3924,1007,3042,3882,2906,14761
2022-10-05,22,3170,1445,1383,3787,2241,12026
2022-10-06,22,3848,1481,1270,2548,5249,14396
2022-10-07,22,1867,2008,1915,2726,5473,13989
2022-10-08,22,3792,1526,3943,2354,2593,14208
2022-10-09,22,4601,2749,3350,2188,5635,18523
2022-10-10,22,2663,2304,1756,2501,5986,15210
2022-10-11,22,1017,2027,1311,3154,3207,10716
2022-10-12,22,3908,1653,2253,1848,2843,12505
2022-10-13,22,1859,2563,3544,1650,5840,15456
2022-10-14,22,2059,1827,2778,1617,4549,12830
2022-10-15,22,1173,2078,1913,4360,4550,14074
2022-10-16,22,1640,1258,3765,3551,5510,15724
2022-10-17,22,2188,1222,3361,3390,3877,14038
2022-10-18,22,3442,1474,1321,1562,4225,12024
2022-10-19,22,1646,2838,1259,4282,3241,13266
2022-10-20,22,1536,1307,2650,3873,4856,14222
2022-10-21,22,2224,2442,2314,3590,3460,14030
2022-10-22,22,1362,1358,2526,1770,3396,10412
2022-10-23,22,2903,2759,1908,1986,5461,15017
2022-10-24,22,1721,2703,1436,2684,3615,12159
2022-10-25,22,4022,1330,1857,4206,3042,14457
2022-10-26,22,2716,1570,1434,2530,3786,12036
2022-10-27,22,1803,1479,1787,2392,2783,10244
2022-10-28,22,1251,1864,2034,3047,2338,10534
2022-10-29,22,2380,2564,2356,3461,3291,14052
2022-10-30,22,3304,2886,3038,3749,2739,15716
2022-10-31,22,3744,2329,1435,2328,5837,15673
2022-11-01,22,3288,2001,2216,4295,3462,15262
2022-11-02,22,1906,1670,2053,4082,5014,14725
2022-11-03,22,2968,2780,3584,3063,4878,17273
2022-11-04,22,1818,2212,3763,4334,3878,16005
2022-11-05,22,2148,1535,1696,2371,2640,10390
2022-11-06,22,2897,2009,2433,2301,2542,12182
2022-11-07,22,3428,1650,2255,2554,5662,15549
2022-11-08,22,4205,1825,3186,2854,2479,14549
2022-11-09,22,3296,2624,1382,1549,3635,12486
2022-11-10,22,3964,1664,2882,2986,3762,15258
2022-11-11,22,4088,893,2901,4078,3220,15180
2022-11-12,22,2417,2643,3120,1643,3362,13185
2022-11-13,22,1601,1429,1354,3861,2484,10729
2022-11-14,22,3639,2432,2466,3772,3454,15763
2022-11-15,22,2792,1854,2767,3882,4378,15673
2022-11-16,22,4778,1764,2035,3924,4036,16537
2022-11-17,22,3807,2045,2974,2412,5680,16918
2022-11-18,22,4162,1881,2843,3974,4052,16912
2022-11-19,22,3002,2223,2999,3123,4379,15726
2022-11-20,22,1103,2868,2951,4344,4827,16093
2022-11-21,22,4937,2148,1219,3208,3238,14750
2022-11-22,22,1612,1851,2578,3053,5193,14287
2022-11-23,22,4434,2915,2963,3936,2767,17015
2022-11-24,22,2191,961,3124,2446,3331,12053
2022-11-25,22,4315,2820,2045,3098,4967,17245
2022-11-26,22,1650,2252,2859,3537,3320,13618
2022-11-27,22,4322,1423,3013,3842,2760,15360
2022-11-28,22,1286,2334,2582,3188,5085,14475
2022-11-29,22,3041,1922,2445,2262,4366,14036
2022-11-30,22,3256,2035,3485,3223,3579,15578
2022-12-01,22,3808,1948,1975,3884,2645,14260
2022-12-02,22,2379,2646,3184,2134,4131,14474
2022-12-03,22,1970,1187,1999,3288,5177,13621
2022-12-04,22,3299,959,2677,3199,3313,13447
2022-12-05,22,3140,1211,3896,2195,2178,12620
2022-12-06,22,2448,1624,3480,3020,5738,16310
2022-12-07,22,1819,1174,2207,2826,5612,13638
2022-12-08,22,3372,1190,3099,3842,3288,14791
2022-12-09,22,3543,2565,2464,4172,4582,17326
2022-12-10,22,4345,1017,2945,3211,4407,15925
2022-12-11,22,2742,986,2590,4338,4026,14682
2022-12-12,22,2716,2595,2181,2703,3472,13667
2022-12-13,22,3461,1023,1225,3195,2833,11737
2022-12-14,22,2235,1848,3484,1935,4441,13943
2022-12-15,22,2601,1677,3001,4360,5848,17487
2022-12-16,22,1872,1901,1386,2888,5430,13477
2022-12-17,22,1734,1009,1754,2142,5061,11700
2022-12-18,22,1242,922,2984,3683,5841,14672
2022-12-19,22,3503,1849,2152,4140,2926,14570
2022-12-20,22,1940,2174,2821,1777,3106,11818
2022-12-21,22,1137,1012,1992,3517,3537,11195
2022-12-22,22,4331,1444,2071,2618,2530,12994
2022-12-23,22,4159,2456,1978,4183,4504,17280
2022-12-24,22,1580,2172,3894,3576,2261,13483
2022-12-25,22,1243,1394,3098,4156,3255,13146
2022-12-26,22,4262,1987,1842,4022,2090,14203
2022-12-27,22,1582,2184,1481,3102,5217,13566
2022-12-28,22,3098,1548,3477,2497,2582,13202
2022-12-29,22,1619,866,3431,3087,3238,12241
2022-12-30,22,3158,1167,2887,1736,3633,12581
2022-12-31,22,1878,1312,1469,1611,2608,8878
2023-01-01,22,1972,963,3777,3755,5537,16004
2023-01-02,22,1246,1065,2228,2839,4590,11968
2023-01-03,22,2157,2222,3332,1766,4035,13512
2023-01-04,22,2538,2785,1420,3244,3523,13510
2023-01-05,22,3853,1760,1997,1546,3267,12423
2023-01-06,22,4384,809,1634,1926,4005,12758
2023-01-07,22,1110,2522,2526,3169,3253,12580
2023-01-08,22,4390,1995,2742,1683,5070,15880
2023-01-09,22,4997,1985,2241,3815,3661,16699
2023-01-10,22,4619,997,3816,3738,3480,16650
2023-01-11,22,1055,2656,3610,1856,3101,12278
2023-01-12,22,1998,2131,1925,2473,4253,12780
2023-01-13,22,2723,2123,2665,3428,2949,13888
2023-01-14,22,1953,843,2901,3163,3098,11958
2023-01-15,22,3156,2522,1946,2251,5012,14887
2023-01-16,22,1647,2770,2125,2820,3378,12740
2023-01-17,22,4355,995,1422,2760,3788,13320
2023-01-18,22,1494,2543,3637,3272,3212,14158
2023-01-19,22,2723,2127,2610,3444,5962,16866
2023-01-20,22,4229,1398,2505,1823,2423,12378
2023-01-21,22,2520,2839,2352,2775,2601,13087
2023-01-22,22,1304,1519,1393,1567,5931,11714
2023-01-23,22,4016,1996,3005,1950,3141,14108
2023-01-24,22,1799,2356,1369,2482,4398,12404
2023-01-25,22,1715,1706,3823,3952,4317,15513
2023-01-26,22,3062,2474,1279,2319,3406,12540
2023-01-27,22,3130,1780,2861,3385,2519,13675
2023-01-28,22,2404,2682,2010,2131,3652,12879
2023-01-29,22,1885,2519,2812,2224,5863,15303
2023-01-30,22,3752,846,2077,3853,5655,16183
2023-01-31,22,2349,2760,2620,3021,2158,12908
2023-02-01,22,4426,1819,3097,2066,5321,16729
2023-02-02,22,4902,2560,2524,1924,2788,14698
2023-02-03,22,3512,2329,3240,4451,4452,17984
2023-02-04,22,4565,2205,3953,1588,4896,17207
2023-02-05,22,1032,1087,2315,3983,5069,13486
2023-02-06,22,4574,1054,3149,3560,4390,16727
2023-02-07,22,2757,2870,3345,3654,2028,14654
2023-02-08,22,2039,850,2454,3370,5384,14097
2023-02-09,22,2071,1108,2598,2925,4914,13616
2023-02-10,22,1911,2126,1624,2938,3353,11952
2023-02-11,22,4189,866,1896,1977,3466,12394
2023-02-12,22,4096,1031,3412,2113,2455,13107
2023-02-13,22,4748,2403,1613,2805,2650,14219
2023-02-14,22,2560,2243,1963,4164,4014,14944
2023-02-15,22,1428,2058,3654,4194,5757,17091
2023-02-16,22,2370,1015,1800,2730,2916,10831
2023-02-17,22,2735,1674,3752,4496,4183,16840
2023-02-18,22,4406,1297,3269,3564,4054,16590
2023-02-19,22,3860,1617,3111,4219,4011,16818
2023-02-20,22,4389,2056,3032,2182,3672,15331
2023-02-21,22,3168,1539,3818,3989,4521,17035
2023-02-22,22,4866,1443,1903,3325,3924,15461
2023-02-23,22,4232,1775,3157,3728,4354,17246
2023-02-24,22,1732,805,3739,1609,4594,12479
2023-02-25,22,2179,822,2753,1549,5521,12824
2023-02-26,22,1870,1586,3704,3803,4920,15883
2023-02-27,22,1254,2712,2683,1508,4000,12157
2023-02-28,22,2337,1248,3496,3714,2924,13719
2023-03-01,22,2201,1717,2219,2889,2973,11999
2023-03-02,22,2926,2280,3064,1707,4186,14163
2023-03-03,22,2932,867,2323,4394,4347,14863
2023-03-04,22,1385,2467,2429,4399,5012,15692
2023-03-05,22,1414,2012,1517,4399,5992,15334
2023-03-06,22,2453,1493,1925,3805,4840,14516
2023-03-07,22,3647,2181,2075,1507,4046,13456
2023-03-08,22,2166,894,3359,2853,2698,11970
2023-03-09,22,3920,2247,2447,2590,2183,13387
2023-03-10,22,1623,2476,3763,4357,3340,15559
2023-03-11,22,2796,825,3868,4334,5607,17430
2023-03-12,22,1929,2198,2452,1743,5446,13768
2023-03-13,22,4763,2241,2477,2013,4099,15593
2023-03-14,22,3017,2168,3297,2486,4646,15614
2023-03-15,22,4822,1784,3928,3805,5806,20145
2023-03-16,22,2652,2896,1776,2344,3833,13501
2023-03-17,22,4541,1304,3159,3484,5482,17970
2023-03-18,22,1053,2476,3576,3065,3591,13761
2023-03-19,22,1282,1180,1763,1598,3419,9242
2023-03-20,22,2231,1296,1446,2430,3062,10465
2023-03-21,22,1484,2124,3794,3370,4316,15088
2023-03-22,22,3767,2937,1464,3862,2541,14571
2023-03-23,22,4486,828,1220,2681,5606,14821
2023-03-24,22,2332,2707,2557,2495,4038,14129
2023-03-25,22,2403,2650,2620,3103,3031,13807
2023-03-26,22,1639,2262,1901,1917,4614,12333
2023-03-27,22,2986,2402,3074,2450,4449,15361
2023-03-28,22,2640,1726,3453,2635,5562,16016
2023-03-29,22,3068,2080,3067,4265,4347,16827
2023-03-30,22,4301,1255,1537,2592,4797,14482
2023-03-31,22,2444,807,1624,1519,2261,8655
2023-04-01,22,3061,1263,3445,4320,5415,17504
2023-04-02,22,2743,1958,1246,4435,4071,14453
2023-04-03,22,3478,1077,1923,3342,2349,12169
2023-04-04,22,3802,1310,3723,1726,4957,15518
2023-04-05,22,3635,1583,1377,3423,5684,15702
2023-04-06,22,4570,901,1916,1861,5556,14804
2023-04-07,22,3177,1310,1806,2307,4248,12848
2023-04-08,22,3663,888,1560,2682,4757,13550
2023-04-09,22,1988,1963,3260,3189,5654,16054
2023-04-10,22,4115,2743,3152,3282,5554,18846
2023-04-11,22,2474,863,2624,3669,5692,15322
2023-04-12,22,1152,2595,2160,3205,5392,14504
2023-04-13,22,2857,2794,1579,1814,3713,12757
2023-04-14,22,3785,1068,3204,3960,3347,15364
2023-04-15,22,3066,1316,3978,3376,3466,15202
2023-04-16,22,2115,828,2099,3962,5634,14638
2023-04-17,22,2276,2441,3973,2781,5648,17119
2023-04-18,22,3299,2909,3021,3239,4415,16883
2023-04-19,22,2150,2907,2959,4334,2277,14627
2023-04-20,22,4259,1342,3834,4473,5575,19483
2023-04-21,22,3507,1112,3937,3262,2082,13900
2023-04-22,22,2051,2487,1592,3047,3391,12568
2023-04-23,22,3828,2684,2810,4151,4130,17603
2023-04-24,22,4050,1998,3015,2476,4282,15821
2023-04-25,22,1702,1822,2181,2587,5322,13614
2023-04-26,22,3538,1164,2213,4492,3341,14748
2023-04-27,22,1510,875,1780,2312,3977,10454
2023-04-28,22,4739,2714,3861,3819,5769,20902
2023-04-29,22,3862,2505,1277,1854,4009,13507
2023-04-30,22,3246,2451,3190,4292,2214,15393
2023-05-01,22,3565,1219,2350,3149,3862,14145
2023-05-02,22,2183,2427,1762,2822,5853,15047
2023-05-03,22,1697,1940,2225,4410,5830,16102
2023-05-04,22,4663,2401,3308,3124,2431,15927
2023-05-05,22,3493,1962,3852,3713,3424,16444
2023-05-06,22,3381,835,3492,3862,3192,14762
2023-05-07,22,4274,895,3704,2852,3460,15185
2023-05-08,22,2594,1995,3105,3948,2288,13930
2023-05-09,22,3060,2332,2778,3041,5697,16908
2023-05-10,22,1377,1896,2797,1992,2139,10201
2023-05-11,22,4776,2644,2486,3783,3646,17335
2023-05-12,22,2152,1121,2862,2769,3113,12017
2023-05-13,22,2038,1045,3009,3272,4100,13464
2023-05-14,22,3207,2663,3269,3645,2565,15349
2023-05-15,22,1190,1810,2897,3382,4146,13425
2023-05-16,22,1032,2462,2324,2447,4071,12336
2023-05-17,22,4418,1348,2358,3114,2318,13556
2023-05-18,22,1444,973,1441,2510,5555,11923
2023-05-19,22,2870,805,3708,2689,2762,12834
2023-05-20,22,2842,2847,2789,3252,3023,14753
2023-05-21,22,1786,2747,2978,4221,2777,14509
2023-05-22,22,2864,956,2641,3166,5395,15022
2023-05-23,22,3284,1729,3876,3313,2700,14902
2023-05-24,22,3205,1520,2955,4451,3955,16086
2023-05-25,22,3024,2037,1500,4352,2762,13675
2023-05-26,22,2977,1127,2807,3506,3441,13858
2023-05-27,22,1763,1981,3155,3769,5119,15787
2023-05-28,22,2024,1380,2667,1777,2072,9920
2023-05-29,22,1899,1581,1504,1939,4527,11450
2023-05-30,22,2858,2129,1878,1886,5904,14655
2023-05-31,22,2208,1370,2395,2768,3558,12299
2023-06-01,22,2653,2423,1604,3716,2269,12665
2023-06-02,22,1839,2288,1245,3432,4087,12891
2023-06-03,22,4444,2188,2528,4184,3317,16661
2023-06-04,22,1691,2171,2669,4217,3028,13776
2023-06-05,22,3777,2922,2387,4189,2813,16088
2023-06-06,22,4626,1414,2021,2264,3888,14213
2023-06-07,22,2527,2123,2052,3468,3769,13939
2023-06-08,22,2145,1546,2791,3925,3812,14219
2023-06-09,22,2013,1844,3302,3126,2556,12841
2023-06-10,22,1398,2365,2218,3915,3790,13686
2023-06-11,22,4805,934,1658,1835,4096,13328
2023-06-12,22,4787,2321,2349,1626,3333,14416
2023-06-13,22,1562,2033,1565,1512,2609,9281
2023-06-14,22,4625,1462,1549,2919,5493,16048
2023-06-15,22,1083,1972,3062,2934,4457,13508
2023-06-16,22,1486,1007,1706,2279,4333,10811
2023-06-17,22,1067,2357,1388,3475,4625,12912
2023-06-18,22,1039,2540,3004,2488,5880,14951
2023-06-19,22,4544,1836,2600,3731,3019,15730
2023-06-20,22,4082,1971,2410,2062,3658,14183
2023-06-21,22,3857,2710,1849,1801,2402,12619
2023-06-22,22,1495,2600,1448,2749,5827,14119
2023-06-23,22,4201,2380,3277,2358,4044,16260
2023-06-24,22,3272,1695,1408,3192,4741,14308
2023-06-25,22,2024,988,2838,3859,2763,12472
2023-06-26,22,1285,2812,3534,2442,4010,14083
2023-06-27,22,3458,2151,2393,1936,3243,13181
2023-06-28,22,4436,2638,3756,4316,5651,20797
2023-06-29,22,3896,2090,1428,3317,3924,14655
2023-06-30,22,2761,1034,1434,2751,3696,11676
2023-07-01,22,3035,1804,3265,2413,4906,15423
2023-07-02,22,2920,1851,2932,3544,4450,15697
2023-07-03,22,2639,1719,2304,1927,5811,14400
2023-07-04,22,4789,1563,1569,2546,3103,13570
2023-07-05,22,3499,2885,2468,2330,3183,14365
2023-07-06,22,2169,2877,2209,3003,3089,13347
2023-07-07,22,4865,1965,3269,2351,3411,15861
2023-07-08,22,1521,2797,2723,3742,2179,12962
2023-07-09,22,2112,2232,3270,1956,4676,14246
2023-07-10,22,3107,2057,1630,2411,2850,12055
2023-07-11,22,1558,2341,3496,3107,4243,14745
2023-07-12,22,4185,1765,1514,3588,2875,13927
2023-07-13,22,1613,1285,1564,4262,5890,14614
2023-07-14,22,1675,995,3315,2242,2387,10614
2023-07-15,22,4741,1974,2327,2032,2259,13333
2023-07-16,22,1008,2991,2345,3507,4937,14788
2023-07-17,22,4632,2607,3065,3261,4466,18031
2023-07-18,22,2988,2813,3972,2683,5117,17573
2023-07-19,22,2183,1637,3980,3024,5755,16579
2023-07-20,22,1422,1528,1534,2144,5280,11908
2023-07-21,22,3352,1448,3530,1748,3477,13555
2023-07-22,22,4585,2076,1548,3441,2951,14601
2023-07-23,22,4562,1089,1934,1803,3571,12959
2023-07-24,22,3238,1383,2260,4485,3921,15287
2023-07-25,22,2760,1007,1825,3543,5936,15071
2023-07-26,22,3464,2151,2925,3128,4098,15766
2023-07-27,22,2068,1560,2998,2121,5862,14609
2023-07-28,22,1675,2098,3486,3578,5379,16216
2023-07-29,22,3621,1608,2880,3932,2960,15001
2023-07-30,22,1495,1558,2600,2642,5494,13789
2023-07-31,22,1431,2254,3640,4040,2183,13548
2023-08-01,22,2168,2262,1459,1715,2590,10194
2023-08-02,22,4905,883,2216,4146,4180,16330
2023-08-03,22,3082,1756,3412,2559,4867,15676
2023-08-04,22,3677,1745,1745,2324,4201,13692
2023-08-05,22,3330,2028,3847,3798,2528,15531
2023-08-06,22,2791,2825,1288,2960,5972,15836
2023-08-07,22,2242,1227,3576,3702,4384,15131
2023-08-08,22,2632,2966,3665,3151,5068,17482
2023-08-09,22,2764,845,2152,2079,4851,12691
2023-08-10,22,4104,1421,3853,3853,3892,17123
2023-08-11,22,4631,1361,2840,4056,4220,17108
2023-08-12,22,2338,1406,1829,4239,3411,13223
2023-08-13,22,1653,1122,1716,3933,3368,11792
2023-08-14,22,1388,2699,2445,2607,2912,12051
2023-08-15,22,2391,1237,1257,3378,2895,11158
2023-08-16,22,3960,2077,3581,3182,5874,18674
2023-08-17,22,1102,1503,1342,4380,3853,12180
2023-08-18,22,4106,2886,2946,1922,3378,15238
2023-08-19,22,4926,2280,2335,4305,2661,16507
2023-08-20,22,4405,2855,3833,3312,5537,19942
2023-08-21,22,2869,2432,2829,3315,2458,13903
2023-08-22,22,4746,2583,1491,2188,4077,15085
2023-08-23,22,4308,2616,2041,3991,5628,18584
2023-08-24,22,4133,990,2253,2923,3314,13613
2023-08-25,22,4314,1131,1648,2244,2299,11636
2023-08-26,22,3544,1898,1523,2029,2421,11415
2023-08-27,22,4915,1057,3698,3388,2351,15409
2023-08-28,22,1685,2244,1785,4153,2914,12781
2023-08-29,22,1183,1643,2948,1955,4476,12205
2023-08-30,22,1434,2250,2085,3385,3855,13009
2023-08-31,22,2365,919,3606,4100,3812,14802
2023-09-01,22,2839,1911,1435,3883,4910,14978
2023-09-02,22,1680,1685,3237,1810,3169,11581
2023-09-03,22,2644,2076,3364,3094,2577,13755
2023-09-04,22,1146,1794,2034,3852,4372,13198
2023-09-05,22,4048,2731,2300,2717,4876,16672
2023-09-06,22,2357,2236,2263,3091,2983,12930
2023-09-07,22,3777,2356,3151,4473,4405,18162
2023-09-08,22,1653,2406,2641,2037,2457,11194
2023-09-09,22,1459,2185,2899,3075,4461,14079
2023-09-10,22,1172,1270,3377,1535,4275,11629
2023-09-11,22,3260,2032,1692,2340,3865,13189
2023-09-12,22,1506,1625,2926,2032,4214,12303
2023-09-13,22,1640,2784,1341,2401,4556,12722
2023-09-14,22,3281,2670,2123,3930,5655,17659
2023-09-15,22,3977,1483,3039,2296,4638,15433
2023-09-16,22,2492,1471,3573,3756,5661,16953
2023-09-17,22,4841,1844,3309,2843,3936,16773
2023-09-18,22,2785,928,3942,2196,3565,13416
2023-09-19,22,4753,2121,1963,3613,5518,17968
2023-09-20,22,4098,1048,2833,4371,3565,15915
2023-09-21,22,4069,1251,1815,1806,4855,13796
2023-09-22,22,1110,2114,1327,1926,2469,8946
2023-09-23,22,4720,2656,1397,2452,2639,13864
2023-09-24,22,1882,1073,2850,2535,5290,13630
2023-09-25,22,3365,2811,2832,3274,4926,17208
2023-09-26,22,3214,2625,1552,2331,4662,14384
2023-09-27,22,3649,1152,1727,2033,3736,12297
2023-09-28,22,1399,1990,2804,3443,5465,15101
2023-09-29,22,1471,2125,1284,3870,4834,13584
2023-09-30,22,3744,2027,3088,3616,4052,16527
2023-10-01,22,3009,2509,3539,4193,4418,17668
2023-10-02,22,2141,2975,1553,1543,5813,14025
2023-10-03,22,2363,2070,1907,4107,3839,14286
2023-10-04,22,4858,1092,2413,3515,3389,15267
2023-10-05,22,1042,1834,2023,3708,3968,12575
2023-10-06,22,1924,1787,1575,3578,3880,12744
2023-10-07,22,3567,2692,2256,1906,3860,14281
2023-10-08,22,1782,2118,3171,1806,3338,12215
2023-10-09,22,1832,2413,3724,2679,5704,16352
2023-10-10,22,1489,2938,2715,3727,5396,16265
2023-10-11,22,2375,2747,2475,3649,2855,14101
2023-10-12,22,3424,2743,1410,3163,5102,15842
2023-10-13,22,3666,1256,1671,4224,4589,15406
2023-10-14,22,3502,1934,1452,1644,2319,10851
2023-10-15,22,1575,1137,3173,3847,2545,12277
2023-10-16,22,1452,2193,1572,2133,3360,10710
2023-10-17,22,1021,2336,2310,2285,2423,10375
2023-10-18,22,4891,1621,2104,3983,3904,16503
2023-10-19,22,3145,2366,1221,3606,2722,13060
2023-10-20,22,1385,1611,2655,3392,5692,14735
2023-10-21,22,2522,1812,2543,3025,3253,13155
2023-10-22,22,1777,838,2470,3593,2518,11196
2023-10-23,22,3349,880,2382,4269,4933,15813
2023-10-24,22,2158,2407,3323,3182,3258,14328
2023-10-25,22,2104,1409,1493,2936,3603,11545
2023-10-26,22,4588,1385,2640,2696,4271,15580
2023-10-27,22,1406,1924,3596,4277,3972,15175
2023-10-28,22,1160,2368,1638,3776,4198,13140
2023-10-29,22,4720,914,2845,2870,3161,14510
2023-10-30,22,1117,1942,3888,3789,5587,16323
2023-10-31,22,2154,1649,1308,1673,4168,10952
2023-11-01,22,4702,1302,3068,2182,2100,13354
2023-11-02,22,4120,2618,3251,3326,3841,17156
2023-11-03,22,1153,1795,2617,1980,2129,9674
2023-11-04,22,2891,1915,1493,3317,2579,12195
2023-11-05,22,3890,2972,2418,4016,2883,16179
2023-11-06,22,1687,2273,2855,3077,3225,13117
2023-11-07,22,3417,1187,3508,2835,4433,15380
2023-11-08,22,3046,1133,3873,4252,3048,15352
2023-11-09,22,4662,2980,3602,2482,3628,17354
2023-11-10,22,3164,1211,3775,2241,5411,15802
2023-11-11,22,2284,1054,2584,2658,4608,13188
2023-11-12,22,1235,1824,3216,2199,5771,14245
2023-11-13,22,3315,2083,1708,2605,2923,12634
2023-11-14,22,3611,2548,1568,2969,3669,14365
2023-11-15,22,1363,2433,3823,2581,2457,12657
2023-11-16,22,2710,813,3232,2402,3132,12289
2023-11-17,22,1481,2094,1647,3359,4526,13107
2023-11-18,22,3274,1836,3666,3824,4981,17581
2023-11-19,22,3404,2236,2903,3374,2363,14280
2023-11-20,22,4813,1700,2480,3979,3285,16257
2023-11-21,22,2276,2427,2202,3420,5718,16043
2023-11-22,22,2345,1355,3081,2802,4718,14301
2023-11-23,22,3262,887,2204,2241,5590,14184
2023-11-24,22,4160,2129,1950,3413,3273,14925
2023-11-25,22,3507,2633,2909,2425,3627,15101
2023-11-26,22,3556,2335,2342,3398,3491,15122
2023-11-27,22,2096,1658,2128,2996,5678,14556
2023-11-28,22,2202,2037,1633,4086,4067,14025
2023-11-29,22,4436,2333,2573,3664,5171,18177
2023-11-30,22,3205,2363,1340,3788,3783,14479
2023-12-01,22,3494,942,2277,3403,2900,13016
2023-12-02,22,2034,2593,2888,3296,4298,15109
2023-12-03,22,1692,2766,2265,2016,2755,11494
2023-12-04,22,3845,1094,1976,2138,4088,13141
2023-12-05,22,2828,1227,1644,4299,5784,15782
2023-12-06,22,4844,2378,1423,2739,3537,14921
2023-12-07,22,4233,1641,1843,3790,3366,14873
2023-12-08,22,1885,1234,3929,3473,5438,15959
2023-12-09,22,3675,1384,2034,2602,5657,15352
2023-12-10,22,4458,1694,2290,1619,4603,14664
2023-12-11,22,3650,2770,1720,1652,2639,12431
2023-12-12,22,4467,931,2900,1876,5204,15378
2023-12-13,22,3334,1100,3961,2448,3987,14830
2023-12-14,22,4638,2255,3292,3167,2158,15510
2023-12-15,22,1117,1181,1410,3060,5693,12461
2023-12-16,22,1495,1430,1798,3153,4209,12085
2023-12-17,22,4282,2668,1326,4019,3724,16019
2023-12-18,22,4631,2500,2844,2810,4678,17463
2023-12-19,22,4918,1678,1271,4262,2954,15083
2023-12-20,22,4468,2145,1719,1995,3599,13926
2023-12-21,22,2571,1176,3478,3761,3642,14628
2023-12-22,22,4460,1064,2753,3849,4706,16832
2023-12-23,22,1713,2851,2332,3633,4196,14725
2023-12-24,22,1472,1610,3314,3576,2236,12208
2023-12-25,22,3605,1007,3051,2592,5195,15450
2023-12-26,22,3194,1724,2248,2365,2552,12083
2023-12-27,22,1478,886,3103,4179,2991,12637
2023-12-28,22,3924,1143,3484,1673,4935,15159
2023-12-29,22,1625,2932,2059,3856,5958,16430
2023-12-30,22,1533,2471,2201,4367,3080,13652
2023-12-31,22,3971,2674,2354,1885,4056,14940
2022-01-01,23,3436,2017,2465,2715,2742,13375
2022-01-02,23,2936,2878,2201,2233,2909,13157
2022-01-03,23,4687,2255,2391,1938,4509,15780
2022-01-04,23,2282,930,2418,1693,3670,10993
2022-01-05,23,3664,956,3286,3567,2589,14062
2022-01-06,23,3318,1687,1368,4356,4335,15064
2022-01-07,23,1472,1159,1379,4427,2989,11426
2022-01-08,23,2289,924,3272,3994,4880,15359
2022-01-09,23,2011,2967,2796,1652,5307,14733
2022-01-10,23,1816,1674,2944,2324,2439,11197
2022-01-11,23,3898,954,1772,2360,5053,14037
2022-01-12,23,4470,909,2737,4222,5015,17353
2022-01-13,23,4487,1260,2105,2912,3006,13770
2022-01-14,23,4917,1925,3416,3606,5057,18921
2022-01-15,23,4236,2092,3415,3709,2831,16283
2022-01-16,23,2971,835,3203,1534,3091,11634
2022-01-17,23,2913,2916,1750,3393,3869,14841
2022-01-18,23,1684,1609,2662,4246,3167,13368
2022-01-19,23,1616,2477,3489,3970,5785,17337
2022-01-20,23,3715,1941,1277,4369,4430,15732
2022-01-21,23,4520,1252,1229,3650,4539,15190
2022-01-22,23,3089,1977,3506,4195,5554,18321
2022-01-23,23,2353,2885,1941,2897,4868,14944
2022-01-24,23,4426,2080,1943,2365,5787,16601
2022-01-25,23,1900,2826,1835,3690,4893,15144
2022-01-26,23,1893,2647,1936,3563,5580,15619
2022-01-27,23,3826,1543,3629,1579,2127,12704
2022-01-28,23,1833,2623,2571,3086,2994,13107
2022-01-29,23,1293,2313,3786,2378,4095,13865
2022-01-30,23,3817,2783,1879,3938,4606,17023
2022-01-31,23,2482,2738,2740,3091,4467,15518
2022-02-01,23,2195,1090,3954,2832,5881,15952
2022-02-02,23,1503,2429,1744,2925,3695,12296
2022-02-03,23,4792,1117,2828,4366,2576,15679
2022-02-04,23,3913,2413,2837,2145,2400,13708
2022-02-05,23,2286,2648,2745,1982,2303,11964
2022-02-06,23,4950,1516,1587,2582,4450,15085
2022-02-07,23,2323,1681,2375,3544,3763,13686
2022-02-08,23,2575,2973,1263,4393,2989,14193
2022-02-09,23,3093,1062,1579,4094,5793,15621
2022-02-10,23,4830,1060,3814,3828,5031,18563
2022-02-11,23,4873,1228,3468,4282,2185,16036
2022-02-12,23,3054,1901,3037,4500,2888,15380
2022-02-13,23,4293,1959,3196,3014,4142,16604
2022-02-14,23,4592,2554,1887,2117,4704,15854
2022-02-15,23,2319,1527,3774,3514,4310,15444
2022-02-16,23,1074,2137,3961,4240,2551,13963
2022-02-17,23,3235,1356,2513,3495,3665,14264
2022-02-18,23,4532,893,3198,2119,5938,16680
2022-02-19,23,1295,2294,3788,4149,4419,15945
2022-02-20,23,4431,1006,1741,4117,4913,16208
2022-02-21,23,1371,1604,1207,1954,4662,10798
2022-02-22,23,3597,1430,3286,2201,2325,12839
2022-02-23,23,4173,1164,3251,1703,4308,14599
2022-02-24,23,2179,2063,1883,3128,2543,11796
2022-02-25,23,4645,2812,2205,2334,5676,17672
2022-02-26,23,4712,1065,3379,1505,3418,14079
2022-02-27,23,3668,1290,1991,2177,4921,14047
2022-02-28,23,2782,2911,2678,3284,5685,17340
2022-03-01,23,1464,2712,3454,3002,3445,14077
2022-03-02,23,1509,1272,1783,1918,3363,9845
2022-03-03,23,4616,1269,3350,1848,4107,15190
2022-03-04,23,4876,2618,3440,1789,5025,17748
2022-03-05,23,3641,1390,3613,3443,4307,16394
2022-03-06,23,2230,932,2413,3059,5874,14508
2022-03-07,23,4125,2550,2202,4063,2212,15152
2022-03-08,23,2205,889,3355,3249,4987,14685
2022-03-09,23,1982,1234,3191,1860,3550,11817
2022-03-10,23,3835,2586,2308,2816,3830,15375
2022-03-11,23,3402,2883,3228,3239,5072,17824
2022-03-12,23,1798,881,2091,2288,3223,10281
2022-03-13,23,1298,2857,2979,4411,2129,13674
2022-03-14,23,2131,1100,1435,3332,4596,12594
2022-03-15,23,4843,990,2714,3320,3957,15824
2022-03-16,23,3263,2984,2376,4452,4428,17503
2022-03-17,23,1487,1889,1209,1918,3597,10100
2022-03-18,23,2923,1557,3703,2610,4493,15286
2022-03-19,23,4834,1194,3739,3501,5988,19256
2022-03-20,23,1360,2115,2342,2237,4079,12133
2022-03-21,23,4444,2357,2874,3596,3128,16399
2022-03-22,23,1867,2250,3374,3173,3927,14591
2022-03-23,23,3449,2022,2153,3338,3504,14466
2022-03-24,23,3381,1780,3405,3445,4587,16598
2022-03-25,23,4097,2900,3442,3718,5046,19203
2022-03-26,23,3357,1608,2778,4009,5160,16912
2022-03-27,23,1327,1894,2300,3481,3940,12942
2022-03-28,23,3744,2977,3088,2494,4400,16703
2022-03-29,23,1624,1915,2773,3533,5296,15141
2022-03-30,23,4796,2531,2760,1608,2042,13737
2022-03-31,23,1443,2520,1948,2083,3082,11076
2022-04-01,23,1907,2830,2436,2979,2853,13005
2022-04-02,23,1554,2029,1474,3294,5411,13762
2022-04-03,23,3427,2957,3085,4342,5254,19065
2022-04-04,23,4635,939,2339,1513,3696,13122
2022-04-05,23,2438,1168,1758,3670,5067,14101
2022-04-06,23,1212,2574,2590,1546,3362,11284
2022-04-07,23,2428,2940,2865,2292,5247,15772
2022-04-08,23,1136,2900,3366,1527,5672,14601
2022-04-09,23,4362,1889,3346,4247,5282,19126
2022-04-10,23,3253,1518,1408,3255,4821,14255
2022-04-11,23,4057,2427,3211,4222,2027,15944
2022-04-12,23,4562,1086,3190,2926,2807,14571
2022-04-13,23,1333,1695,2640,2803,5479,13950
2022-04-14,23,3264,1329,2964,4188,5748,17493
2022-04-15,23,3859,2066,3639,4307,4957,18828
2022-04-16,23,3878,2956,2709,2100,5069,16712
2022-04-17,23,3980,1072,3608,3076,2371,14107
2022-04-18,23,4211,2726,2986,3913,5277,19113
2022-04-19,23,1391,2577,2878,3838,2182,12866
2022-04-20,23,2201,2860,3342,2212,3243,13858
2022-04-21,23,1420,2062,3564,4419,5745,17210
2022-04-22,23,1997,970,2579,2366,3903,11815
2022-04-23,23,4325,2537,1591,3591,2685,14729
2022-04-24,23,3310,997,2307,3522,4986,15122
2022-04-25,23,3605,1527,1821,1792,4357,13102
2022-04-26,23,3749,2554,1723,3001,3889,14916
2022-04-27,23,3698,1743,1630,4352,2616,14039
2022-04-28,23,1403,2651,1505,3183,3086,11828
2022-04-29,23,3931,2168,1714,2546,2452,12811
2022-04-30,23,3156,2619,2466,2103,2377,12721
2022-05-01,23,4514,2483,1594,2804,3700,15095
2022-05-02,23,2225,2423,1417,1616,2549,10230
2022-05-03,23,3131,1462,1739,2856,2441,11629
2022-05-04,23,2951,1196,3216,2952,4243,14558
2022-05-05,23,3802,2961,2468,3783,4055,17069
2022-05-06,23,4398,811,3180,2094,3862,14345
2022-05-07,23,3147,1073,2663,3300,5269,15452
2022-05-08,23,2207,1805,3376,2203,5505,15096
2022-05-09,23,2345,2610,2615,3028,3573,14171
2022-05-10,23,1587,1122,3888,2122,5119,13838
2022-05-11,23,2712,2643,2513,2160,5330,15358
2022-05-12,23,2046,1376,2073,1966,2930,10391
2022-05-13,23,3206,2469,3796,3701,3991,17163
2022-05-14,23,4722,2608,2546,3727,4496,18099
2022-05-15,23,2160,2007,2713,3545,4366,14791
2022-05-16,23,1459,1494,3063,1727,2697,10440
2022-05-17,23,3945,2812,1343,4223,2385,14708
2022-05-18,23,1973,1099,1847,3515,5257,13691
2022-05-19,23,1805,1915,2080,2389,4473,12662
2022-05-20,23,2645,2505,3499,3636,4550,16835
2022-05-21,23,3822,2742,3971,2385,2678,15598
2022-05-22,23,4967,2084,3484,3573,4447,18555
2022-05-23,23,3321,2047,1534,3554,4780,15236
2022-05-24,23,1256,2424,3075,4406,3286,14447
2022-05-25,23,1291,1057,3722,3639,4322,14031
2022-05-26,23,2160,1031,3597,2295,2863,11946
2022-05-27,23,1083,1518,2173,4235,4359,13368
2022-05-28,23,4836,1390,1715,4488,2791,15220
2022-05-29,23,4629,2179,2862,2737,5073,17480
2022-05-30,23,1092,2812,2276,2111,2073,10364
2022-05-31,23,2974,2121,1585,1900,4151,12731
2022-06-01,23,2056,1172,2163,3888,5004,14283
2022-06-02,23,4526,2321,3003,2816,3793,16459
2022-06-03,23,1049,1423,1721,2670,4292,11155
2022-06-04,23,4338,2353,2146,2444,4438,15719
2022-06-05,23,4108,1322,2085,2264,4870,14649
2022-06-06,23,2900,2991,3841,1639,4912,16283
2022-06-07,23,1553,1479,1422,2583,3151,10188
2022-06-08,23,2947,937,2637,3186,2182,11889
2022-06-09,23,3439,805,2668,1879,4943,13734
2022-06-10,23,4390,2639,1332,3378,5578,17317
2022-06-11,23,4888,1851,2485,3251,2503,14978
2022-06-12,23,1681,2298,2789,3708,5091,15567
2022-06-13,23,1347,2688,3596,3817,3667,15115
2022-06-14,23,3136,1255,1222,3822,4410,13845
2022-06-15,23,4660,1318,3857,4138,5146,19119
2022-06-16,23,3247,2271,1692,2851,2472,12533
2022-06-17,23,3955,2230,2327,3000,2231,13743
2022-06-18,23,3142,2400,3090,2363,4348,15343
2022-06-19,23,3967,988,2251,2383,2998,12587
2022-06-20,23,2834,2949,3448,1826,5758,16815
2022-06-21,23,3522,2995,2320,2969,5614,17420
2022-06-22,23,1603,2126,2661,3716,4243,14349
2022-06-23,23,4424,1008,3150,2043,2135,12760
2022-06-24,23,4598,2103,3395,2998,4000,17094
2022-06-25,23,2293,2612,3684,2606,4631,15826
2022-06-26,23,3363,1201,3477,3592,3667,15300
2022-06-27,23,2868,2644,1924,3235,3490,14161
2022-06-28,23,2850,2778,2575,2838,4097,15138
2022-06-29,23,3936,1738,3316,2283,3093,14366
2022-06-30,23,2156,2553,3420,3161,4851,16141
2022-07-01,23,3143,2592,1866,3627,3519,14747
2022-07-02,23,4552,1910,2493,2805,3756,15516
2022-07-03,23,1256,2817,1774,2149,2843,10839
2022-07-04,23,1709,1698,3730,3847,2929,13913
2022-07-05,23,1923,1867,2860,4478,3458,14586
2022-07-06,23,1147,1831,1548,2757,5774,13057
2022-07-07,23,4386,2633,2294,2827,3966,16106
2022-07-08,23,3879,1960,3839,1969,3440,15087
2022-07-09,23,4071,2728,3917,3797,2322,16835
2022-07-10,23,1961,944,3266,2587,5274,14032
2022-07-11,23,4199,2636,2788,3705,3410,16738
2022-07-12,23,2807,2984,1561,2852,5045,15249
2022-07-13,23,4362,1872,2519,1772,5677,16202
2022-07-14,23,2876,1798,3369,3783,4284,16110
2022-07-15,23,4978,2372,2663,3157,2306,15476
2022-07-16,23,3816,2807,3776,1567,5019,16985
2022-07-17,23,2920,1737,3254,2459,3350,13720
2022-07-18,23,4898,1033,1631,4079,3086,14727
2022-07-19,23,3231,2861,2278,2162,5522,16054
2022-07-20,23,3637,1031,3320,3790,2417,14195
2022-07-21,23,2537,862,2509,2123,5752,13783
2022-07-22,23,1915,1175,3902,4356,3092,14440
2022-07-23,23,4343,2390,3151,2929,4334,17147
2022-07-24,23,4535,2184,2854,3163,2433,15169
2022-07-25,23,4680,2898,1212,3210,2486,14486
2022-07-26,23,2214,2215,1426,3517,5344,14716
2022-07-27,23,2255,2757,2153,2343,2920,12428
2022-07-28,23,1067,1500,3494,3598,2260,11919
2022-07-29,23,2814,1203,3562,3995,2270,13844
2022-07-30,23,1341,2886,1543,3386,3374,12530
2022-07-31,23,4010,1161,3019,4055,3322,15567
2022-08-01,23,2368,1152,2184,3219,4031,12954
2022-08-02,23,1364,1839,3787,3084,3730,13804
2022-08-03,23,3237,2964,1262,3773,3990,15226
2022-08-04,23,1620,2334,1983,4104,5546,15587
2022-08-05,23,3239,2851,1816,4193,2586,14685
2022-08-06,23,3603,964,3992,1889,4715,15163
2022-08-07,23,3014,2509,3624,1533,3658,14338
2022-08-08,23,1773,1734,3248,4076,5513,16344
2022-08-09,23,2789,1983,3388,3449,3580,15189
2022-08-10,23,3741,1942,3015,2492,5919,17109
2022-08-11,23,1736,1137,1582,2199,5550,12204
2022-08-12,23,3278,1680,3475,3437,2572,14442
2022-08-13,23,2203,1821,2018,2028,4448,12518
2022-08-14,23,2672,2252,2239,2790,5288,15241
2022-08-15,23,2992,861,3950,3651,3884,15338
2022-08-16,23,1139,2640,2769,1963,2426,10937
2022-08-17,23,1573,1693,3156,4160,2780,13362
2022-08-18,23,2756,2425,2254,3455,2313,13203
2022-08-19,23,3624,2591,3645,1644,5990,17494
2022-08-20,23,4094,2193,3838,3658,3326,17109
2022-08-21,23,1629,2214,1591,4116,2277,11827
2022-08-22,23,1833,1863,2997,2017,2053,10763
2022-08-23,23,2610,1067,3696,4102,4918,16393
2022-08-24,23,4469,925,3017,2867,5673,16951
2022-08-25,23,1172,2032,1450,2742,4324,11720
2022-08-26,23,1082,2786,1777,3645,3902,13192
2022-08-27,23,3671,1146,1432,3124,4197,13570
2022-08-28,23,4743,2786,3916,2173,3959,17577
2022-08-29,23,3896,2780,3944,2767,2284,15671
2022-08-30,23,2606,1275,1277,4177,3324,12659
2022-08-31,23,2674,1693,1329,1608,3408,10712
2022-09-01,23,2740,2903,3545,4195,3649,17032
2022-09-02,23,3130,2722,2714,4283,4344,17193
2022-09-03,23,4462,1702,3468,3137,5406,18175
2022-09-04,23,1510,2422,2325,1596,5068,12921
2022-09-05,23,2182,1257,1299,1624,3352,9714
2022-09-06,23,3572,1739,1927,2661,4305,14204
2022-09-07,23,2914,2982,1484,3253,2630,13263
2022-09-08,23,1934,848,1674,2165,3374,9995
2022-09-09,23,3985,1856,2531,2861,4158,15391
2022-09-10,23,2328,1407,2325,3639,5494,15193
2022-09-11,23,4503,949,1667,2033,4862,14014
2022-09-12,23,1769,2613,2655,3245,4829,15111
2022-09-13,23,1567,2913,1746,1661,4768,12655
2022-09-14,23,3946,1664,3487,4152,5796,19045
2022-09-15,23,4797,1384,2198,2518,5128,16025
2022-09-16,23,4767,1701,2398,2329,4602,15797
2022-09-17,23,3421,2495,2244,3683,4021,15864
2022-09-18,23,1608,2530,2805,1582,3340,11865
2022-09-19,23,2153,1546,1328,3305,4588,12920
2022-09-20,23,4775,2906,3474,1949,3312,16416
2022-09-21,23,1077,1162,3676,2805,5613,14333
2022-09-22,23,1674,816,3346,2032,5823,13691
2022-09-23,23,4557,2980,2240,3758,2313,15848
2022-09-24,23,3354,1736,1282,3450,4538,14360
2022-09-25,23,4695,1881,1650,3016,2540,13782
2022-09-26,23,2820,2324,2772,4338,2372,14626
2022-09-27,23,3705,976,2213,2468,3700,13062
2022-09-28,23,2271,1733,2141,3836,2454,12435
2022-09-29,23,4914,1549,2199,1713,3662,14037
2022-09-30,23,4416,2222,1625,1731,2127,12121
2022-10-01,23,3329,1725,2365,4056,5964,17439
2022-10-02,23,3840,1413,1367,3642,2007,12269
2022-10-03,23,4335,1325,3723,3213,5741,18337
2022-10-04,23,1855,1938,1597,3737,5755,14882
2022-10-05,23,1213,2695,2998,3100,2044,12050
2022-10-06,23,3181,1107,3385,4111,3291,15075
2022-10-07,23,2047,1550,2329,2644,5084,13654
2022-10-08,23,3335,1431,2117,4343,3465,14691
2022-10-09,23,1458,1446,1428,4160,4182,12674
2022-10-10,23,4135,2925,2808,3115,4319,17302
2022-10-11,23,2152,878,1295,2830,3608,10763
2022-10-12,23,2921,842,3537,1843,5606,14749
2022-10-13,23,4885,1165,2884,2443,3581,14958
2022-10-14,23,1495,2347,2646,4096,5587,16171
2022-10-15,23,2548,2427,1368,2283,4581,13207
2022-10-16,23,1670,2669,3936,3256,2016,13547
2022-10-17,23,3617,2935,2657,2003,5666,16878
2022-10-18,23,3490,1804,3153,3520,3761,15728
2022-10-19,23,2721,1078,2099,3386,4149,13433
2022-10-20,23,1486,2402,2800,4107,4456,15251
2022-10-21,23,1391,1509,3568,4393,5375,16236
2022-10-22,23,2291,2270,2109,3358,5070,15098
2022-10-23,23,2139,1629,3117,2834,5893,15612
2022-10-24,23,2930,1534,2336,3626,3399,13825
2022-10-25,23,4771,939,1568,2649,2854,12781
2022-10-26,23,2724,2582,2638,4057,2987,14988
2022-10-27,23,1227,962,3643,4078,2960,12870
2022-10-28,23,4064,2412,2169,3061,3449,15155
2022-10-29,23,1296,1994,2054,2549,3738,11631
2022-10-30,23,2559,2837,3822,3406,5856,18480
2022-10-31,23,3764,2898,1306,3797,3379,15144
2022-11-01,23,4803,1829,3470,1911,3102,15115
2022-11-02,23,2213,2658,3397,1956,5434,15658
2022-11-03,23,3363,1499,3104,4285,4656,16907
2022-11-04,23,3490,2972,1386,3686,4732,16266
2022-11-05,23,2540,1104,3353,3156,5486,15639
2022-11-06,23,2648,2124,3737,3655,4075,16239
2022-11-07,23,2189,2755,2099,1506,2685,11234
2022-11-08,23,2830,2946,3012,4204,5128,18120
2022-11-09,23,3603,1025,1677,2153,3413,11871
2022-11-10,23,1264,1608,3957,3134,2648,12611
2022-11-11,23,3831,2947,1618,4167,2098,14661
2022-11-12,23,1132,1210,2395,3431,2423,10591
2022-11-13,23,2312,2994,1442,1741,3366,11855
2022-11-14,23,2213,1968,3728,3789,5647,17345
2022-11-15,23,2585,1177,2052,2119,2907,10840
2022-11-16,23,4385,2149,1490,3508,4025,15557
2022-11-17,23,2587,1390,2970,3340,2702,12989
2022-11-18,23,1501,2529,3690,4032,3601,15353
2022-11-19,23,1610,2311,3555,2472,5296,15244
2022-11-20,23,2841,1774,3651,3672,5140,17078
2022-11-21,23,3495,2371,2668,3270,4629,16433
2022-11-22,23,3333,2391,3436,4475,2510,16145
2022-11-23,23,2782,2082,1602,3169,5101,14736
2022-11-24,23,3701,2248,2463,4411,5244,18067
2022-11-25,23,4585,1247,3918,1749,3529,15028
2022-11-26,23,3260,1442,1317,4483,5080,15582
2022-11-27,23,2337,2175,1277,3224,4784,13797
2022-11-28,23,3879,1836,3337,2863,5693,17608
2022-11-29,23,4233,2863,3346,2173,4771,17386
2022-11-30,23,4170,1502,1260,3084,3235,13251
2022-12-01,23,2291,2640,2282,1962,4085,13260
2022-12-02,23,1543,2898,2201,4153,4596,15391
2022-12-03,23,1750,1707,2355,3787,4923,14522
2022-12-04,23,3901,808,3347,3000,2380,13436
2022-12-05,23,1868,2225,2090,2461,2356,11000
2022-12-06,23,4105,1881,2656,3193,3800,15635
2022-12-07,23,2906,2771,2990,3717,2092,14476
2022-12-08,23,4465,816,2088,3442,5819,16630
2022-12-09,23,3789,998,2717,3470,2139,13113
2022-12-10,23,4954,1788,2320,2754,5453,17269
2022-12-11,23,1563,2666,2493,2844,5175,14741
2022-12-12,23,3846,1058,1569,3839,5617,15929
2022-12-13,23,2945,903,2987,2187,4126,13148
2022-12-14,23,1936,1337,2018,1651,5614,12556
2022-12-15,23,4766,2600,2422,3901,2810,16499
2022-12-16,23,3613,1094,3806,4135,3457,16105
2022-12-17,23,2438,1329,1242,3382,5908,14299
2022-12-18,23,2738,2581,3424,1719,5102,15564
2022-12-19,23,1996,2974,1460,4412,5802,16644
2022-12-20,23,3812,1726,1512,2924,2716,12690
2022-12-21,23,1702,1861,3510,1889,2397,11359
2022-12-22,23,1627,1649,3203,1706,5160,13345
2022-12-23,23,1237,1834,3318,2356,5179,13924
2022-12-24,23,1225,889,3400,2997,5707,14218
2022-12-25,23,4149,849,3137,3504,3639,15278
2022-12-26,23,1369,1643,3139,1996,3719,11866
2022-12-27,23,2869,1542,1288,4121,5495,15315
2022-12-28,23,1151,963,3448,2140,4161,11863
2022-12-29,23,1224,2025,2432,4132,3119,12932
2022-12-30,23,3297,802,1857,2925,3085,11966
2022-12-31,23,4554,1942,2045,2330,4999,15870
2023-01-01,23,4116,1173,3289,1926,5664,16168
2023-01-02,23,1647,2289,1413,2520,5688,13557
2023-01-03,23,3600,2315,3253,3732,5660,18560
2023-01-04,23,1884,1357,3056,4103,4133,14533
2023-01-05,23,2875,1999,2085,3569,3135,13663
2023-01-06,23,3137,1857,2418,2666,3127,13205
2023-01-07,23,3419,2454,3396,2684,3186,15139
2023-01-08,23,1173,1383,1737,1589,5258,11140
2023-01-09,23,4627,875,2915,4089,3215,15721
2023-01-10,23,2200,1334,2992,2129,4833,13488
2023-01-11,23,1801,961,3614,3292,2486,12154
2023-01-12,23,2585,1825,2532,2516,4899,14357
2023-01-13,23,4801,1897,1555,2116,5422,15791
2023-01-14,23,1097,1976,2947,2343,5494,13857
2023-01-15,23,2597,1705,3670,3365,4756,16093
2023-01-16,23,2904,1505,2803,2182,3758,13152
2023-01-17,23,3732,1449,3663,1669,3148,13661
2023-01-18,23,2277,1002,2962,1961,5566,13768
2023-01-19,23,3332,1218,1390,3419,3586,12945
2023-01-20,23,3976,1617,2003,3016,3436,14048
2023-01-21,23,4485,1248,1376,2039,5867,15015
2023-01-22,23,4139,2951,3576,4475,5303,20444
2023-01-23,23,2276,2994,2564,3239,5820,16893
2023-01-24,23,2620,862,2264,3066,3885,12697
2023-01-25,23,4460,1843,1408,3080,3321,14112
2023-01-26,23,1265,1465,2759,3379,2902,11770
2023-01-27,23,4069,1257,2741,3206,5660,16933
2023-01-28,23,1578,2247,3577,3126,3311,13839
2023-01-29,23,4901,2631,3359,4214,3054,18159
2023-01-30,23,1021,1887,2041,3461,3272,11682
2023-01-31,23,2689,2307,2378,1895,5489,14758
2023-02-01,23,3283,2512,2087,4441,2112,14435
2023-02-02,23,3846,2641,2091,3594,5084,17256
2023-02-03,23,1294,872,3600,4070,4142,13978
2023-02-04,23,2129,1774,2238,3300,4548,13989
2023-02-05,23,3311,2557,2343,2409,4157,14777
2023-02-06,23,3279,1342,2063,3346,2652,12682
2023-02-07,23,4066,1978,1501,2280,2923,12748
2023-02-08,23,1554,1406,2686,3626,3035,12307
2023-02-09,23,4386,1867,2830,3505,4120,16708
2023-02-10,23,2927,2834,2872,3582,2759,14974
2023-02-11,23,3355,2065,2852,3564,4706,16542
2023-02-12,23,1521,2608,3824,3259,2830,14042
2023-02-13,23,2020,1265,3966,2947,3139,13337
2023-02-14,23,4059,1264,3606,4316,3469,16714
2023-02-15,23,3756,2865,3182,2993,2722,15518
2023-02-16,23,3956,2502,2286,4197,3485,16426
2023-02-17,23,1837,1287,1651,3107,3296,11178
2023-02-18,23,3530,2262,1495,3083,3742,14112
2023-02-19,23,3496,1665,1553,3193,4069,13976
2023-02-20,23,3909,1813,3829,3153,3572,16276
2023-02-21,23,3883,2823,3264,1668,2826,14464
2023-02-22,23,1179,905,2340,4200,4542,13166
2023-02-23,23,4427,1147,2227,4004,2481,14286
2023-02-24,23,4352,823,1925,2140,5609,14849
2023-02-25,23,4116,2953,3284,3269,3521,17143
2023-02-26,23,1599,2910,3325,2588,5659,16081
2023-02-27,23,3773,2508,3639,2972,5846,18738
2023-02-28,23,4508,876,3753,2915,3439,15491
2023-03-01,23,3351,2218,3240,2136,5200,16145
2023-03-02,23,4437,2967,1418,1691,2919,13432
2023-03-03,23,1858,2125,1421,4000,2001,11405
2023-03-04,23,2813,1087,1245,3889,3820,12854
2023-03-05,23,4066,2058,3328,1594,5993,17039
2023-03-06,23,4908,1441,2557,1737,4158,14801
2023-03-07,23,2135,2827,2230,1545,4409,13146
2023-03-08,23,3201,2995,3457,3477,3876,17006
2023-03-09,23,1447,1330,2330,2008,3332,10447
2023-03-10,23,4666,2839,3136,3002,4556,18199
2023-03-11,23,4551,1617,1956,2144,2748,13016
2023-03-12,23,1360,1624,1686,3453,5566,13689
2023-03-13,23,1397,1722,3952,3831,5277,16179
2023-03-14,23,1380,934,2718,4167,3664,12863
2023-03-15,23,2182,2439,2081,1959,4049,12710
2023-03-16,23,3464,1975,2159,2429,4144,14171
2023-03-17,23,4516,813,3241,3103,3282,14955
2023-03-18,23,4869,2124,1988,3406,2385,14772
2023-03-19,23,3699,1407,3371,1941,3924,14342
2023-03-20,23,4105,1398,3501,2490,3577,15071
2023-03-21,23,1912,860,2415,4219,4613,14019
2023-03-22,23,2135,2906,3847,2098,3804,14790
2023-03-23,23,2286,2225,2730,3134,2893,13268
2023-03-24,23,2773,1984,2311,4325,3308,14701
2023-03-25,23,3509,1149,3596,3474,2140,13868
2023-03-26,23,2647,1945,3506,3979,4911,16988
2023-03-27,23,3533,1228,3763,2846,4122,15492
2023-03-28,23,2593,2087,2809,3514,5463,16466
2023-03-29,23,3793,2321,2515,3502,3158,15289
2023-03-30,23,1181,1059,3010,3770,4419,13439
2023-03-31,23,4897,2079,1355,2876,5058,16265
2023-04-01,23,4111,907,2896,3447,2156,13517
2023-04-02,23,3700,1121,2778,1757,4043,13399
2023-04-03,23,2552,1308,1795,2449,4196,12300
2023-04-04,23,3377,1542,2806,3977,2113,13815
2023-04-05,23,1955,1057,3878,2852,4095,13837
2023-04-06,23,1423,840,1877,2156,4916,11212
2023-04-07,23,2537,1195,1258,1583,4849,11422
2023-04-08,23,3929,1211,3226,3882,5676,17924
2023-04-09,23,3524,1450,3295,2912,4148,15329
2023-04-10,23,1789,987,3522,3171,4235,13704
2023-04-11,23,4226,2439,2835,2941,4673,17114
2023-04-12,23,4523,1740,3056,1979,2820,14118
2023-04-13,23,4362,1094,1955,1903,4618,13932
2023-04-14,23,3202,2532,2292,3786,3816,15628
2023-04-15,23,3859,2537,3686,2236,4695,17013
2023-04-16,23,3768,2972,2955,1525,5420,16640
2023-04-17,23,1955,1362,3199,3066,3965,13547
2023-04-18,23,1726,1159,3758,2267,2147,11057
2023-04-19,23,3028,2102,2614,2914,2645,13303
2023-04-20,23,2537,2478,1785,2113,5675,14588
2023-04-21,23,1122,976,3402,3129,4370,12999
2023-04-22,23,4673,2303,3263,4152,2764,17155
2023-04-23,23,4068,2894,2540,1594,2704,13800
2023-04-24,23,3681,1243,2093,3417,5639,16073
2023-04-25,23,2533,1213,1533,4211,4017,13507
2023-04-26,23,4373,1462,2971,3516,3423,15745
2023-04-27,23,3938,2059,2940,3386,3952,16275
2023-04-28,23,1062,2298,2348,4184,3186,13078
2023-04-29,23,1544,1735,2779,3051,4281,13390
2023-04-30,23,1555,2638,1998,3360,5199,14750
2023-05-01,23,1760,1272,2946,3682,5654,15314
2023-05-02,23,1743,1470,3485,2936,3654,13288
2023-05-03,23,4247,2071,2146,3655,5455,17574
2023-05-04,23,4665,1007,1212,2888,3799,13571
2023-05-05,23,4739,1241,2601,2903,2661,14145
2023-05-06,23,2633,1862,3084,3398,5534,16511
2023-05-07,23,3221,2092,2686,3781,5056,16836
2023-05-08,23,3334,849,3006,4262,3229,14680
2023-05-09,23,1780,2185,3193,2693,5433,15284
2023-05-10,23,2699,1483,2353,2787,4904,14226
2023-05-11,23,4833,1443,3150,2087,5069,16582
2023-05-12,23,1176,1773,3424,3417,4927,14717
2023-05-13,23,2062,851,2903,3041,2335,11192
2023-05-14,23,1631,1069,1492,3815,2555,10562
2023-05-15,23,4229,2954,3474,4404,2714,17775
2023-05-16,23,4292,1973,1279,2173,3808,13525
2023-05-17,23,4981,2755,1501,1594,5220,16051
2023-05-18,23,3990,2175,1866,3589,3528,15148
2023-05-19,23,3793,1390,2681,1585,5142,14591
2023-05-20,23,1434,1741,3709,4239,3200,14323
2023-05-21,23,4663,2059,2272,2509,5917,17420
2023-05-22,23,1734,1138,3439,4414,4099,14824
2023-05-23,23,1454,2159,1787,4277,4916,14593
2023-05-24,23,2480,1044,2920,2277,5804,14525
2023-05-25,23,2099,1702,2084,4219,4268,14372
2023-05-26,23,3389,1228,2058,1913,2182,10770
2023-05-27,23,2077,953,2580,4369,2773,12752
2023-05-28,23,3173,2343,1348,4191,5810,16865
2023-05-29,23,2523,1550,3304,4360,2026,13763
2023-05-30,23,3513,1958,2622,3003,3184,14280
2023-05-31,23,4944,2904,1941,4475,5086,19350
2023-06-01,23,1356,2999,2091,3517,4223,14186
2023-06-02,23,4627,2718,1785,4030,2932,16092
2023-06-03,23,4625,1945,1206,3906,2800,14482
2023-06-04,23,4613,1872,2710,4299,4235,17729
2023-06-05,23,2713,2241,3782,2988,3697,15421
2023-06-06,23,3923,886,2204,1778,4854,13645
2023-06-07,23,2053,2218,1207,2271,5708,13457
2023-06-08,23,1968,2990,2724,1855,5201,14738
2023-06-09,23,4596,879,3350,1695,3325,13845
2023-06-10,23,4657,1402,3262,3376,3477,16174
2023-06-11,23,3440,854,3718,2107,4281,14400
2023-06-12,23,4528,2884,2541,1790,2273,14016
2023-06-13,23,4823,1133,2370,2672,2971,13969
2023-06-14,23,1874,1179,2188,4226,5905,15372
2023-06-15,23,1577,2364,3736,2699,2051,12427
2023-06-16,23,2348,827,2319,1800,3058,10352
2023-06-17,23,3651,2633,2425,3940,3848,16497
2023-06-18,23,1142,1914,3678,4189,4659,15582
2023-06-19,23,3643,976,2870,3024,3715,14228
2023-06-20,23,1657,1706,3083,3617,3914,13977
2023-06-21,23,1960,2246,2685,3407,2839,13137
2023-06-22,23,1975,820,1984,3693,3857,12329
2023-06-23,23,1754,1929,1806,4356,4933,14778
2023-06-24,23,4317,2254,2889,2045,4338,15843
2023-06-25,23,2085,1410,1259,4312,5054,14120
2023-06-26,23,2311,2244,3826,4253,5717,18351
2023-06-27,23,1856,814,2319,3827,2792,11608
2023-06-28,23,2033,2497,3750,2500,4099,14879
2023-06-29,23,2992,1947,2989,2041,4660,14629
2023-06-30,23,4207,2975,3921,2450,3728,17281
2023-07-01,23,2959,1277,3381,2791,5080,15488
2023-07-02,23,2387,1419,3579,3524,3284,14193
2023-07-03,23,3722,1111,1566,3464,4679,14542
2023-07-04,23,1832,1488,2393,3367,4223,13303
2023-07-05,23,2166,1856,1507,3932,4509,13970
2023-07-06,23,1860,1846,3473,2621,4958,14758
2023-07-07,23,2789,1821,2382,2550,2256,11798
2023-07-08,23,3348,2850,1817,2371,3841,14227
2023-07-09,23,4904,2995,3512,1731,5884,19026
2023-07-10,23,1669,1738,2638,2639,4864,13548
2023-07-11,23,3179,975,3030,1626,4358,13168
2023-07-12,23,2583,1406,3483,1886,4500,13858
2023-07-13,23,2344,1246,2994,3337,5464,15385
2023-07-14,23,4491,1217,2075,2897,2600,13280
2023-07-15,23,4702,1091,3580,2537,2117,14027
2023-07-16,23,4170,849,2201,3483,2938,13641
2023-07-17,23,1544,816,2136,2905,4587,11988
2023-07-18,23,2151,2953,3808,1598,5133,15643
2023-07-19,23,1543,2873,1950,2414,5552,14332
2023-07-20,23,1320,2495,1905,3389,2360,11469
2023-07-21,23,4112,2565,3230,1514,4105,15526
2023-07-22,23,1140,1619,2334,2727,2008,9828
2023-07-23,23,3802,2726,2297,3429,4552,16806
2023-07-24,23,1194,2393,3692,1623,3242,12144
2023-07-25,23,4236,2213,2485,3146,3967,16047
2023-07-26,23,1693,2783,3714,1572,5977,15739
2023-07-27,23,2520,1025,2370,3429,4657,14001
2023-07-28,23,3031,1294,2535,2866,4240,13966
2023-07-29,23,2454,2972,2881,1715,2331,12353
2023-07-30,23,2110,2092,1255,3227,4006,12690
2023-07-31,23,1102,2486,3176,4493,2489,13746
2023-08-01,23,4754,2593,1608,4357,5172,18484
2023-08-02,23,1686,2591,1757,4228,2861,13123
2023-08-03,23,2814,2701,3269,1673,3265,13722
2023-08-04,23,3080,2869,2731,3908,3593,16181
2023-08-05,23,3904,2514,2238,4181,5959,18796
2023-08-06,23,4851,1279,3793,3005,2281,15209
2023-08-07,23,2164,1004,1705,3563,3901,12337
2023-08-08,23,4792,808,3279,2019,2234,13132
2023-08-09,23,4455,2145,1483,3593,3752,15428
2023-08-10,23,3835,1183,2500,4060,5513,17091
2023-08-11,23,3092,1268,1222,4297,2691,12570
2023-08-12,23,4382,2158,1428,3304,2279,13551
2023-08-13,23,4855,1564,3301,1555,4329,15604
2023-08-14,23,4316,1400,2869,1706,3327,13618
2023-08-15,23,4978,1005,3955,2043,2871,14852
2023-08-16,23,3687,1592,1379,1624,3173,11455
2023-08-17,23,4972,2060,2591,4204,4423,18250
2023-08-18,23,3011,2150,3369,3508,4608,16646
2023-08-19,23,2065,1224,3643,3950,5292,16174
2023-08-20,23,3254,1634,3262,3495,3731,15376
2023-08-21,23,3124,1107,2982,1950,3325,12488
2023-08-22,23,2761,2455,2700,3646,2006,13568
2023-08-23,23,4412,1315,1283,2549,3191,12750
2023-08-24,23,1425,1060,1833,4260,2777,11355
2023-08-25,23,3354,1870,2746,3927,2732,14629
2023-08-26,23,3094,890,3649,1884,5355,14872
2023-08-27,23,1946,1766,2148,2517,4078,12455
2023-08-28,23,2822,1910,2146,4325,4277,15480
2023-08-29,23,2485,2029,2535,4163,4135,15347
2023-08-30,23,3234,2858,2268,3951,3179,15490
2023-08-31,23,4118,854,3501,2739,2899,14111
2023-09-01,23,3391,1689,1842,2423,3006,12351
2023-09-02,23,1241,1213,2350,2086,2015,8905
2023-09-03,23,2294,1139,3984,1512,4160,13089
2023-09-04,23,2301,2054,3867,1534,3684,13440
2023-09-05,23,4114,2753,2314,1541,3079,13801
2023-09-06,23,3583,2268,3041,3908,2862,15662
2023-09-07,23,3545,2059,2972,4480,5411,18467
2023-09-08,23,3273,1614,3467,4490,2995,15839
2023-09-09,23,2684,1946,1692,4085,5465,15872
2023-09-10,23,2451,2037,1745,1868,3935,12036
2023-09-11,23,1441,2879,2176,1602,4903,13001
2023-09-12,23,2869,1865,3499,4269,2244,14746
2023-09-13,23,3060,1391,2834,1822,4290,13397
2023-09-14,23,2253,1899,2304,3402,4520,14378
2023-09-15,23,2634,927,3114,3956,5851,16482
2023-09-16,23,2988,1372,2422,2265,5178,14225
2023-09-17,23,4279,1442,3536,2492,2674,14423
2023-09-18,23,2297,2077,3104,2611,3160,13249
2023-09-19,23,2901,1319,3758,3894,5282,17154
2023-09-20,23,1636,1063,1909,3096,4287,11991
2023-09-21,23,4119,2929,3930,3301,4630,18909
2023-09-22,23,1442,1208,3704,3647,4165,14166
2023-09-23,23,1441,2886,1823,4048,3695,13893
2023-09-24,23,3100,1043,3809,3370,2459,13781
2023-09-25,23,3998,1598,1981,3004,3908,14489
2023-09-26,23,1190,2232,1654,3439,3863,12378
2023-09-27,23,1676,2063,3528,3263,4125,14655
2023-09-28,23,3296,2531,1925,4294,4438,16484
2023-09-29,23,1239,1996,3593,3970,3970,14768
2023-09-30,23,4309,1762,1210,3600,5628,16509
2023-10-01,23,2193,2368,1618,2529,3961,12669
2023-10-02,23,2957,2553,3928,2213,3792,15443
2023-10-03,23,2334,2626,3806,2893,2663,14322
2023-10-04,23,3836,2984,3805,1877,3486,15988
2023-10-05,23,4141,1868,2708,2793,3455,14965
2023-10-06,23,3810,2964,2663,2354,4507,16298
2023-10-07,23,3887,863,3708,1778,5774,16010
2023-10-08,23,3607,1718,1632,2192,4085,13234
2023-10-09,23,2558,1742,3254,3328,4797,15679
2023-10-10,23,3233,2192,2562,1762,5268,15017
2023-10-11,23,3529,2800,2242,2655,3326,14552
2023-10-12,23,1534,1748,1521,2375,3327,10505
2023-10-13,23,4682,2668,1607,4093,5277,18327
2023-10-14,23,4696,2528,1353,3859,5381,17817
2023-10-15,23,2102,1344,2209,3725,2493,11873
2023-10-16,23,2880,1365,1992,3253,4561,14051
2023-10-17,23,4113,2604,1999,1677,2025,12418
2023-10-18,23,3445,2828,1315,3354,3129,14071
2023-10-19,23,4591,918,1714,3614,2550,13387
2023-10-20,23,4071,2753,1588,2120,4990,15522
2023-10-21,23,3737,2822,3367,3021,3005,15952
2023-10-22,23,3983,1807,2250,2326,4551,14917
2023-10-23,23,4612,1176,3143,2554,4530,16015
2023-10-24,23,1113,2009,2738,4191,2186,12237
2023-10-25,23,3539,1729,2201,3121,4978,15568
2023-10-26,23,1312,1711,2401,3675,5524,14623
2023-10-27,23,4158,2535,2009,2032,3252,13986
2023-10-28,23,3449,1841,1678,3350,3304,13622
2023-10-29,23,3994,2338,3801,2846,2514,15493
2023-10-30,23,2564,1745,2525,1647,2363,10844
2023-10-31,23,4858,1002,1483,2651,3011,13005
2023-11-01,23,1445,1348,1947,3915,4558,13213
2023-11-02,23,1765,2548,2910,2740,2193,12156
2023-11-03,23,1598,1598,2974,1810,5596,13576
2023-11-04,23,2570,2598,2888,1718,3828,13602
2023-11-05,23,3402,2834,1367,4349,3370,15322
2023-11-06,23,2405,1459,2430,3737,5097,15128
2023-11-07,23,3790,2132,3427,2857,3383,15589
2023-11-08,23,2338,1757,2998,2953,4595,14641
2023-11-09,23,2893,1072,1796,3668,5976,15405
2023-11-10,23,3023,2169,2702,3430,3345,14669
2023-11-11,23,1649,1283,3218,2676,4020,12846
2023-11-12,23,4817,2929,3074,1850,2267,14937
2023-11-13,23,4572,1953,2766,2419,4592,16302
2023-11-14,23,4422,1261,3613,2528,4917,16741
2023-11-15,23,1156,2573,2530,3739,5428,15426
2023-11-16,23,3838,1367,1673,3512,2473,12863
2023-11-17,23,4192,2360,1733,2347,2916,13548
2023-11-18,23,2535,1891,2268,4251,4980,15925
2023-11-19,23,1180,2095,1482,3530,3916,12203
2023-11-20,23,1297,2135,2502,2210,3316,11460
2023-11-21,23,2110,1254,2724,4402,3221,13711
2023-11-22,23,4129,1950,3981,3134,2002,15196
2023-11-23,23,1178,1839,1276,2009,3921,10223
2023-11-24,23,3588,2547,2008,3636,4055,15834
2023-11-25,23,1404,2030,3894,4411,2859,14598
2023-11-26,23,4702,1424,1947,2679,2579,13331
2023-11-27,23,3800,2718,3739,3864,3180,17301
2023-11-28,23,3366,2584,3734,3507,3978,17169
2023-11-29,23,1840,2243,3089,3644,4351,15167
2023-11-30,23,1337,1554,2708,4137,5792,15528
2023-12-01,23,2114,2892,3075,3878,4864,16823
2023-12-02,23,4093,1173,2150,4208,3685,15309
2023-12-03,23,2415,2099,1692,2652,4116,12974
2023-12-04,23,3034,2811,2462,3677,2140,14124
2023-12-05,23,3410,1834,2653,3318,3470,14685
2023-12-06,23,3535,1572,1958,3836,2045,12946
2023-12-07,23,3181,2807,2717,4436,2488,15629
2023-12-08,23,3969,2278,3519,3617,2396,15779
2023-12-09,23,3843,1555,1911,2646,3758,13713
2023-12-10,23,2250,860,1292,2064,3675,10141
2023-12-11,23,2985,2419,1321,2411,4729,13865
2023-12-12,23,2699,1384,1461,2299,2236,10079
2023-12-13,23,3757,1301,2728,2091,4778,14655
2023-12-14,23,3683,1736,1653,1785,3697,12554
2023-12-15,23,1048,1397,2602,1703,4754,11504
2023-12-16,23,3960,2637,1281,3109,2250,13237
2023-12-17,23,2571,1748,2047,2293,4722,13381
2023-12-18,23,3192,1784,2555,3878,3043,14452
2023-12-19,23,2804,2518,1965,4364,2654,14305
2023-12-20,23,3221,1349,3400,2786,3409,14165
2023-12-21,23,3562,1912,1676,2485,5412,15047
2023-12-22,23,3817,2859,2530,3260,5768,18234
2023-12-23,23,2555,1267,3091,2013,3545,12471
2023-12-24,23,1900,2603,2314,2472,4982,14271
2023-12-25,23,4942,1572,3584,1651,5431,17180
2023-12-26,23,3412,1311,1336,3147,3135,12341
2023-12-27,23,3420,1504,2913,4378,4138,16353
2023-12-28,23,4174,2301,2130,1785,2784,13174
2023-12-29,23,4985,1062,2319,3784,2442,14592
2023-12-30,23,2015,2512,3687,2875,5201,16290
2023-12-31,23,3988,1364,3507,1838,5963,16660
2022-01-01,24,2536,1546,1834,3941,6000,15857
2022-01-02,24,4731,1646,1974,2250,2506,13107
2022-01-03,24,4107,814,2204,4283,5019,16427
2022-01-04,24,4638,1587,1471,3549,2742,13987
2022-01-05,24,3613,2730,1628,1948,3141,13060
2022-01-06,24,2198,2871,1347,3236,3001,12653
2022-01-07,24,2278,2891,1650,4210,5056,16085
2022-01-08,24,3917,878,2444,2877,4034,14150
2022-01-09,24,2250,1318,3909,1830,2784,12091
2022-01-10,24,1863,2586,1546,1588,4483,12066
2022-01-11,24,3833,2893,3165,3739,3769,17399
2022-01-12,24,4138,2669,2138,3938,3245,16128
2022-01-13,24,2916,2175,2909,2474,3931,14405
2022-01-14,24,3328,2913,2931,4164,5785,19121
2022-01-15,24,1488,2518,3414,3384,4237,15041
2022-01-16,24,2116,2083,3526,4371,3611,15707
2022-01-17,24,2823,2225,2584,3077,2593,13302
2022-01-18,24,1303,2834,1569,3180,3524,12410
2022-01-19,24,2038,1768,2146,3525,2259,11736
2022-01-20,24,4879,1349,2778,2930,5321,17257
2022-01-21,24,2106,843,3238,4163,2992,13342
2022-01-22,24,3980,2196,3632,2935,3371,16114
2022-01-23,24,1012,2671,2800,4440,5070,15993
2022-01-24,24,4619,1532,3423,3962,3373,16909
2022-01-25,24,4525,1547,2749,1895,3562,14278
2022-01-26,24,3045,2207,3063,3156,5050,16521
2022-01-27,24,2309,2469,2384,3858,3454,14474
2022-01-28,24,1303,2607,2489,1877,2488,10764
2022-01-29,24,2069,2313,2751,3383,4231,14747
2022-01-30,24,4599,2514,2967,1530,4304,15914
2022-01-31,24,4811,1175,1583,3008,3163,13740
2022-02-01,24,2260,1039,1403,4191,3588,12481
2022-02-02,24,2191,2185,1689,3745,2980,12790
2022-02-03,24,4316,2862,3266,2289,2628,15361
2022-02-04,24,3827,2211,3657,2757,5479,17931
2022-02-05,24,3530,2893,1236,4434,2256,14349
2022-02-06,24,1153,2678,2061,3143,5920,14955
2022-02-07,24,3109,1909,2050,3576,2209,12853
2022-02-08,24,1972,2925,1733,4216,4564,15410
2022-02-09,24,2523,2952,2173,3167,5526,16341
2022-02-10,24,3164,2344,3754,2724,4089,16075
2022-02-11,24,1189,1917,2493,1860,5429,12888
2022-02-12,24,4260,2464,2955,2404,5320,17403
2022-02-13,24,4224,2894,1870,2634,3299,14921
2022-02-14,24,2423,2724,3897,2327,2343,13714
2022-02-15,24,3334,2777,2348,3817,5847,18123
2022-02-16,24,1301,2772,1653,3947,3603,13276
2022-02-17,24,1976,1210,1457,4395,2518,11556
2022-02-18,24,2109,963,1351,1504,4862,10789
2022-02-19,24,3007,1774,2395,2249,2311,11736
2022-02-20,24,3400,2762,2562,1663,5180,15567
2022-02-21,24,1035,1909,1301,3616,2880,10741
2022-02-22,24,1979,2044,1592,2423,5877,13915
2022-02-23,24,3307,2069,3671,4355,5548,18950
2022-02-24,24,4171,2054,2854,3834,5260,18173
2022-02-25,24,3873,1600,1209,3376,3262,13320
2022-02-26,24,4360,1413,2947,2925,5869,17514
2022-02-27,24,3597,2120,1438,3748,4616,15519
2022-02-28,24,1829,2267,3657,2526,2324,12603
2022-03-01,24,2858,2139,1724,4319,3707,14747
2022-03-02,24,3405,2199,3174,1743,2336,12857
2022-03-03,24,4284,969,3044,3867,4954,17118
2022-03-04,24,3376,926,3028,3345,3904,14579
2022-03-05,24,4656,2866,1442,3128,5503,17595
2022-03-06,24,3472,1538,2537,3204,2784,13535
2022-03-07,24,4161,1095,1403,4078,3098,13835
2022-03-08,24,1894,841,3899,3165,2538,12337
2022-03-09,24,4377,2206,3532,2829,2240,15184
2022-03-10,24,1910,1850,2210,3891,4561,14422
2022-03-11,24,1916,2895,1732,1710,4616,12869
2022-03-12,24,4259,2921,3490,4100,5688,20458
2022-03-13,24,4450,1562,3849,3479,2305,15645
2022-03-14,24,3948,1840,4000,1579,2406,13773
2022-03-15,24,4403,2941,1313,2172,2654,13483
2022-03-16,24,3431,1724,3972,1578,5698,16403
2022-03-17,24,2475,852,2151,1688,5303,12469
2022-03-18,24,4219,2385,1504,3140,4941,16189
2022-03-19,24,2298,918,2628,1810,3870,11524
2022-03-20,24,4115,1773,2236,2203,3917,14244
2022-03-21,24,1921,1792,2605,3761,2061,12140
2022-03-22,24,1495,1772,1572,3383,5346,13568
2022-03-23,24,4874,2118,3548,2820,4945,18305
2022-03-24,24,3975,2732,2860,2686,3749,16002
2022-03-25,24,4583,2464,2522,3017,2121,14707
2022-03-26,24,1684,1968,2531,2587,2495,11265
2022-03-27,24,3447,1174,1878,1582,4776,12857
2022-03-28,24,3564,1097,2046,1687,3613,12007
2022-03-29,24,4433,1525,3372,3561,2517,15408
2022-03-30,24,4492,1629,1268,2252,5101,14742
2022-03-31,24,1754,2033,1834,3724,4149,13494
2022-04-01,24,2928,2981,3497,3441,2490,15337
2022-04-02,24,2408,1288,1902,1668,3375,10641
2022-04-03,24,4867,1354,1857,2296,5007,15381
2022-04-04,24,3348,1211,2351,2241,4944,14095
2022-04-05,24,3612,1202,2671,4142,4623,16250
2022-04-06,24,2529,2436,3813,3410,5446,17634
2022-04-07,24,1797,2220,2158,2669,5228,14072
2022-04-08,24,3538,1120,2232,1747,3182,11819
2022-04-09,24,4298,1146,3192,3982,3742,16360
2022-04-10,24,3988,2233,2223,3248,4828,16520
2022-04-11,24,3845,1592,3704,4024,2870,16035
2022-04-12,24,3149,2725,2889,2077,5465,16305
2022-04-13,24,2819,1433,2460,3643,3034,13389
2022-04-14,24,1030,1146,3942,3651,3079,12848
2022-04-15,24,4389,1427,3062,3893,3198,15969
2022-04-16,24,1139,1123,3475,3866,2666,12269
2022-04-17,24,3635,2696,3769,2194,4206,16500
2022-04-18,24,1955,835,2470,3639,3091,11990
2022-04-19,24,1216,1054,3166,3201,3700,12337
2022-04-20,24,3515,2339,3815,1907,4916,16492
2022-04-21,24,4811,2165,3207,2619,5449,18251
2022-04-22,24,2222,2462,1906,2938,4304,13832
2022-04-23,24,1774,1296,1705,1809,3877,10461
2022-04-24,24,3212,1707,1923,3076,4659,14577
2022-04-25,24,3089,1628,2754,4154,3046,14671
2022-04-26,24,3949,1052,3340,1872,5837,16050
2022-04-27,24,3121,1028,1545,1847,2077,9618
2022-04-28,24,4583,2543,2999,3228,5895,19248
2022-04-29,24,3416,1317,1588,3773,2054,12148
2022-04-30,24,1025,1223,1877,4152,2652,10929
2022-05-01,24,2066,2616,3648,1856,2987,13173
2022-05-02,24,3208,1178,2269,1701,2202,10558
2022-05-03,24,3345,2734,2984,2107,2587,13757
2022-05-04,24,4066,2893,3589,3276,3785,17609
2022-05-05,24,3833,1618,2033,3856,3657,14997
2022-05-06,24,2302,866,3651,2965,3470,13254
2022-05-07,24,4552,2609,1977,4497,3586,17221
2022-05-08,24,2416,1516,3386,3351,4471,15140
2022-05-09,24,2704,1377,3462,2423,5700,15666
2022-05-10,24,1286,1933,1326,1628,4051,10224
2022-05-11,24,1246,1175,3817,1876,4849,12963
2022-05-12,24,1784,1994,2261,4295,3136,13470
2022-05-13,24,3253,1406,3356,2362,4269,14646
2022-05-14,24,1040,1844,2979,2664,2202,10729
2022-05-15,24,3470,1540,1261,4079,5281,15631
2022-05-16,24,3284,953,2017,2350,2880,11484
2022-05-17,24,1109,1648,2915,4072,4224,13968
2022-05-18,24,4694,2273,2839,3195,4802,17803
2022-05-19,24,1738,857,3506,3900,3157,13158
2022-05-20,24,3799,2948,2992,4014,4693,18446
2022-05-21,24,3082,908,3361,4494,4854,16699
2022-05-22,24,2906,2875,3016,1776,4103,14676
2022-05-23,24,1528,2469,2368,2186,3727,12278
2022-05-24,24,2383,1493,3969,3527,2635,14007
2022-05-25,24,4362,2133,2040,3599,2009,14143
2022-05-26,24,1086,1804,1629,3445,3863,11827
2022-05-27,24,1226,1141,2971,4482,3474,13294
2022-05-28,24,3886,1998,1259,2109,4034,13286
2022-05-29,24,4101,2302,1207,4306,5371,17287
2022-05-30,24,1663,2691,2558,1532,3124,11568
2022-05-31,24,4754,2914,2335,2380,4454,16837
2022-06-01,24,1831,1817,3843,2023,4792,14306
2022-06-02,24,2990,2841,3438,1522,3826,14617
2022-06-03,24,2930,871,1975,3055,2318,11149
2022-06-04,24,1475,2231,2170,2668,2813,11357
2022-06-05,24,1438,1906,2226,3680,5651,14901
2022-06-06,24,2855,2222,2035,2679,5899,15690
2022-06-07,24,2988,2683,2395,1653,2707,12426
2022-06-08,24,2134,2867,1681,2613,5985,15280
2022-06-09,24,1334,1213,2484,3078,2188,10297
2022-06-10,24,4001,2797,3798,2995,4080,17671
2022-06-11,24,1952,1130,3412,4188,3889,14571
2022-06-12,24,4043,2988,2809,3644,2915,16399
2022-06-13,24,3596,995,3645,3398,2733,14367
2022-06-14,24,2112,2388,3360,2883,4247,14990
2022-06-15,24,1777,1063,1929,3714,4434,12917
2022-06-16,24,4677,948,1455,4336,3704,15120
2022-06-17,24,1711,2521,3036,1607,3274,12149
2022-06-18,24,4850,1723,2930,2229,2870,14602
2022-06-19,24,3414,1661,3172,3081,3343,14671
2022-06-20,24,4200,2159,1352,4220,2789,14720
2022-06-21,24,1945,2639,2595,3306,2976,13461
2022-06-22,24,2523,2467,2332,1744,2212,11278
2022-06-23,24,2818,2249,1305,4042,4948,15362
2022-06-24,24,3821,1744,2834,3271,4379,16049
2022-06-25,24,3491,2759,1969,3302,4933,16454
2022-06-26,24,4564,2560,1626,4114,3129,15993
2022-06-27,24,3519,1738,3095,3874,5357,17583
2022-06-28,24,2328,2984,2331,3347,5253,16243
2022-06-29,24,3243,1057,2569,3961,4111,14941
2022-06-30,24,2229,2012,3235,4012,5361,16849
2022-07-01,24,3886,1100,1514,2159,4571,13230
2022-07-02,24,1161,2047,1535,1701,5048,11492
2022-07-03,24,4888,2447,3304,3052,3820,17511
2022-07-04,24,4645,1373,3142,2924,5697,17781
2022-07-05,24,2061,1008,2618,1551,4013,11251
2022-07-06,24,4400,933,2308,2298,5018,14957
2022-07-07,24,4696,1890,2222,4278,5374,18460
2022-07-08,24,4284,1792,2498,3261,2534,14369
2022-07-09,24,4216,878,1261,3588,2113,12056
2022-07-10,24,3739,2047,3418,3520,2151,14875
2022-07-11,24,1648,1336,3365,3295,4890,14534
2022-07-12,24,4020,2156,3923,2035,3256,15390
2022-07-13,24,2205,1564,3837,3074,5203,15883
2022-07-14,24,3012,2218,2343,2365,4426,14364
2022-07-15,24,3464,2105,3890,4119,2691,16269
2022-07-16,24,4095,1832,3518,1670,5904,17019
2022-07-17,24,4780,2426,2101,3018,2582,14907
2022-07-18,24,1654,1883,2509,4086,5824,15956
2022-07-19,24,3885,1835,3682,4367,2403,16172
2022-07-20,24,3409,2001,3906,2266,4497,16079
2022-07-21,24,1744,2591,1698,4282,5638,15953
2022-07-22,24,1935,1016,2614,2690,5354,13609
2022-07-23,24,1130,2427,1912,4298,5048,14815
2022-07-24,24,1682,2745,3380,3824,5167,16798
2022-07-25,24,2277,1030,3404,3000,2345,12056
2022-07-26,24,3295,1508,3625,3343,3327,15098
2022-07-27,24,2817,1487,2703,3697,3747,14451
2022-07-28,24,2864,2230,1707,2407,5338,14546
2022-07-29,24,4083,991,3545,2252,3823,14694
2022-07-30,24,1414,2974,2838,4451,3952,15629
2022-07-31,24,1897,2812,2292,1732,5030,13763
2022-08-01,24,4055,2735,1538,1635,2920,12883
2022-08-02,24,2436,1039,3846,2849,5673,15843
2022-08-03,24,1856,1847,3646,4115,2032,13496
2022-08-04,24,2317,2340,3659,4133,3307,15756
2022-08-05,24,3761,1742,2261,2780,4203,14747
2022-08-06,24,1030,1472,2564,2998,2969,11033
2022-08-07,24,2286,1280,3659,4103,4155,15483
2022-08-08,24,1588,2496,1576,2651,3100,11411
2022-08-09,24,3548,2586,2107,1592,4411,14244
2022-08-10,24,2094,2020,2946,2253,2086,11399
2022-08-11,24,4044,1498,1494,4339,2930,14305
2022-08-12,24,1795,1611,1299,2187,4206,11098
2022-08-13,24,2205,1052,3484,3401,2839,12981
2022-08-14,24,4004,1007,2764,4482,3643,15900
2022-08-15,24,4834,2589,3434,2961,5767,19585
2022-08-16,24,2635,2811,3147,2128,4578,15299
2022-08-17,24,4498,1583,3933,2403,5852,18269
2022-08-18,24,2749,2408,2927,3991,5734,17809
2022-08-19,24,1136,869,3631,1824,2740,10200
2022-08-20,24,2835,1879,1938,3947,5738,16337
2022-08-21,24,3313,2324,2921,1996,2342,12896
2022-08-22,24,2931,1546,1756,2592,3835,12660
2022-08-23,24,4037,1808,3422,2395,3901,15563
2022-08-24,24,2686,2027,3940,4426,5550,18629
2022-08-25,24,1113,2407,1751,2726,4860,12857
2022-08-26,24,3919,1587,3252,2627,5160,16545
2022-08-27,24,2916,1824,1494,2083,4651,12968
2022-08-28,24,4783,2007,2564,4426,5692,19472
2022-08-29,24,3702,2152,3231,2322,3007,14414
2022-08-30,24,4622,1603,2731,1869,5059,15884
2022-08-31,24,3784,1467,1333,2166,5997,14747
2022-09-01,24,4901,927,2628,3329,3163,14948
2022-09-02,24,1954,2823,3799,2214,2770,13560
2022-09-03,24,1930,2152,3645,3679,4741,16147
2022-09-04,24,4244,1757,2032,4148,3116,15297
2022-09-05,24,2983,963,3873,4143,5328,17290
2022-09-06,24,4469,2635,3378,2382,5333,18197
2022-09-07,24,3178,1870,3823,4052,4644,17567
2022-09-08,24,1148,1051,1780,3017,4199,11195
2022-09-09,24,4941,2687,1922,3306,4733,17589
2022-09-10,24,4436,2558,3681,1502,5962,18139
2022-09-11,24,1736,1694,1514,1702,3996,10642
2022-09-12,24,3213,1999,3742,3705,3143,15802
2022-09-13,24,3570,1148,1548,3626,3374,13266
2022-09-14,24,3394,2452,2483,4011,2168,14508
2022-09-15,24,1172,2873,3537,2129,4117,13828
2022-09-16,24,1236,2667,1382,2925,4039,12249
2022-09-17,24,1273,2392,3278,1788,5012,13743
2022-09-18,24,3378,1333,2329,3168,4198,14406
2022-09-19,24,1579,1175,1623,3393,2135,9905
2022-09-20,24,4125,1961,3703,4225,4804,18818
2022-09-21,24,2834,1045,3938,4335,5906,18058
2022-09-22,24,1610,1114,1744,3120,3570,11158
2022-09-23,24,1084,1690,1312,3246,4454,11786
2022-09-24,24,4185,1154,2049,3560,5108,16056
2022-09-25,24,3033,874,1683,4233,5548,15371
2022-09-26,24,2615,1707,3807,2793,4855,15777
2022-09-27,24,3224,1930,2960,4086,4590,16790
2022-09-28,24,3647,1056,2310,4051,2726,13790
2022-09-29,24,3934,1696,2292,2942,2280,13144
2022-09-30,24,2579,2902,3305,2664,3282,14732
2022-10-01,24,2048,1445,1209,3229,2180,10111
2022-10-02,24,2580,1502,1204,2285,5310,12881
2022-10-03,24,4788,1195,2538,3618,5273,17412
2022-10-04,24,1905,2418,3911,3149,4787,16170
2022-10-05,24,1296,2730,1260,1599,4347,11232
2022-10-06,24,3296,895,1394,3031,5851,14467
2022-10-07,24,2892,1487,3289,3191,2441,13300
2022-10-08,24,3228,932,2278,3283,2272,11993
2022-10-09,24,1732,1291,3094,3146,4534,13797
2022-10-10,24,2958,2810,2026,3030,2637,13461
2022-10-11,24,3256,1677,3996,1651,2114,12694
2022-10-12,24,2452,2026,2709,1872,5850,14909
2022-10-13,24,2228,1003,3391,4468,4904,15994
2022-10-14,24,2258,2338,2435,3126,5920,16077
2022-10-15,24,3132,1658,3997,2699,4912,16398
2022-10-16,24,1658,2046,1871,3975,2393,11943
2022-10-17,24,3183,1025,2822,1714,4364,13108
2022-10-18,24,1037,1210,3835,2975,5755,14812
2022-10-19,24,4020,900,2417,2130,4133,13600
2022-10-20,24,4718,958,1528,4135,2308,13647
2022-10-21,24,2695,1255,2135,4245,4831,15161
2022-10-22,24,1041,1221,1977,3685,5341,13265
2022-10-23,24,4938,2183,3566,3310,3826,17823
2022-10-24,24,1738,2033,2672,3245,4207,13895
2022-10-25,24,4360,2027,2742,4211,3435,16775
2022-10-26,24,2486,1262,2573,2615,5557,14493
2022-10-27,24,4634,2274,1715,4465,5154,18242
2022-10-28,24,1525,866,2593,2261,2505,9750
2022-10-29,24,3370,1318,1392,3813,5989,15882
2022-10-30,24,3176,1521,3358,2490,2611,13156
2022-10-31,24,4267,2663,2617,3815,5336,18698
2022-11-01,24,2826,1332,1725,1832,2351,10066
2022-11-02,24,1293,2099,2739,4403,5311,15845
2022-11-03,24,3038,857,3039,4368,4494,15796
2022-11-04,24,4675,2998,1704,3009,2126,14512
2022-11-05,24,4047,1713,1765,4497,5807,17829
2022-11-06,24,1281,2968,2081,3682,2847,12859
2022-11-07,24,4852,2526,3666,1696,4411,17151
2022-11-08,24,4830,876,1742,2217,4908,14573
2022-11-09,24,1357,1249,3765,2826,4149,13346
2022-11-10,24,4932,1705,2957,3593,2185,15372
2022-11-11,24,1370,1723,3581,4380,5290,16344
2022-11-12,24,3238,904,3582,2687,2201,12612
2022-11-13,24,2762,2634,3762,3272,3600,16030
2022-11-14,24,4794,2284,2712,2201,5944,17935
2022-11-15,24,3145,2738,3839,3528,4790,18040
2022-11-16,24,2703,851,1490,2000,2507,9551
2022-11-17,24,3628,1656,1671,4457,3310,14722
2022-11-18,24,3782,2284,2568,3249,4127,16010
2022-11-19,24,3916,1635,3853,2950,2012,14366
2022-11-20,24,2095,1123,3156,3107,5403,14884
2022-11-21,24,2649,1081,3394,1757,2523,11404
2022-11-22,24,3579,1422,2513,2161,3151,12826
2022-11-23,24,2077,1015,1822,2924,4239,12077
2022-11-24,24,2557,1747,2414,3992,5320,16030
2022-11-25,24,2155,2672,3350,3776,3737,15690
2022-11-26,24,3712,2422,3840,2910,2168,15052
2022-11-27,24,1192,2811,2995,1884,5288,14170
2022-11-28,24,1111,1294,3966,2537,5936,14844
2022-11-29,24,3090,2012,2991,2836,2872,13801
2022-11-30,24,2192,2993,2872,1552,4288,13897
2022-12-01,24,1944,1336,3277,3805,4319,14681
2022-12-02,24,1637,2260,3511,2291,4056,13755
2022-12-03,24,3823,1066,3536,2612,3757,14794
2022-12-04,24,3366,1451,1610,3194,2975,12596
2022-12-05,24,3121,1050,3527,2500,5332,15530
2022-12-06,24,4520,2276,2584,3099,2456,14935
2022-12-07,24,1879,2297,2962,4294,5954,17386
2022-12-08,24,3730,2063,1450,3321,5400,15964
2022-12-09,24,2635,1428,1770,4354,4892,15079
2022-12-10,24,1019,2377,1651,4321,2308,11676
2022-12-11,24,4124,1481,1788,2974,5389,15756
2022-12-12,24,1979,1259,2052,2984,4067,12341
2022-12-13,24,4856,892,1715,2292,3561,13316
2022-12-14,24,1630,2045,2828,3264,4494,14261
2022-12-15,24,2249,2079,3614,3469,4870,16281
2022-12-16,24,1768,2379,3056,4175,4496,15874
2022-12-17,24,3618,2058,1385,1609,2990,11660
2022-12-18,24,3628,2083,1282,4403,3807,15203
2022-12-19,24,2912,1555,3109,1524,2054,11154
2022-12-20,24,2448,2750,3280,1847,2739,13064
2022-12-21,24,1915,1471,2942,3219,2431,11978
2022-12-22,24,2979,1600,1332,4120,4249,14280
2022-12-23,24,1023,2753,2701,2805,3006,12288
2022-12-24,24,1467,2841,3962,1760,5957,15987
2022-12-25,24,1089,2779,3846,3189,5585,16488
2022-12-26,24,4630,2782,3881,3372,3862,18527
2022-12-27,24,4868,1923,3383,1946,2888,15008
2022-12-28,24,4993,815,1805,2606,5749,15968
2022-12-29,24,2571,858,1500,3131,2745,10805
2022-12-30,24,3280,2975,2329,2298,4516,15398
2022-12-31,24,3767,2291,1785,1621,2616,12080
2023-01-01,24,1363,1735,1925,1840,5325,12188
2023-01-02,24,1572,1561,3163,1730,5145,13171
2023-01-03,24,2420,2352,2734,1763,4540,13809
2023-01-04,24,4143,1141,1736,3838,5486,16344
2023-01-05,24,1305,2783,1629,3692,5582,14991
2023-01-06,24,4924,2562,3039,4416,3996,18937
2023-01-07,24,2368,1223,1400,3418,3789,12198
2023-01-08,24,3781,2363,3371,2956,3678,16149
2023-01-09,24,1821,2942,2060,4099,5270,16192
2023-01-10,24,1163,2005,2247,1803,3444,10662
2023-01-11,24,1313,2962,2367,1511,3203,11356
2023-01-12,24,1354,2928,2832,3068,3695,13877
2023-01-13,24,1443,956,2325,1737,3300,9761
2023-01-14,24,3706,2684,2960,2762,3475,15587
2023-01-15,24,1806,945,1234,3132,5139,12256
2023-01-16,24,2886,1479,3203,4163,2108,13839
2023-01-17,24,4683,1845,2641,3570,2396,15135
2023-01-18,24,3131,2718,2479,4438,3558,16324
2023-01-19,24,3017,1531,2796,3436,3507,14287
2023-01-20,24,3150,872,2558,1693,3809,12082
2023-01-21,24,3405,1444,2124,2123,5216,14312
2023-01-22,24,4870,2053,1806,1601,3453,13783
2023-01-23,24,3019,1306,1905,3135,5794,15159
2023-01-24,24,4505,2854,3291,3003,3575,17228
2023-01-25,24,4034,2423,3669,2704,2914,15744
2023-01-26,24,3355,2960,2604,2533,2268,13720
2023-01-27,24,4555,1027,3000,3916,3044,15542
2023-01-28,24,3602,2564,3697,3645,3584,17092
2023-01-29,24,4264,1456,3237,2128,5097,16182
2023-01-30,24,2632,2398,2098,3761,4957,15846
2023-01-31,24,3968,1923,2905,3758,2680,15234
2023-02-01,24,4565,2367,2449,2073,4778,16232
2023-02-02,24,1084,1512,1535,2143,4476,10750
2023-02-03,24,4089,2743,2766,3785,5568,18951
2023-02-04,24,1597,2585,2431,4054,5225,15892
2023-02-05,24,2450,1642,3834,3164,2695,13785
2023-02-06,24,2027,2781,1377,3206,3266,12657
2023-02-07,24,4483,2712,3201,4091,2858,17345
2023-02-08,24,2021,1019,3094,3890,2154,12178
2023-02-09,24,1733,2131,3625,2099,4909,14497
2023-02-10,24,2181,1030,3040,3064,5034,14349
2023-02-11,24,3139,1409,3355,1696,3499,13098
2023-02-12,24,1960,903,3842,3300,4644,14649
2023-02-13,24,2677,1438,3187,4276,4430,16008
2023-02-14,24,3281,1825,1301,2880,4308,13595
2023-02-15,24,3943,1313,2400,4478,3657,15791
2023-02-16,24,2333,2212,3120,3704,5540,16909
2023-02-17,24,2309,1588,2753,1619,2207,10476
2023-02-18,24,2416,1212,2596,1811,4578,12613
2023-02-19,24,3490,2651,1623,2333,3398,13495
2023-02-20,24,3414,2301,2329,2521,5062,15627
2023-02-21,24,2970,2074,1504,3459,2316,12323
2023-02-22,24,1149,1343,1454,2925,5449,12320
2023-02-23,24,3054,968,3086,2540,4613,14261
2023-02-24,24,2641,1172,1419,1674,3011,9917
2023-02-25,24,2981,989,2283,3300,4408,13961
2023-02-26,24,4060,2988,3569,2863,5919,19399
2023-02-27,24,1555,885,1777,4370,3080,11667
2023-02-28,24,4720,1125,3911,3607,5298,18661
2023-03-01,24,3919,1335,3104,1672,3926,13956
2023-03-02,24,1957,1802,3991,1575,3037,12362
2023-03-03,24,3192,1467,1479,3674,2693,12505
2023-03-04,24,4359,2856,1347,2404,2836,13802
2023-03-05,24,4841,2686,3754,2791,3742,17814
2023-03-06,24,3465,2260,2395,2552,5601,16273
2023-03-07,24,4799,2112,2372,3940,3674,16897
2023-03-08,24,1713,1267,3951,2878,5376,15185
2023-03-09,24,3055,2023,2844,3195,2806,13923
2023-03-10,24,4719,1921,1645,2650,5981,16916
2023-03-11,24,1716,1164,3163,3356,2107,11506
2023-03-12,24,4000,2816,3360,4413,4830,19419
2023-03-13,24,4314,2352,2014,1972,3051,13703
2023-03-14,24,2521,1140,2777,3248,2868,12554
2023-03-15,24,2154,2774,1630,3438,5531,15527
2023-03-16,24,2877,1811,2698,3221,4844,15451
2023-03-17,24,4251,2409,2727,2302,5061,16750
2023-03-18,24,2373,2867,3561,3258,2606,14665
2023-03-19,24,3640,1742,1584,3025,3857,13848
2023-03-20,24,4376,2938,3321,2952,3213,16800
2023-03-21,24,3127,2905,2362,1707,2429,12530
2023-03-22,24,1230,2342,1561,3070,2825,11028
2023-03-23,24,1013,1544,2451,2781,3370,11159
2023-03-24,24,1876,1638,3925,4195,4943,16577
2023-03-25,24,1311,2380,2295,2480,2763,11229
2023-03-26,24,4941,1646,1961,2197,3892,14637
2023-03-27,24,1107,1326,1789,3151,4614,11987
2023-03-28,24,4789,2767,1504,3043,3229,15332
2023-03-29,24,3928,2938,3836,4155,2787,17644
2023-03-30,24,2716,2969,3062,2018,5123,15888
2023-03-31,24,1240,2806,2490,3659,5393,15588
2023-04-01,24,1190,2880,3619,4317,3160,15166
2023-04-02,24,3790,881,2075,1955,4996,13697
2023-04-03,24,3453,2235,1465,3224,2884,13261
2023-04-04,24,2196,2015,2813,1648,4755,13427
2023-04-05,24,4966,2140,2348,3668,2953,16075
2023-04-06,24,4012,1077,1826,2002,3908,12825
2023-04-07,24,2617,1970,3804,1768,2642,12801
2023-04-08,24,2182,1428,2149,1771,5087,12617
2023-04-09,24,2854,2535,1362,3467,5107,15325
2023-04-10,24,4859,2878,2222,2232,4445,16636
2023-04-11,24,4220,1946,1611,3519,3460,14756
2023-04-12,24,1055,1253,1474,2103,4947,10832
2023-04-13,24,2146,1954,1482,3525,5483,14590
2023-04-14,24,3504,1749,2270,3078,2897,13498
2023-04-15,24,3601,2919,3233,2670,3007,15430
2023-04-16,24,4795,1450,3685,4431,5428,19789
2023-04-17,24,2703,1514,1576,1854,5033,12680
2023-04-18,24,2246,1957,1349,1883,2436,9871
2023-04-19,24,4049,2063,1325,2466,4237,14140
2023-04-20,24,4480,875,2243,1599,4276,13473
2023-04-21,24,1985,911,2697,1879,5692,13164
2023-04-22,24,1630,1476,1690,1789,2638,9223
2023-04-23,24,3149,2574,2636,1911,5647,15917
2023-04-24,24,4821,1972,2533,2743,2849,14918
2023-04-25,24,3028,2496,2038,4014,3746,15322
2023-04-26,24,2685,1733,1833,2322,3405,11978
2023-04-27,24,1567,941,2335,3044,4175,12062
2023-04-28,24,2705,1935,1465,1779,3174,11058
2023-04-29,24,2341,1480,2357,3270,4829,14277
2023-04-30,24,2481,1788,2056,3061,5705,15091
2023-05-01,24,4811,2290,1340,3896,4297,16634
2023-05-02,24,4008,2249,1461,3129,5615,16462
2023-05-03,24,2192,1199,2965,1681,2458,10495
2023-05-04,24,3203,1615,2674,1634,4009,13135
2023-05-05,24,1763,2378,2248,3022,5826,15237
2023-05-06,24,2924,2587,1826,3937,3080,14354
2023-05-07,24,2015,823,2035,3416,5520,13809
2023-05-08,24,3904,1444,1913,3476,3634,14371
2023-05-09,24,3276,984,3263,3275,2230,13028
2023-05-10,24,3983,2712,2700,3406,4538,17339
2023-05-11,24,4039,2668,2825,3985,3519,17036
2023-05-12,24,2191,1308,3743,3370,2913,13525
2023-05-13,24,4032,1972,2567,4017,3718,16306
2023-05-14,24,4657,1603,3569,3453,4115,17397
2023-05-15,24,2581,1885,3564,2613,3899,14542
2023-05-16,24,1828,1198,2933,4281,4365,14605
2023-05-17,24,2045,2920,2234,3046,4477,14722
2023-05-18,24,3322,2178,2383,2710,2059,12652
2023-05-19,24,1688,1901,1616,2458,5696,13359
2023-05-20,24,4296,2284,3989,4180,3999,18748
2023-05-21,24,3060,2184,3161,3583,4309,16297
2023-05-22,24,4901,2403,3199,4078,4164,18745
2023-05-23,24,3783,2187,2156,2986,2162,13274
2023-05-24,24,2297,2258,2795,2851,4803,15004
2023-05-25,24,4885,2600,3721,2763,5129,19098
2023-05-26,24,3582,2436,1208,4084,3408,14718
2023-05-27,24,2524,1905,2869,3859,4335,15492
2023-05-28,24,2387,2206,2781,2323,5415,15112
2023-05-29,24,2968,1259,3255,3095,3413,13990
2023-05-30,24,4082,2124,2993,1862,5516,16577
2023-05-31,24,1940,2405,3907,4203,3990,16445
2023-06-01,24,2814,2093,3481,4245,5812,18445
2023-06-02,24,1612,1096,2377,3439,2836,11360
2023-06-03,24,4965,1747,3184,1759,5358,17013
2023-06-04,24,4053,1702,3922,3706,2536,15919
2023-06-05,24,1337,1188,3033,3487,2081,11126
2023-06-06,24,2273,2859,1691,2413,3944,13180
2023-06-07,24,4486,907,3757,3336,5238,17724
2023-06-08,24,4870,1454,2466,4131,3965,16886
2023-06-09,24,2303,2370,3748,3118,2380,13919
2023-06-10,24,3418,894,3666,1816,3724,13518
2023-06-11,24,3303,899,2796,3539,2833,13370
2023-06-12,24,2657,2779,1573,3249,5001,15259
2023-06-13,24,4564,2284,3877,3076,3827,17628
2023-06-14,24,3971,803,3815,4445,4023,17057
2023-06-15,24,4955,2328,1342,2332,3288,14245
2023-06-16,24,4411,1639,3799,2542,5547,17938
2023-06-17,24,3064,2904,3023,1567,4651,15209
2023-06-18,24,3612,2216,2425,3836,5222,17311
2023-06-19,24,2319,1529,3920,3833,2948,14549
2023-06-20,24,4429,1907,1918,2769,4417,15440
2023-06-21,24,2559,1471,2245,2889,5257,14421
2023-06-22,24,1719,2358,1693,3653,2023,11446
2023-06-23,24,1150,1816,1662,3027,4164,11819
2023-06-24,24,3579,2419,2417,3216,3314,14945
2023-06-25,24,1134,1319,3011,2684,4581,12729
2023-06-26,24,3224,884,1906,4234,2276,12524
2023-06-27,24,4589,2303,3867,3491,3156,17406
2023-06-28,24,1760,979,2259,2016,2153,9167
2023-06-29,24,4271,2366,2438,2552,2954,14581
2023-06-30,24,1022,1930,2241,4084,4003,13280
2023-07-01,24,2505,2448,3483,4219,4300,16955
2023-07-02,24,1828,1142,1876,3487,5151,13484
2023-07-03,24,3616,1526,2750,3338,3428,14658
2023-07-04,24,1900,1499,1923,1829,3546,10697
2023-07-05,24,2369,1930,3742,1541,4514,14096
2023-07-06,24,1911,2509,3430,4275,5166,17291
2023-07-07,24,3353,2177,3564,2979,2510,14583
2023-07-08,24,1379,1718,2976,1712,4603,12388
2023-07-09,24,2797,2336,3082,4100,5246,17561
2023-07-10,24,4577,1857,1692,3904,3983,16013
2023-07-11,24,3265,1124,2890,2823,2455,12557
2023-07-12,24,3239,1205,1261,1994,5742,13441
2023-07-13,24,4654,1377,1777,4441,5669,17918
2023-07-14,24,1192,1183,1945,3027,2433,9780
2023-07-15,24,2358,2295,3133,2424,3205,13415
2023-07-16,24,2877,1672,1290,2431,3457,11727
2023-07-17,24,3300,1733,3745,3036,4333,16147
2023-07-18,24,2132,2714,3061,2855,3380,14142
2023-07-19,24,4842,1761,3968,1717,4479,16767
2023-07-20,24,1140,858,2208,4107,3059,11372
2023-07-21,24,3134,2397,3042,4150,4085,16808
2023-07-22,24,1153,1659,2617,2583,5360,13372
2023-07-23,24,3435,2557,2141,3726,4952,16811
2023-07-24,24,3132,2986,3719,3359,2262,15458
2023-07-25,24,4629,2712,2004,3967,4471,17783
2023-07-26,24,3893,1192,2691,1584,4702,14062
2023-07-27,24,3457,2706,1706,2127,2507,12503
2023-07-28,24,1874,1204,2405,4416,2268,12167
2023-07-29,24,3790,1225,2321,2799,5307,15442
2023-07-30,24,3217,1956,2761,1728,4342,14004
2023-07-31,24,4547,1449,1367,3165,3830,14358
2023-08-01,24,2081,1967,3465,4430,2678,14621
2023-08-02,24,2894,1067,3375,1634,3049,12019
2023-08-03,24,3647,1422,1838,1539,2582,11028
2023-08-04,24,4217,1050,3362,1772,4434,14835
2023-08-05,24,2065,2506,2522,2601,2922,12616
2023-08-06,24,1008,2340,2351,4112,5328,15139
2023-08-07,24,3710,1771,3038,4472,5164,18155
2023-08-08,24,4007,1978,3284,3112,2848,15229
2023-08-09,24,2455,2027,3005,1507,5369,14363
2023-08-10,24,2194,1940,2994,3344,3348,13820
2023-08-11,24,1912,1565,2791,1705,5388,13361
2023-08-12,24,4687,2508,2921,1887,3792,15795
2023-08-13,24,3316,2683,1772,1800,5569,15140
2023-08-14,24,4587,2670,3602,2547,2925,16331
2023-08-15,24,4109,1268,3848,3972,4580,17777
2023-08-16,24,2283,2612,2047,3832,4806,15580
2023-08-17,24,4525,1161,2455,3080,5128,16349
2023-08-18,24,4444,2888,1208,1504,3222,13266
2023-08-19,24,4599,834,1595,3001,5343,15372
2023-08-20,24,2301,1584,1497,2634,5806,13822
2023-08-21,24,2686,2112,1725,2396,2230,11149
2023-08-22,24,4604,1088,2203,3495,5390,16780
2023-08-23,24,4231,1811,3697,2559,4044,16342
2023-08-24,24,4873,954,3864,2160,3059,14910
2023-08-25,24,4332,1004,1343,1563,3766,12008
2023-08-26,24,3553,1100,2337,4381,3885,15256
2023-08-27,24,2615,2497,1996,4133,4647,15888
2023-08-28,24,3232,1881,1554,2483,4534,13684
2023-08-29,24,1466,2708,1254,3093,2933,11454
2023-08-30,24,2966,2813,3590,3367,3477,16213
2023-08-31,24,1154,2193,3192,4318,3594,14451
2023-09-01,24,3366,2405,3412,4086,3127,16396
2023-09-02,24,3103,1823,3761,2202,5035,15924
2023-09-03,24,2518,2348,2902,2375,4621,14764
2023-09-04,24,3687,2866,1924,3062,5279,16818
2023-09-05,24,2944,1578,2759,2041,3750,13072
2023-09-06,24,3872,2629,3818,3192,2324,15835
2023-09-07,24,1190,2730,3386,1780,5165,14251
2023-09-08,24,1951,2316,3635,1775,3333,13010
2023-09-09,24,2989,1812,2734,1515,2307,11357
2023-09-10,24,4689,961,1517,3827,3366,14360
2023-09-11,24,2450,900,3482,3937,3475,14244
2023-09-12,24,4255,839,3404,2267,3271,14036
2023-09-13,24,3303,2833,2781,4167,4474,17558
2023-09-14,24,3471,1186,2086,1752,5684,14179
2023-09-15,24,1089,2828,1617,2561,5186,13281
2023-09-16,24,1615,2712,2524,3340,3434,13625
2023-09-17,24,3133,2969,1453,2650,4393,14598
2023-09-18,24,3886,1577,3179,2400,3768,14810
2023-09-19,24,4531,1469,2341,4243,2678,15262
2023-09-20,24,1095,1954,3242,2563,3522,12376
2023-09-21,24,2475,2428,3251,3006,3923,15083
2023-09-22,24,4483,1770,2576,1895,5426,16150
2023-09-23,24,1051,2991,2482,1587,3436,11547
2023-09-24,24,1889,1290,3978,3351,5400,15908
2023-09-25,24,4475,1240,1336,3315,4218,14584
2023-09-26,24,4219,1564,3315,4014,2133,15245
2023-09-27,24,4817,807,3802,4276,2377,16079
2023-09-28,24,1736,2708,2465,3944,4875,15728
2023-09-29,24,2392,2502,2666,1697,5940,15197
2023-09-30,24,1246,1159,3176,3426,2711,11718
2023-10-01,24,4079,1778,1555,2110,4603,14125
2023-10-02,24,2995,1613,3953,4493,5321,18375
2023-10-03,24,3797,1496,1756,2360,4100,13509
2023-10-04,24,1662,1554,1804,3741,3460,12221
2023-10-05,24,2653,1306,2624,2768,4536,13887
2023-10-06,24,2530,2563,1628,3140,4390,14251
2023-10-07,24,4967,2032,3485,4365,2745,17594
2023-10-08,24,2737,2725,3670,4487,5897,19516
2023-10-09,24,4123,1147,2490,3652,5503,16915
2023-10-10,24,4454,1364,1630,3322,3661,14431
2023-10-11,24,4260,1887,3961,4148,3525,17781
2023-10-12,24,3458,2627,1981,2663,2541,13270
2023-10-13,24,2520,2659,3222,2094,4458,14953
2023-10-14,24,1711,2521,3899,2521,3263,13915
2023-10-15,24,2338,2056,3710,2285,3719,14108
2023-10-16,24,1009,1543,1975,2172,5479,12178
2023-10-17,24,1866,1200,2610,2501,3648,11825
2023-10-18,24,4195,2502,3075,2388,5765,17925
2023-10-19,24,3248,3000,2129,1846,5395,15618
2023-10-20,24,3405,1016,2782,3699,4162,15064
2023-10-21,24,3294,2030,3610,3481,2321,14736
2023-10-22,24,1780,2689,2084,3091,3054,12698
2023-10-23,24,2358,2975,2219,3540,5127,16219
2023-10-24,24,1328,2114,3235,1628,3110,11415
2023-10-25,24,3533,2106,3717,4293,4852,18501
2023-10-26,24,4471,1766,3761,4184,5134,19316
2023-10-27,24,4968,1880,2710,3356,3440,16354
2023-10-28,24,3307,2834,2016,3778,3963,15898
2023-10-29,24,4266,826,2287,2305,4607,14291
2023-10-30,24,3388,2017,3397,2716,2423,13941
2023-10-31,24,4935,2243,2983,2743,3729,16633
2023-11-01,24,1020,2371,2467,3202,2373,11433
2023-11-02,24,2521,1671,2025,2585,2215,11017
2023-11-03,24,1922,2494,1847,3084,5349,14696
2023-11-04,24,2414,2604,2224,4308,5276,16826
2023-11-05,24,3038,1588,2967,1596,3768,12957
2023-11-06,24,4555,2441,1651,3514,3405,15566
2023-11-07,24,1443,2730,1209,3366,3175,11923
2023-11-08,24,3727,1814,2624,2055,5496,15716
2023-11-09,24,3896,1486,1632,3855,5732,16601
2023-11-10,24,2819,2483,2223,4140,4940,16605
2023-11-11,24,1207,1849,1537,3854,3207,11654
2023-11-12,24,2448,2477,3407,1967,3311,13610
2023-11-13,24,3186,2381,1443,4448,3381,14839
2023-11-14,24,3803,1389,3134,3674,3931,15931
2023-11-15,24,4965,2869,3860,3510,4122,19326
2023-11-16,24,1466,1647,1540,1577,5324,11554
2023-11-17,24,1221,1912,1400,3138,5635,13306
2023-11-18,24,1847,2760,3104,3668,4275,15654
2023-11-19,24,4141,2762,3041,4469,4563,18976
2023-11-20,24,1705,1210,1729,3996,3020,11660
2023-11-21,24,3909,2823,3459,4476,5806,20473
2023-11-22,24,4209,2950,2216,2429,5729,17533
2023-11-23,24,4383,2156,2904,3157,2372,14972
2023-11-24,24,3227,1250,1725,2198,2036,10436
2023-11-25,24,1782,1000,1570,1876,4063,10291
2023-11-26,24,2523,2587,3408,2051,4834,15403
2023-11-27,24,1456,2681,2653,2487,3482,12759
2023-11-28,24,1784,2821,2324,1554,4727,13210
2023-11-29,24,3693,2245,3146,2447,5229,16760
2023-11-30,24,2672,1632,3461,4373,5080,17218
2023-12-01,24,4324,1128,3712,3258,3767,16189
2023-12-02,24,3778,1627,3819,1651,2836,13711
2023-12-03,24,1527,1507,2016,3031,5365,13446
2023-12-04,24,4366,2746,3669,3561,2573,16915
2023-12-05,24,4125,2345,3266,4097,3861,17694
2023-12-06,24,2223,2345,1972,2465,2932,11937
2023-12-07,24,3789,1230,2879,3616,3449,14963
2023-12-08,24,1152,2526,3644,2200,4578,14100
2023-12-09,24,3739,1080,2363,2986,4168,14336
2023-12-10,24,4294,1381,3255,2184,2020,13134
2023-12-11,24,3187,1859,3802,1575,3030,13453
2023-12-12,24,2507,2565,1964,3910,5512,16458
2023-12-13,24,4690,1230,2402,1634,3530,13486
2023-12-14,24,2575,1009,2091,2716,3401,11792
2023-12-15,24,1482,1306,1554,4245,3409,11996
2023-12-16,24,2741,1981,2550,4429,2756,14457
2023-12-17,24,4670,2554,1780,2310,5377,16691
2023-12-18,24,1220,2196,3831,3731,4500,15478
2023-12-19,24,3793,1813,1880,2053,4522,14061
2023-12-20,24,1060,2934,1223,3099,5243,13559
2023-12-21,24,1584,867,2591,3647,4650,13339
2023-12-22,24,2295,2770,3530,1918,5252,15765
2023-12-23,24,3310,1507,1854,3185,5898,15754
2023-12-24,24,3503,1819,3724,1581,4948,15575
2023-12-25,24,2614,2443,2029,3507,4929,15522
2023-12-26,24,4158,2616,1927,2036,2444,13181
2023-12-27,24,1673,2080,1389,3615,5403,14160
2023-12-28,24,4719,1219,2581,4283,4833,17635
2023-12-29,24,2224,1034,2032,2427,4897,12614
2023-12-30,24,3373,1606,1614,1712,4763,13068
2023-12-31,24,1118,954,2802,2877,2462,10213
2022-01-01,25,1695,2382,1503,1539,3764,10883
2022-01-02,25,2622,2408,3445,1709,5282,15466
2022-01-03,25,4184,913,3509,4161,4066,16833
2022-01-04,25,2736,1761,3516,2635,4190,14838
2022-01-05,25,1070,942,1965,2542,2646,9165
2022-01-06,25,4355,1292,3829,2987,2579,15042
2022-01-07,25,2310,2960,2499,3150,3059,13978
2022-01-08,25,4006,2868,3226,2742,5484,18326
2022-01-09,25,3925,1838,3688,2074,4603,16128
2022-01-10,25,2767,1088,2891,4472,3910,15128
2022-01-11,25,3983,1025,2119,3380,5740,16247
2022-01-12,25,4932,2080,3658,2791,4583,18044
2022-01-13,25,3627,2368,3648,2500,3946,16089
2022-01-14,25,2427,1589,2497,1639,4711,12863
2022-01-15,25,1044,936,2882,2682,3493,11037
2022-01-16,25,1447,1572,3931,3481,3505,13936
2022-01-17,25,2965,1812,3369,3384,2844,14374
2022-01-18,25,2639,2155,1745,4166,5829,16534
2022-01-19,25,4260,2462,1389,3777,2110,13998
2022-01-20,25,4230,942,3876,1819,5312,16179
2022-01-21,25,3326,2514,3298,4112,2050,15300
2022-01-22,25,1048,1453,1412,2099,5353,11365
2022-01-23,25,4697,2734,3120,3540,2492,16583
2022-01-24,25,3266,1953,1465,4288,3856,14828
2022-01-25,25,2579,2011,2150,2082,2044,10866
2022-01-26,25,2609,2398,3202,2710,5253,16172
2022-01-27,25,3922,1255,3871,2719,3398,15165
2022-01-28,25,4803,1184,2493,3120,5854,17454
2022-01-29,25,1960,873,2916,4197,3758,13704
2022-01-30,25,3320,1701,2205,1638,3390,12254
2022-01-31,25,3052,2520,2203,1675,3828,13278
2022-02-01,25,1302,1736,1610,2007,2453,9108
2022-02-02,25,2071,1993,1583,2874,5183,13704
2022-02-03,25,4904,2700,1306,3785,2209,14904
2022-02-04,25,2888,2718,3249,2208,4363,15426
2022-02-05,25,1261,945,2557,4456,4720,13939
2022-02-06,25,4587,2350,3222,3143,4955,18257
2022-02-07,25,1449,1614,1619,2123,2621,9426
2022-02-08,25,4619,2989,3799,2212,3020,16639
2022-02-09,25,2250,2006,2126,1600,2825,10807
2022-02-10,25,4366,1735,3449,2942,5932,18424
2022-02-11,25,2914,2976,1914,4244,4290,16338
2022-02-12,25,1016,2092,1322,3004,3276,10710
2022-02-13,25,1966,2668,3277,3612,2543,14066
2022-02-14,25,4618,2276,2026,2418,2457,13795
2022-02-15,25,1818,2534,2234,4417,3108,14111
2022-02-16,25,3640,1430,3444,3452,2424,14390
2022-02-17,25,4616,1801,1453,4480,4669,17019
2022-02-18,25,2500,2700,3963,4273,3663,17099
2022-02-19,25,3390,1951,2705,2487,2009,12542
2022-02-20,25,4292,1364,3025,2678,5302,16661
2022-02-21,25,3009,2945,3993,3223,2166,15336
2022-02-22,25,1024,1358,2636,2078,5340,12436
2022-02-23,25,2962,2453,2360,2768,2024,12567
2022-02-24,25,1006,2898,3685,3006,4932,15527
2022-02-25,25,2613,2025,2481,3482,2095,12696
2022-02-26,25,4878,2563,1621,1728,2500,13290
2022-02-27,25,2123,1933,2140,3500,5554,15250
2022-02-28,25,2899,1849,3112,1759,4506,14125
2022-03-01,25,2951,2388,3434,4123,5352,18248
2022-03-02,25,3768,2696,2078,4402,4016,16960
2022-03-03,25,1977,831,1904,2057,3060,9829
2022-03-04,25,4417,928,2703,3145,2584,13777
2022-03-05,25,3321,2766,3146,2194,4554,15981
2022-03-06,25,4507,2875,3374,2784,3604,17144
2022-03-07,25,1535,2529,2724,2571,5473,14832
2022-03-08,25,4242,2903,2680,3368,3729,16922
2022-03-09,25,1169,1505,2454,2848,5369,13345
2022-03-10,25,3931,2003,3729,3987,3515,17165
2022-03-11,25,4882,1361,1972,3960,3803,15978
2022-03-12,25,4383,2395,1965,2566,5619,16928
2022-03-13,25,1968,1808,3225,3139,4939,15079
2022-03-14,25,3164,1521,1334,3310,3588,12917
2022-03-15,25,4554,1165,1569,3125,3518,13931
2022-03-16,25,1913,1695,2011,2644,4800,13063
2022-03-17,25,1152,1748,2102,1684,4631,11317
2022-03-18,25,2629,2806,3542,2656,2114,13747
2022-03-19,25,4080,1854,3402,2170,2997,14503
2022-03-20,25,2806,1559,1844,2287,3707,12203
2022-03-21,25,1350,2843,1340,1981,5165,12679
2022-03-22,25,1673,2647,2956,2845,4543,14664
2022-03-23,25,3424,2638,3859,2147,4426,16494
2022-03-24,25,4595,919,2014,3368,2938,13834
2022-03-25,25,3499,941,2502,2973,3874,13789
2022-03-26,25,4036,2784,1640,1762,4034,14256
2022-03-27,25,1616,1838,2915,3074,5951,15394
2022-03-28,25,2081,997,3056,2387,5413,13934
2022-03-29,25,4668,1488,3740,3917,5986,19799
2022-03-30,25,1244,2288,2231,2236,2829,10828
2022-03-31,25,3285,1266,3904,2151,5691,16297
2022-04-01,25,4237,2603,3390,3475,5539,19244
2022-04-02,25,2622,2981,2272,3206,4012,15093
2022-04-03,25,2083,2243,1858,3117,4509,13810
2022-04-04,25,1307,2538,3601,3338,5875,16659
2022-04-05,25,3107,1996,3793,2710,4601,16207
2022-04-06,25,4692,1876,2666,2239,5581,17054
2022-04-07,25,1831,1134,1754,3685,5233,13637
2022-04-08,25,2042,1693,3614,2032,3991,13372
2022-04-09,25,1867,1791,3966,4236,5002,16862
2022-04-10,25,4231,2858,1352,1671,3920,14032
2022-04-11,25,2696,1365,3408,4306,2980,14755
2022-04-12,25,2056,2504,1431,3749,3411,13151
2022-04-13,25,1791,2355,1589,3400,4985,14120
2022-04-14,25,3388,882,1554,3693,2836,12353
2022-04-15,25,4463,1927,1594,1745,5087,14816
2022-04-16,25,2674,1891,1284,3911,5054,14814
2022-04-17,25,4718,2693,3226,3649,3192,17478
2022-04-18,25,3174,1542,2619,2768,5881,15984
2022-04-19,25,1223,994,1636,1624,5443,10920
2022-04-20,25,1965,1323,1467,3668,2471,10894
2022-04-21,25,3090,2678,2917,1627,5646,15958
2022-04-22,25,3092,1002,2421,2571,3352,12438
2022-04-23,25,2724,2569,3817,1562,4846,15518
2022-04-24,25,4827,1433,2647,2862,2810,14579
2022-04-25,25,1921,1720,2068,2009,3938,11656
2022-04-26,25,3247,2015,2774,4248,2932,15216
2022-04-27,25,4236,1351,1786,2301,3890,13564
2022-04-28,25,1244,1558,1657,4390,4734,13583
2022-04-29,25,1894,2880,3524,1852,5765,15915
2022-04-30,25,4999,1271,2202,2530,3163,14165
2022-05-01,25,3983,1113,3544,3586,2794,15020
2022-05-02,25,4447,2891,1611,2614,2501,14064
2022-05-03,25,4368,1466,2723,2726,5276,16559
2022-05-04,25,4642,2090,3202,2639,4737,17310
2022-05-05,25,4086,2624,2576,3728,5845,18859
2022-05-06,25,2321,2644,1560,3185,2671,12381
2022-05-07,25,1858,1373,2984,2526,5749,14490
2022-05-08,25,4609,1063,1231,3930,4014,14847
2022-05-09,25,3158,1823,3494,3854,2359,14688
2022-05-10,25,4730,2416,1219,3592,3527,15484
2022-05-11,25,4240,1744,2627,4343,4115,17069
2022-05-12,25,1186,1299,2472,2263,3188,10408
2022-05-13,25,3131,1022,3402,2088,5720,15363
2022-05-14,25,4476,2575,1948,1919,4555,15473
2022-05-15,25,4997,2189,3711,1573,4030,16500
2022-05-16,25,3943,2730,2595,4249,4671,18188
2022-05-17,25,2503,2549,3265,4185,3002,15504
2022-05-18,25,3541,2390,1616,4352,5084,16983
2022-05-19,25,1702,2326,3519,2119,5613,15279
2022-05-20,25,2023,1184,2843,3561,4170,13781
2022-05-21,25,3327,2977,1811,2014,3897,14026
2022-05-22,25,2459,1975,2193,2626,3626,12879
2022-05-23,25,3372,1707,2940,1822,3030,12871
2022-05-24,25,3535,868,1331,3194,5010,13938
2022-05-25,25,4096,2719,3442,2462,5941,18660
2022-05-26,25,1300,2736,3244,3714,2286,13280
2022-05-27,25,2057,1744,2354,1762,3076,10993
2022-05-28,25,4673,1754,2536,2679,4436,16078
2022-05-29,25,4329,2313,3626,3685,3702,17655
2022-05-30,25,3669,2137,1366,2581,3045,12798
2022-05-31,25,4733,853,3765,4165,5421,18937
2022-06-01,25,2518,1911,2400,1969,2127,10925
2022-06-02,25,1421,908,3100,2429,3913,11771
2022-06-03,25,2893,1099,2003,4198,3539,13732
2022-06-04,25,1863,898,1669,4239,4024,12693
2022-06-05,25,1711,1079,2242,3847,2116,10995
2022-06-06,25,4816,1412,3803,4016,4649,18696
2022-06-07,25,3344,1946,3867,4217,5860,19234
2022-06-08,25,4923,1036,1644,1799,3319,12721
2022-06-09,25,1080,1989,1915,2463,2410,9857
2022-06-10,25,4787,1057,1389,2227,5174,14634
2022-06-11,25,2962,2696,1990,3791,4708,16147
2022-06-12,25,4606,1176,3116,3102,4780,16780
2022-06-13,25,3422,2981,2989,1736,4497,15625
2022-06-14,25,1479,2182,2096,3389,2423,11569
2022-06-15,25,3607,939,3102,3097,2222,12967
2022-06-16,25,4840,1831,2269,3473,2509,14922
2022-06-17,25,3028,2352,1890,1670,5122,14062
2022-06-18,25,3677,1768,3268,2099,4173,14985
2022-06-19,25,4189,1713,3139,4078,5044,18163
2022-06-20,25,3842,1317,1486,2858,4559,14062
2022-06-21,25,1930,2545,2301,1934,4899,13609
2022-06-22,25,1465,1362,1208,2317,2860,9212
2022-06-23,25,2907,2301,1664,3964,2381,13217
2022-06-24,25,1560,1301,3629,4270,3807,14567
2022-06-25,25,1942,1212,2537,3603,2313,11607
2022-06-26,25,2944,2673,2677,4456,3368,16118
2022-06-27,25,4948,2213,2464,3108,3427,16160
2022-06-28,25,3368,2705,3956,1712,5164,16905
2022-06-29,25,3812,1848,1721,4207,3781,15369
2022-06-30,25,4023,2804,2402,2744,3726,15699
2022-07-01,25,2805,2778,2577,2821,4225,15206
2022-07-02,25,3688,2378,2318,4300,4424,17108
2022-07-03,25,1623,2527,3513,1941,2749,12353
2022-07-04,25,3390,1040,3553,1893,2561,12437
2022-07-05,25,1839,1848,3253,1846,5813,14599
2022-07-06,25,3550,2641,1588,1652,4835,14266
2022-07-07,25,2503,2977,3689,3996,4079,17244
2022-07-08,25,3727,1575,1307,3502,2017,12128
2022-07-09,25,4922,2860,2890,2001,2158,14831
2022-07-10,25,1616,2747,2465,2828,4943,14599
2022-07-11,25,4446,1742,2090,2608,3473,14359
2022-07-12,25,2511,2019,1202,1698,5417,12847
2022-07-13,25,3223,2881,2290,2054,4726,15174
2022-07-14,25,2362,2526,3401,2621,4558,15468
2022-07-15,25,3246,1486,3276,4200,3649,15857
2022-07-16,25,3033,1898,2027,1572,2559,11089
2022-07-17,25,2176,2236,1407,2812,5710,14341
2022-07-18,25,2255,2690,2226,2865,4149,14185
2022-07-19,25,3648,1368,1606,1547,4068,12237
2022-07-20,25,4234,1571,2067,2165,5373,15410
2022-07-21,25,1244,2036,3110,4004,3577,13971
2022-07-22,25,4025,2223,1464,3052,2786,13550
2022-07-23,25,3576,927,3832,2242,4903,15480
2022-07-24,25,4768,1948,3053,4286,4846,18901
2022-07-25,25,1798,1247,2735,3269,4175,13224
2022-07-26,25,2855,2633,1558,1527,3848,12421
2022-07-27,25,4685,1035,1465,3749,4945,15879
2022-07-28,25,2385,1156,1854,1502,2614,9511
2022-07-29,25,2056,1058,1648,2944,4677,12383
2022-07-30,25,3592,1460,2373,2523,3876,13824
2022-07-31,25,3634,2270,1571,2068,4018,13561
2022-08-01,25,1941,827,2974,3588,4486,13816
2022-08-02,25,4040,2374,3431,4138,3266,17249
2022-08-03,25,3983,1423,1379,1774,3792,12351
2022-08-04,25,3043,1641,3271,1989,5009,14953
2022-08-05,25,3290,1615,1345,4489,5846,16585
2022-08-06,25,3544,1690,3415,2307,3475,14431
2022-08-07,25,2388,2048,2941,2097,2135,11609
2022-08-08,25,2447,2254,1444,2643,5717,14505
2022-08-09,25,3634,1142,2882,3718,3402,14778
2022-08-10,25,4986,2473,1781,3095,4786,17121
2022-08-11,25,4239,970,2890,4098,4900,17097
2022-08-12,25,4921,2426,2807,1864,3892,15910
2022-08-13,25,3228,2743,2642,2493,5224,16330
2022-08-14,25,2917,1019,2168,2268,2641,11013
2022-08-15,25,2247,2673,3546,3801,4366,16633
2022-08-16,25,3940,2111,2345,2054,5532,15982
2022-08-17,25,4628,2130,2283,1683,4580,15304
2022-08-18,25,4067,2012,3467,3220,5154,17920
2022-08-19,25,2794,1887,1839,3491,2861,12872
2022-08-20,25,1322,1536,3500,1819,5363,13540
2022-08-21,25,1750,1372,2245,3474,5146,13987
2022-08-22,25,4917,2166,1316,2175,3957,14531
2022-08-23,25,3644,2306,1708,3571,3113,14342
2022-08-24,25,2688,2787,2558,2143,3702,13878
2022-08-25,25,2837,2115,1560,3155,2379,12046
2022-08-26,25,2423,2587,2380,2877,3935,14202
2022-08-27,25,1876,2875,1716,3005,3139,12611
2022-08-28,25,3947,1779,2156,1687,2223,11792
2022-08-29,25,4853,2117,1380,2724,4707,15781
2022-08-30,25,4654,1344,1903,3895,2658,14454
2022-08-31,25,4734,2413,2578,4245,2597,16567
2022-09-01,25,3911,1065,2228,2492,4110,13806
2022-09-02,25,2446,2577,3469,1684,2855,13031
2022-09-03,25,4879,921,2463,3753,5864,17880
2022-09-04,25,4822,1440,1640,2563,2462,12927
2022-09-05,25,3195,2606,2613,3086,2514,14014
2022-09-06,25,2746,1255,2306,4298,2417,13022
2022-09-07,25,3117,1259,1975,3315,2461,12127
2022-09-08,25,2998,2496,3518,3886,2699,15597
2022-09-09,25,2802,2177,3455,3846,5517,17797
2022-09-10,25,2514,2294,2616,2223,4297,13944
2022-09-11,25,3051,2646,1344,1737,5225,14003
2022-09-12,25,4543,2824,3646,4201,4541,19755
2022-09-13,25,3461,2123,2307,3030,3047,13968
2022-09-14,25,2740,1833,2023,3481,5376,15453
2022-09-15,25,2209,2868,3187,1870,2603,12737
2022-09-16,25,3499,1099,3929,3098,2161,13786
2022-09-17,25,1148,1748,2659,4493,3588,13636
2022-09-18,25,4431,1192,3356,2290,5886,17155
2022-09-19,25,3204,1098,3509,4318,2401,14530
2022-09-20,25,2940,1452,1596,3378,4154,13520
2022-09-21,25,3481,1892,2023,4350,2257,14003
2022-09-22,25,1359,2007,2144,2677,4313,12500
2022-09-23,25,4293,2126,1402,3186,4214,15221
2022-09-24,25,3648,2783,1792,2470,2008,12701
2022-09-25,25,4123,2225,1739,2887,5246,16220
2022-09-26,25,1387,1125,2812,3782,5759,14865
2022-09-27,25,3372,1387,2720,4115,3119,14713
2022-09-28,25,4958,916,2665,2650,4759,15948
2022-09-29,25,4191,1699,3991,4101,3511,17493
2022-09-30,25,2503,997,1491,2503,5501,12995
2022-10-01,25,3633,2112,1622,2960,3177,13504
2022-10-02,25,2795,2332,3019,3391,4787,16324
2022-10-03,25,3827,1893,3143,2237,4249,15349
2022-10-04,25,2285,1539,2265,3926,2238,12253
2022-10-05,25,3746,1129,1438,3443,5263,15019
2022-10-06,25,3222,1271,3721,2176,4108,14498
2022-10-07,25,4636,2203,1831,3489,2040,14199
2022-10-08,25,1067,1380,2700,3427,4008,12582
2022-10-09,25,3812,1734,1270,3581,5193,15590
2022-10-10,25,4720,2570,2520,2464,4777,17051
2022-10-11,25,1075,1637,1834,1805,2112,8463
2022-10-12,25,1066,843,1383,2188,5335,10815
2022-10-13,25,2840,909,3872,2871,2331,12823
2022-10-14,25,4310,2344,2895,3504,2414,15467
2022-10-15,25,2361,1147,2456,2189,4537,12690
2022-10-16,25,1011,2654,2882,2455,5550,14552
2022-10-17,25,3128,2178,2851,3993,3882,16032
2022-10-18,25,3217,2574,3114,1862,2914,13681
2022-10-19,25,1743,2644,1797,2505,4854,13543
2022-10-20,25,2150,2627,1776,3819,3487,13859
2022-10-21,25,2928,1452,1854,4081,3285,13600
2022-10-22,25,1279,2052,1802,3862,4593,13588
2022-10-23,25,1991,2915,2365,1885,4452,13608
2022-10-24,25,3139,2687,1342,2122,3377,12667
2022-10-25,25,3467,1052,2422,3843,5459,16243
2022-10-26,25,3064,2993,1372,2734,4048,14211
2022-10-27,25,1576,2975,3437,4204,4325,16517
2022-10-28,25,3068,1983,1431,3445,3721,13648
2022-10-29,25,4668,2218,1639,3458,3220,15203
2022-10-30,25,1449,1652,1677,2978,2760,10516
2022-10-31,25,1892,2133,3402,3914,4162,15503
2022-11-01,25,2134,1258,2258,1937,5970,13557
2022-11-02,25,3043,2098,2838,3489,5604,17072
2022-11-03,25,3118,2971,2711,4333,4559,17692
2022-11-04,25,2942,2804,2326,3948,2924,14944
2022-11-05,25,1905,2843,3622,1917,3431,13718
2022-11-06,25,3316,2731,3470,3887,5536,18940
2022-11-07,25,2903,1329,1340,4106,2701,12379
2022-11-08,25,2327,2059,1597,4216,2707,12906
2022-11-09,25,1279,1239,3154,3907,5090,14669
2022-11-10,25,4740,1275,1922,2865,4601,15403
2022-11-11,25,4234,1851,3929,3152,5112,18278
2022-11-12,25,2560,1209,2653,2613,4534,13569
2022-11-13,25,2780,1623,2516,3462,5350,15731
2022-11-14,25,2566,2521,2831,1816,2995,12729
2022-11-15,25,1039,2108,3387,2774,3173,12481
2022-11-16,25,4263,1891,2864,3925,5239,18182
2022-11-17,25,2778,1060,3909,2887,4906,15540
2022-11-18,25,3860,2562,2422,2094,2939,13877
2022-11-19,25,1976,1296,2965,3953,2063,12253
2022-11-20,25,2048,2711,3123,1954,2424,12260
2022-11-21,25,1904,1494,1537,3075,5524,13534
2022-11-22,25,3427,2668,3222,4263,4289,17869
2022-11-23,25,2737,2924,1333,3158,2597,12749
2022-11-24,25,4094,1776,2945,3735,2335,14885
2022-11-25,25,2865,1413,2261,3850,4544,14933
2022-11-26,25,2815,2406,3567,3468,3296,15552
2022-11-27,25,2352,1280,3351,2814,5825,15622
2022-11-28,25,4107,2805,2279,2212,5158,16561
2022-11-29,25,1007,1120,2323,2155,2197,8802
2022-11-30,25,2979,1877,1488,2418,4839,13601
2022-12-01,25,4736,815,1305,4322,5717,16895
2022-12-02,25,3786,1956,3525,3151,4554,16972
2022-12-03,25,1395,1426,2737,3930,5034,14522
2022-12-04,25,2837,2154,3414,3993,5450,17848
2022-12-05,25,1724,1911,3365,2784,5291,15075
2022-12-06,25,4661,2055,1752,3969,4545,16982
2022-12-07,25,1287,1214,3279,2060,5572,13412
2022-12-08,25,2047,2940,1505,2259,4984,13735
2022-12-09,25,2560,1952,2977,2907,3216,13612
2022-12-10,25,4048,1728,3178,4459,2675,16088
2022-12-11,25,4441,1034,2726,3618,3577,15396
2022-12-12,25,3186,987,2061,2749,3606,12589
2022-12-13,25,3668,1757,1580,3559,2098,12662
2022-12-14,25,2775,2708,1855,2724,5563,15625
2022-12-15,25,1949,1502,3521,3530,2406,12908
2022-12-16,25,4407,2742,3361,4123,2184,16817
2022-12-17,25,4938,1857,1885,2787,4740,16207
2022-12-18,25,2877,1188,2315,2906,3990,13276
2022-12-19,25,3418,2149,2711,1884,2781,12943
2022-12-20,25,2963,1510,1810,3810,4318,14411
2022-12-21,25,1208,2140,2500,1744,4101,11693
2022-12-22,25,4096,1815,1327,4234,4919,16391
2022-12-23,25,2025,2759,1810,4085,2255,12934
2022-12-24,25,1030,2073,2144,2301,4364,11912
2022-12-25,25,2740,1870,1955,3316,4949,14830
2022-12-26,25,2650,1507,2063,3733,3361,13314
2022-12-27,25,1484,983,2915,2404,5448,13234
2022-12-28,25,2860,2335,2725,3823,2022,13765
2022-12-29,25,4059,1504,1381,4142,2623,13709
2022-12-30,25,1696,2450,2133,3281,3625,13185
2022-12-31,25,1213,1412,3508,2328,4909,13370
2023-01-01,25,4650,2229,1354,2466,4688,15387
2023-01-02,25,2112,1715,1634,4468,5851,15780
2023-01-03,25,3222,1446,3553,2166,5202,15589
2023-01-04,25,4986,1820,3952,1684,5697,18139
2023-01-05,25,1567,1704,2673,2767,2136,10847
2023-01-06,25,1871,841,1425,2054,2986,9177
2023-01-07,25,4521,1414,2959,3932,3398,16224
2023-01-08,25,2772,2507,3275,4403,2165,15122
2023-01-09,25,2869,2280,3334,1818,2366,12667
2023-01-10,25,3470,1149,3470,1709,2786,12584
2023-01-11,25,4704,2470,2209,4036,2768,16187
2023-01-12,25,3217,2097,3427,4222,2240,15203
2023-01-13,25,4965,1090,3889,3540,4408,17892
2023-01-14,25,3981,1025,3914,1761,3940,14621
2023-01-15,25,4375,2256,3082,3312,3142,16167
2023-01-16,25,4561,1878,3784,4452,3832,18507
2023-01-17,25,2127,1765,2172,1590,3230,10884
2023-01-18,25,2227,997,3990,4043,2490,13747
2023-01-19,25,3621,2476,2361,3986,2682,15126
2023-01-20,25,4508,2903,1875,2476,4809,16571
2023-01-21,25,4333,2818,3986,1970,2035,15142
2023-01-22,25,1403,2019,2209,3510,2448,11589
2023-01-23,25,1304,2643,2113,4286,3532,13878
2023-01-24,25,3571,2202,3167,2717,3227,14884
2023-01-25,25,3047,1384,3001,3239,4883,15554
2023-01-26,25,2936,1644,1674,3376,5487,15117
2023-01-27,25,4516,2436,1689,2627,5424,16692
2023-01-28,25,3270,1307,2198,3676,5232,15683
2023-01-29,25,1035,2717,3754,3383,3860,14749
2023-01-30,25,3095,1095,3568,4367,2172,14297
2023-01-31,25,4201,1739,1415,2939,3248,13542
2023-02-01,25,2446,1317,2852,4139,3036,13790
2023-02-02,25,4420,2066,3171,4462,4737,18856
2023-02-03,25,1565,1838,3305,3018,5673,15399
2023-02-04,25,4266,1630,1355,2281,3012,12544
2023-02-05,25,4716,1159,1512,2156,4045,13588
2023-02-06,25,3186,2388,3610,2323,3567,15074
2023-02-07,25,2387,1071,2612,1804,2947,10821
2023-02-08,25,1609,1238,1781,3922,2144,10694
2023-02-09,25,3611,1395,1335,2852,3257,12450
2023-02-10,25,4292,1912,3386,3739,5746,19075
2023-02-11,25,1857,1770,3063,2693,4149,13532
2023-02-12,25,3438,961,3459,3332,2185,13375
2023-02-13,25,2217,1007,2680,3429,3229,12562
2023-02-14,25,4136,2365,3930,2447,4081,16959
2023-02-15,25,2414,1045,3751,2256,2261,11727
2023-02-16,25,4255,1009,2569,3345,4223,15401
2023-02-17,25,4560,927,3446,2565,3722,15220
2023-02-18,25,1930,1130,3953,3425,3724,14162
2023-02-19,25,3686,2750,2165,3177,4668,16446
2023-02-20,25,4254,1243,2317,2888,2714,13416
2023-02-21,25,2992,841,1304,3571,2827,11535
2023-02-22,25,2563,2123,1246,2564,5776,14272
2023-02-23,25,2270,1451,3467,2281,5222,14691
2023-02-24,25,3544,2334,2733,2294,4736,15641
2023-02-25,25,2472,1861,1431,3943,5015,14722
2023-02-26,25,3424,2062,2046,3868,5611,17011
2023-02-27,25,3304,977,1247,2805,3262,11595
2023-02-28,25,3900,1812,2400,2748,5623,16483
2023-03-01,25,1157,1331,1597,2246,2245,8576
2023-03-02,25,4616,1894,2409,3932,4447,17298
2023-03-03,25,4230,2002,1821,2142,5156,15351
2023-03-04,25,1599,2024,3432,3064,4941,15060
2023-03-05,25,1982,1620,1221,2895,5315,13033
2023-03-06,25,2223,874,3380,2874,4382,13733
2023-03-07,25,3368,2314,1789,2053,4853,14377
2023-03-08,25,3218,1281,2740,3771,5974,16984
2023-03-09,25,1936,855,3532,1908,3889,12120
2023-03-10,25,2869,2293,1559,4143,2161,13025
2023-03-11,25,1940,1556,1794,4232,5571,15093
2023-03-12,25,3410,1389,2855,3627,4246,15527
2023-03-13,25,3263,1743,2684,4027,3878,15595
2023-03-14,25,4189,906,2454,1846,2766,12161
2023-03-15,25,4140,964,1503,4199,3940,14746
2023-03-16,25,2033,1174,2300,2872,4154,12533
2023-03-17,25,4466,1636,2681,2627,2609,14019
2023-03-18,25,4783,2036,3660,1812,3229,15520
2023-03-19,25,1041,2259,3774,3419,4665,15158
2023-03-20,25,2001,2211,3593,2994,2527,13326
2023-03-21,25,2991,2967,3356,2410,2294,14018
2023-03-22,25,3507,1821,2695,4219,4966,17208
2023-03-23,25,3364,2840,1259,2979,3487,13929
2023-03-24,25,4223,1534,3348,4015,5999,19119
2023-03-25,25,4148,2430,2770,1954,4236,15538
2023-03-26,25,3570,1163,1337,3695,2204,11969
2023-03-27,25,4821,1921,1868,2054,4104,14768
2023-03-28,25,3342,2089,1293,2789,4977,14490
2023-03-29,25,4925,1116,2703,3530,5045,17319
2023-03-30,25,2783,1878,2898,3648,3512,14719
2023-03-31,25,2707,2528,3271,2511,2812,13829
2023-04-01,25,3668,2358,3009,3006,4196,16237
2023-04-02,25,4214,815,1415,3337,3584,13365
2023-04-03,25,2068,1167,2310,4171,4314,14030
2023-04-04,25,2357,2260,1785,4449,2692,13543
2023-04-05,25,4240,1517,3004,3783,3938,16482
2023-04-06,25,4554,981,2335,2924,2263,13057
2023-04-07,25,3878,1562,3504,1731,3295,13970
2023-04-08,25,2824,2567,3447,4447,5645,18930
2023-04-09,25,1287,2810,3391,3281,5046,15815
2023-04-10,25,2538,2968,3693,3388,5914,18501
2023-04-11,25,1325,2905,3774,3135,4512,15651
2023-04-12,25,3048,1580,1318,3261,5473,14680
2023-04-13,25,3102,2981,3211,2909,3047,15250
2023-04-14,25,4148,2511,1854,1606,2759,12878
2023-04-15,25,3054,2607,2911,3448,2679,14699
2023-04-16,25,4099,2636,2917,2951,5494,18097
2023-04-17,25,4477,2080,3809,3234,3568,17168
2023-04-18,25,4651,1549,2177,3627,5576,17580
2023-04-19,25,1105,1966,2156,3196,5170,13593
2023-04-20,25,3626,2774,1282,3990,5570,17242
2023-04-21,25,4994,1807,3352,1520,5434,17107
2023-04-22,25,4196,1911,2656,3601,4250,16614
2023-04-23,25,1036,1270,2451,2197,2231,9185
2023-04-24,25,1689,1914,3266,4220,3512,14601
2023-04-25,25,2671,1282,3435,2519,3299,13206
2023-04-26,25,2735,2014,2066,4224,4548,15587
2023-04-27,25,1890,2821,1403,3263,2438,11815
2023-04-28,25,3721,2943,3864,2975,5425,18928
2023-04-29,25,1287,2041,1640,1640,5851,12459
2023-04-30,25,2118,1157,1922,4371,3555,13123
2023-05-01,25,1828,2449,3102,1704,5779,14862
2023-05-02,25,3646,1613,1481,2111,2602,11453
2023-05-03,25,3198,1843,3176,1723,4903,14843
2023-05-04,25,3951,2844,2229,3325,4089,16438
2023-05-05,25,2138,2129,2263,2441,5964,14935
2023-05-06,25,2169,1347,1608,2256,3899,11279
2023-05-07,25,4115,2084,3221,2085,3758,15263
2023-05-08,25,4857,1288,2657,2869,2839,14510
2023-05-09,25,3715,2327,3114,2790,2261,14207
2023-05-10,25,4856,944,3321,2751,2130,14002
2023-05-11,25,1221,2930,1822,4362,3227,13562
2023-05-12,25,2228,2219,3561,2768,2878,13654
2023-05-13,25,2622,2691,3140,2652,5573,16678
2023-05-14,25,3196,1212,3940,2932,5172,16452
2023-05-15,25,4157,933,2938,3562,5825,17415
2023-05-16,25,2063,937,2462,1598,3993,11053
2023-05-17,25,3895,2468,1752,4189,4797,17101
2023-05-18,25,1600,2372,1287,4318,2531,12108
2023-05-19,25,3741,1264,3025,4450,2630,15110
2023-05-20,25,4232,2157,2690,1943,4076,15098
2023-05-21,25,3994,2944,2858,2802,4865,17463
2023-05-22,25,2594,1526,3988,3010,3724,14842
2023-05-23,25,4963,2953,3801,3338,3815,18870
2023-05-24,25,3177,1206,2703,2676,4665,14427
2023-05-25,25,1992,1456,1504,1653,2602,9207
2023-05-26,25,1571,1667,1668,1695,3541,10142
2023-05-27,25,2764,2866,2509,1826,5835,15800
2023-05-28,25,1785,1640,3963,2327,4488,14203
2023-05-29,25,3098,1178,2263,4407,5758,16704
2023-05-30,25,4689,1633,1375,4143,3484,15324
2023-05-31,25,4940,1834,2708,3620,5318,18420
2023-06-01,25,1771,1036,1414,4425,4208,12854
2023-06-02,25,2149,1826,2753,2904,2429,12061
2023-06-03,25,1249,2586,3022,4429,3224,14510
2023-06-04,25,3180,957,2582,3376,3110,13205
2023-06-05,25,3634,2632,2247,1544,2312,12369
2023-06-06,25,4156,2685,3653,3822,5676,19992
2023-06-07,25,2026,2295,1500,1766,5998,13585
2023-06-08,25,4897,2672,3761,2616,2473,16419
2023-06-09,25,3384,1694,2558,4416,2550,14602
2023-06-10,25,1223,2170,3431,4189,3972,14985
2023-06-11,25,2166,2068,1205,2815,5663,13917
2023-06-12,25,1370,2370,2334,1530,4196,11800
2023-06-13,25,3568,2491,1207,3947,2886,14099
2023-06-14,25,1538,2169,2769,2007,3254,11737
2023-06-15,25,1906,2813,2126,4120,3311,14276
2023-06-16,25,1843,2189,2023,3639,3443,13137
2023-06-17,25,3246,2790,2475,4286,2133,14930
2023-06-18,25,1574,1949,3740,3890,3151,14304
2023-06-19,25,1191,936,3128,4087,5524,14866
2023-06-20,25,4216,2248,3962,1594,2151,14171
2023-06-21,25,1929,2568,3531,2808,2834,13670
2023-06-22,25,2261,1379,1896,2943,5326,13805
2023-06-23,25,4846,2446,3481,1853,2359,14985
2023-06-24,25,2618,1944,3604,2101,4718,14985
2023-06-25,25,1248,2427,1569,3593,5036,13873
2023-06-26,25,3209,2194,2248,2430,2151,12232
2023-06-27,25,4236,1089,1701,3906,2523,13455
2023-06-28,25,1116,1146,1756,3317,3965,11300
2023-06-29,25,1113,2389,1430,3039,4140,12111
2023-06-30,25,2393,2117,2745,3137,3914,14306
2023-07-01,25,2739,1967,1791,4350,2922,13769
2023-07-02,25,3555,2984,2336,4028,5364,18267
2023-07-03,25,3609,1333,1238,3439,3294,12913
2023-07-04,25,1882,1387,2102,3150,5328,13849
2023-07-05,25,1469,2723,2592,4472,2015,13271
2023-07-06,25,2334,2746,3206,2063,3269,13618
2023-07-07,25,3792,1214,2390,1674,5805,14875
2023-07-08,25,2595,2569,1341,3702,3444,13651
2023-07-09,25,2516,2049,1609,1695,4358,12227
2023-07-10,25,2613,2139,1602,1828,4102,12284
2023-07-11,25,2140,1074,1591,3803,5004,13612
2023-07-12,25,4386,2973,1556,3012,3098,15025
2023-07-13,25,4798,992,2913,3382,5531,17616
2023-07-14,25,2950,2689,3623,2609,4963,16834
2023-07-15,25,1740,1726,2640,3449,2722,12277
2023-07-16,25,2499,2154,2416,4014,5065,16148
2023-07-17,25,2489,1895,2033,3973,4948,15338
2023-07-18,25,4260,1798,3663,3632,5261,18614
2023-07-19,25,4547,1634,2938,3098,4133,16350
2023-07-20,25,4256,2468,2547,2581,3045,14897
2023-07-21,25,1481,2739,1221,2207,2416,10064
2023-07-22,25,4682,1850,3175,2131,2914,14752
2023-07-23,25,2833,2953,2224,3235,4668,15913
2023-07-24,25,3148,1617,3518,3162,2160,13605
2023-07-25,25,1775,1494,1381,4170,4594,13414
2023-07-26,25,1238,1963,2684,4267,5371,15523
2023-07-27,25,4865,2068,1756,2493,2361,13543
2023-07-28,25,4288,2954,1632,4031,5119,18024
2023-07-29,25,4571,2080,2946,2786,3115,15498
2023-07-30,25,2966,1048,3922,2210,5058,15204
2023-07-31,25,2438,1053,1485,4106,3023,12105
2023-08-01,25,2354,2090,2347,3851,3318,13960
2023-08-02,25,1559,2361,3252,4233,2580,13985
2023-08-03,25,4769,865,1538,3226,3285,13683
2023-08-04,25,2958,2929,1212,2161,2168,11428
2023-08-05,25,3493,1754,3386,4270,4804,17707
2023-08-06,25,1898,1176,2758,2890,4839,13561
2023-08-07,25,1198,1013,2381,1669,5297,11558
2023-08-08,25,4315,1389,3016,4298,3704,16722
2023-08-09,25,3372,2578,1445,3630,3937,14962
2023-08-10,25,2278,2662,1286,3590,5047,14863
2023-08-11,25,1957,1122,3744,3341,2787,12951
2023-08-12,25,2284,1923,3243,1849,2553,11852
2023-08-13,25,4959,1616,1282,3759,5402,17018
2023-08-14,25,3822,2907,3687,3318,3232,16966
2023-08-15,25,3707,2141,3901,3355,3905,17009
2023-08-16,25,2021,1578,3335,2133,5978,15045
2023-08-17,25,2558,1576,2062,2446,4873,13515
2023-08-18,25,3996,1648,2621,3584,5223,17072
2023-08-19,25,3510,1635,3007,3564,3703,15419
2023-08-20,25,2287,843,2361,2231,2317,10039
2023-08-21,25,3084,2805,1866,3423,3490,14668
2023-08-22,25,3382,2912,3571,3194,5418,18477
2023-08-23,25,3594,2862,3113,2922,4935,17426
2023-08-24,25,1247,1789,2082,2548,5745,13411
2023-08-25,25,1744,1252,1277,4264,5837,14374
2023-08-26,25,1865,1178,3724,2296,5579,14642
2023-08-27,25,2229,2756,2335,2323,3036,12679
2023-08-28,25,3260,2008,2035,1870,3831,13004
2023-08-29,25,1630,996,2187,2381,2407,9601
2023-08-30,25,2770,2867,1615,2307,3519,13078
2023-08-31,25,3176,1347,2202,2893,3536,13154
2023-09-01,25,2032,2401,2468,3707,4948,15556
2023-09-02,25,1557,1666,1303,3551,3897,11974
2023-09-03,25,2601,1482,3721,3031,3688,14523
2023-09-04,25,1729,2179,2725,3287,4811,14731
2023-09-05,25,2499,1682,1748,4042,5990,15961
2023-09-06,25,1088,2460,2303,3079,5762,14692
2023-09-07,25,4447,2359,3556,2159,4447,16968
2023-09-08,25,2254,2968,3933,1704,2965,13824
2023-09-09,25,3009,2804,3119,2848,5652,17432
2023-09-10,25,2560,1387,2586,2579,2084,11196
2023-09-11,25,3277,2750,2586,3267,2146,14026
2023-09-12,25,1170,1293,2378,3836,2340,11017
2023-09-13,25,3467,2610,1519,2229,5088,14913
2023-09-14,25,3141,1134,3819,3190,2243,13527
2023-09-15,25,3318,1030,2022,1515,3991,11876
2023-09-16,25,4732,1469,3994,1914,3826,15935
2023-09-17,25,1236,917,3294,4430,4405,14282
2023-09-18,25,4460,2811,2994,3492,5607,19364
2023-09-19,25,4903,2175,2454,2035,4098,15665
2023-09-20,25,3414,1671,1247,2646,2081,11059
2023-09-21,25,4585,2919,2094,2194,5266,17058
2023-09-22,25,4748,1824,2752,2807,2035,14166
2023-09-23,25,4377,2248,3821,2957,4962,18365
2023-09-24,25,3230,2119,3838,4095,4814,18096
2023-09-25,25,3775,902,1310,2479,3367,11833
2023-09-26,25,1051,965,2871,3100,2517,10504
2023-09-27,25,1666,1664,3003,3160,5909,15402
2023-09-28,25,4448,1632,2762,2473,2164,13479
2023-09-29,25,3590,2323,3853,1947,5659,17372
2023-09-30,25,4013,1820,3454,2182,5146,16615
2023-10-01,25,1948,840,1307,2238,5619,11952
2023-10-02,25,2071,1638,3931,2791,5980,16411
2023-10-03,25,2924,817,1599,3656,2953,11949
2023-10-04,25,4247,1668,3489,2053,4835,16292
2023-10-05,25,3378,2180,1939,2752,5558,15807
2023-10-06,25,1598,1616,2577,4254,3434,13479
2023-10-07,25,4017,1987,2655,1868,4471,14998
2023-10-08,25,1590,2224,1356,1996,2896,10062
2023-10-09,25,1938,1182,1879,1579,4108,10686
2023-10-10,25,3757,2256,3750,1613,3742,15118
2023-10-11,25,1865,1831,1729,1584,2199,9208
2023-10-12,25,2938,1362,3188,3336,5601,16425
2023-10-13,25,2520,1646,2271,2322,3999,12758
2023-10-14,25,3851,1322,3157,3901,2418,14649
2023-10-15,25,3943,1556,2936,2343,3151,13929
2023-10-16,25,1290,1805,2545,4174,2212,12026
2023-10-17,25,1312,2777,3879,2892,3816,14676
2023-10-18,25,1950,2370,3085,2168,4279,13852
2023-10-19,25,2656,2648,1707,2268,3582,12861
2023-10-20,25,2350,1223,2710,2352,2312,10947
2023-10-21,25,1902,1616,2884,1525,4506,12433
2023-10-22,25,3187,2940,1399,1731,2214,11471
2023-10-23,25,2368,1069,3034,4323,4557,15351
2023-10-24,25,2983,1872,3533,3569,2835,14792
2023-10-25,25,2155,1893,3955,3128,3854,14985
2023-10-26,25,1294,911,3533,3790,5059,14587
2023-10-27,25,2327,1854,2454,2273,5277,14185
2023-10-28,25,1693,2737,1608,3790,3371,13199
2023-10-29,25,4662,2881,1323,4464,2141,15471
2023-10-30,25,2893,1681,1566,2934,3293,12367
2023-10-31,25,1640,1428,1230,3870,2650,10818
2023-11-01,25,4823,1949,2425,4136,4832,18165
2023-11-02,25,1501,2573,3407,3890,3722,15093
2023-11-03,25,3392,2758,2005,4139,2050,14344
2023-11-04,25,2180,1869,2588,2910,3509,13056
2023-11-05,25,3798,1209,2360,1931,4552,13850
2023-11-06,25,2266,2871,1623,2156,5980,14896
2023-11-07,25,1350,1714,1794,4293,3986,13137
2023-11-08,25,3849,2175,3311,2105,2308,13748
2023-11-09,25,4139,2154,3487,1690,2989,14459
2023-11-10,25,2916,2405,2844,4464,5374,18003
2023-11-11,25,1036,1832,3038,2502,3959,12367
2023-11-12,25,3804,1854,3592,2190,3107,14547
2023-11-13,25,3066,2180,2854,4192,4527,16819
2023-11-14,25,3941,1232,1812,4422,3278,14685
2023-11-15,25,3476,2451,2355,3347,5616,17245
2023-11-16,25,4268,2688,3378,1939,3367,15640
2023-11-17,25,3235,2908,1885,2193,4987,15208
2023-11-18,25,3366,2020,3854,2165,2237,13642
2023-11-19,25,2739,1812,3896,2575,4306,15328
2023-11-20,25,3179,1611,1282,1595,3106,10773
2023-11-21,25,4364,2996,3888,3428,5463,20139
2023-11-22,25,2162,1038,3955,4172,5182,16509
2023-11-23,25,2266,929,1307,2516,2018,9036
2023-11-24,25,1055,959,3406,3062,2747,11229
2023-11-25,25,4861,2832,3759,3161,3398,18011
2023-11-26,25,1263,805,1460,4370,3697,11595
2023-11-27,25,2342,1688,3278,3945,3093,14346
2023-11-28,25,2533,1542,1373,2434,4617,12499
2023-11-29,25,2089,882,3836,4140,2450,13397
2023-11-30,25,2064,1493,2976,3422,3191,13146
2023-12-01,25,3759,1381,1499,3824,4219,14682
2023-12-02,25,4429,1747,2519,2996,4427,16118
2023-12-03,25,4487,2397,3576,2607,3981,17048
2023-12-04,25,1025,2077,3827,3659,4638,15226
2023-12-05,25,1495,1682,2209,3663,2609,11658
2023-12-06,25,3602,1400,3978,2923,3025,14928
2023-12-07,25,2477,2618,2586,2246,5381,15308
2023-12-08,25,2935,1848,2722,3450,4133,15088
2023-12-09,25,1447,2076,3876,2402,3416,13217
2023-12-10,25,4043,1216,2682,2440,5327,15708
2023-12-11,25,3179,1791,1594,1645,3151,11360
2023-12-12,25,4532,2369,3808,1868,4937,17514
2023-12-13,25,4180,2803,1531,2465,5525,16504
2023-12-14,25,4764,1749,2130,1548,5638,15829
2023-12-15,25,4773,2144,3396,1723,4318,16354
2023-12-16,25,2151,1961,1984,2618,5932,14646
2023-12-17,25,1102,2087,3946,2032,4703,13870
2023-12-18,25,3692,1931,1958,2206,5169,14956
2023-12-19,25,2038,1287,3047,3575,5770,15717
2023-12-20,25,4634,2387,1939,4263,3034,16257
2023-12-21,25,4005,1062,3626,2311,3071,14075
2023-12-22,25,3060,1579,2457,3945,2627,13668
2023-12-23,25,1098,2355,1385,3111,4229,12178
2023-12-24,25,3427,2389,3331,4152,5525,18824
2023-12-25,25,2448,1127,3648,1888,2595,11706
2023-12-26,25,4913,1686,1247,2879,4284,15009
2023-12-27,25,1523,2725,3106,4347,2919,14620
2023-12-28,25,2763,2343,3975,1886,3862,14829
2023-12-29,25,2236,951,2493,4417,5321,15418
2023-12-30,25,2603,1414,2919,4075,4295,15306
2023-12-31,25,2827,1352,2337,1955,4528,12999
2022-01-01,26,1536,1553,2696,1926,5444,13155
2022-01-02,26,2578,1364,2788,1699,5943,14372
2022-01-03,26,4410,1000,3222,3366,4784,16782
2022-01-04,26,3643,1100,3214,2999,3171,14127
2022-01-05,26,4457,2151,3267,4049,3281,17205
2022-01-06,26,2031,1129,2143,2343,3888,11534
2022-01-07,26,1842,1337,2186,2532,2172,10069
2022-01-08,26,1743,2720,3170,4245,4471,16349
2022-01-09,26,1505,2011,3719,3432,5975,16642
2022-01-10,26,3348,1966,2643,2591,4109,14657
2022-01-11,26,4355,2674,2087,3265,3310,15691
2022-01-12,26,4658,1840,2126,3632,5857,18113
2022-01-13,26,2105,1899,2372,1730,2679,10785
2022-01-14,26,1438,1574,2278,3757,5637,14684
2022-01-15,26,1900,1141,2133,3601,3980,12755
2022-01-16,26,2925,2946,2930,3134,5185,17120
2022-01-17,26,4454,1838,3778,2359,2821,15250
2022-01-18,26,4690,2209,1825,4244,3334,16302
2022-01-19,26,2128,887,3558,4495,4371,15439
2022-01-20,26,4684,1678,2468,1662,5898,16390
2022-01-21,26,1667,1181,3880,3393,2990,13111
2022-01-22,26,3900,1100,3174,1753,5653,15580
2022-01-23,26,3683,2703,2173,1996,3310,13865
2022-01-24,26,3721,1895,2384,1680,5389,15069
2022-01-25,26,3719,1050,1204,1762,5530,13265
2022-01-26,26,2580,1450,3341,2946,3573,13890
2022-01-27,26,4328,1598,2832,2487,2600,13845
2022-01-28,26,1892,940,2817,2271,3379,11299
2022-01-29,26,2323,2256,3851,3848,5476,17754
2022-01-30,26,1751,2767,1930,3231,3851,13530
2022-01-31,26,4004,2775,1355,2996,3501,14631
2022-02-01,26,1912,1306,2841,2840,2054,10953
2022-02-02,26,1294,1989,2380,1570,5702,12935
2022-02-03,26,1739,1484,3102,4410,3975,14710
2022-02-04,26,1018,2529,2885,4280,4780,15492
2022-02-05,26,4314,1642,1864,3099,3095,14014
2022-02-06,26,3424,1558,1319,2411,3488,12200
2022-02-07,26,3996,2750,2790,3846,2635,16017
2022-02-08,26,2932,884,2870,1652,4632,12970
2022-02-09,26,2674,1349,2401,3550,2945,12919
2022-02-10,26,3995,1015,3912,4360,3368,16650
2022-02-11,26,4746,2837,2254,1832,3732,15401
2022-02-12,26,1703,1582,3104,1822,5498,13709
2022-02-13,26,2536,1073,3522,1571,5442,14144
2022-02-14,26,2442,2313,3679,1508,2386,12328
2022-02-15,26,1424,956,2376,2657,4106,11519
2022-02-16,26,3225,1463,1982,4107,4825,15602
2022-02-17,26,4988,2828,1979,1512,4115,15422
2022-02-18,26,4705,2140,1919,3212,4276,16252
2022-02-19,26,2521,1004,1894,3744,4207,13370
2022-02-20,26,4362,2022,2277,4497,3921,17079
2022-02-21,26,1476,2785,1286,4082,4942,14571
2022-02-22,26,4313,1329,1886,4336,3849,15713
2022-02-23,26,3757,2721,2578,3446,5982,18484
2022-02-24,26,3810,1529,3596,4450,4104,17489
2022-02-25,26,2636,1112,3365,3242,3138,13493
2022-02-26,26,1603,852,1600,3443,4665,12163
2022-02-27,26,1538,1790,2501,3999,5696,15524
2022-02-28,26,1254,1189,1403,3661,3357,10864
2022-03-01,26,3512,2919,3217,4278,4070,17996
2022-03-02,26,4800,1510,1366,3341,5813,16830
2022-03-03,26,2215,2495,1676,4400,3920,14706
2022-03-04,26,1678,941,3134,2612,5323,13688
2022-03-05,26,1559,2690,1746,2773,3066,11834
2022-03-06,26,3039,2221,3000,3916,5152,17328
2022-03-07,26,1968,1376,1850,2124,2915,10233
2022-03-08,26,3557,1220,3473,2856,2010,13116
2022-03-09,26,1518,2356,2690,4445,3924,14933
2022-03-10,26,4861,887,2369,2651,3257,14025
2022-03-11,26,3019,2490,3972,4255,5515,19251
2022-03-12,26,4843,832,1667,3355,5596,16293
2022-03-13,26,1566,1660,2921,1881,3693,11721
2022-03-14,26,4205,2708,1514,2759,5120,16306
2022-03-15,26,3777,2848,2917,3560,4578,17680
2022-03-16,26,4336,1927,2598,1898,4663,15422
2022-03-17,26,1118,2248,3208,2729,3109,12412
2022-03-18,26,3235,2309,2423,3759,2599,14325
2022-03-19,26,3827,2280,2321,1733,3766,13927
2022-03-20,26,4416,1909,2365,3317,2197,14204
2022-03-21,26,4953,2219,3097,2265,5948,18482
2022-03-22,26,1263,2047,3339,4480,5444,16573
2022-03-23,26,4520,1215,1447,3242,3052,13476
2022-03-24,26,3060,2910,1401,4483,4872,16726
2022-03-25,26,1893,1364,1243,1913,5833,12246
2022-03-26,26,3353,1228,3161,3742,5234,16718
2022-03-27,26,4516,1476,1765,4188,5294,17239
2022-03-28,26,4420,1180,3324,2155,5185,16264
2022-03-29,26,3015,1789,3095,3117,3165,14181
2022-03-30,26,1874,1901,1775,2950,5775,14275
2022-03-31,26,3462,2852,2609,2085,2552,13560
2022-04-01,26,1486,1233,2978,3453,5479,14629
2022-04-02,26,2201,1452,3643,3991,4874,16161
2022-04-03,26,3710,1659,3822,2599,2168,13958
2022-04-04,26,2152,2206,3406,3357,4216,15337
2022-04-05,26,2184,1637,3366,2693,3891,13771
2022-04-06,26,4105,1292,2606,3656,4313,15972
2022-04-07,26,4499,858,3811,1644,2568,13380
2022-04-08,26,3241,1116,3429,3594,4151,15531
2022-04-09,26,4729,948,1486,4454,2791,14408
2022-04-10,26,2627,1072,1775,1603,4130,11207
2022-04-11,26,3542,2541,2987,1908,5277,16255
2022-04-12,26,2102,2665,3540,4002,5744,18053
2022-04-13,26,2408,1893,1659,2129,4803,12892
2022-04-14,26,2881,1601,2067,2357,5725,14631
2022-04-15,26,2548,1156,1437,2773,4197,12111
2022-04-16,26,2357,1983,1336,2657,3059,11392
2022-04-17,26,4826,2165,1444,3206,2673,14314
2022-04-18,26,4345,1842,1926,1985,2697,12795
2022-04-19,26,3023,1937,3082,4445,2508,14995
2022-04-20,26,1878,2058,1979,2108,5845,13868
2022-04-21,26,3608,2264,3366,3428,5962,18628
2022-04-22,26,3720,2284,1519,4096,4110,15729
2022-04-23,26,1141,2269,2246,2095,3509,11260
2022-04-24,26,1828,2677,2791,2060,2265,11621
2022-04-25,26,4139,1454,2848,2737,5882,17060
2022-04-26,26,4357,1824,2108,4103,2677,15069
2022-04-27,26,2122,1446,2840,4115,4720,15243
2022-04-28,26,4711,1156,1627,3504,5714,16712
2022-04-29,26,4252,1916,2451,3991,4703,17313
2022-04-30,26,2441,1116,2477,1521,2037,9592
2022-05-01,26,1830,2390,1905,2768,2997,11890
2022-05-02,26,1044,2646,3069,2413,2365,11537
2022-05-03,26,3059,2507,3717,3724,3468,16475
2022-05-04,26,4315,2921,1800,4079,3235,16350
2022-05-05,26,4936,903,1803,4419,2562,14623
2022-05-06,26,4057,1985,1420,2721,3994,14177
2022-05-07,26,1214,2066,2047,2352,4827,12506
2022-05-08,26,1695,837,2935,1965,4286,11718
2022-05-09,26,2416,1566,1468,1699,4705,11854
2022-05-10,26,4033,2662,2191,2020,4401,15307
2022-05-11,26,4079,2428,2716,4222,4775,18220
2022-05-12,26,3910,1288,3327,1976,2751,13252
2022-05-13,26,1930,1217,1220,3334,3529,11230
2022-05-14,26,1787,2262,2266,4122,4722,15159
2022-05-15,26,1540,2715,3331,2674,2764,13024
2022-05-16,26,1274,969,2394,1862,4781,11280
2022-05-17,26,3019,1072,1385,3239,2698,11413
2022-05-18,26,3952,2776,3510,2543,2054,14835
2022-05-19,26,1592,1179,3011,4403,2022,12207
2022-05-20,26,1363,2044,2877,2911,3659,12854
2022-05-21,26,2585,2193,1206,3668,4335,13987
2022-05-22,26,1145,2991,3617,3872,5268,16893
2022-05-23,26,2010,1621,2783,3738,3401,13553
2022-05-24,26,1255,1517,2354,1663,5742,12531
2022-05-25,26,3981,1179,2882,4004,3500,15546
2022-05-26,26,3685,1600,3792,2569,3964,15610
2022-05-27,26,2736,2963,2826,1771,3110,13406
2022-05-28,26,3918,1059,1828,3115,2561,12481
2022-05-29,26,1070,1113,2766,2405,2219,9573
2022-05-30,26,4421,2541,3431,2338,2868,15599
2022-05-31,26,1619,2363,1923,4025,5411,15341
2022-06-01,26,1533,2452,3149,3640,2670,13444
2022-06-02,26,2501,912,2175,3885,2346,11819
2022-06-03,26,4393,1087,2548,3512,2228,13768
2022-06-04,26,2640,2848,1889,2733,4833,14943
2022-06-05,26,2030,2411,2740,2142,3190,12513
2022-06-06,26,2391,1236,2921,3111,2834,12493
2022-06-07,26,4943,1476,1368,2318,2252,12357
2022-06-08,26,2962,1017,2545,1611,3681,11816
2022-06-09,26,3384,2120,1405,3322,4865,15096
2022-06-10,26,3091,959,2443,3631,3355,13479
2022-06-11,26,1777,2947,2482,2174,3777,13157
2022-06-12,26,1718,1624,2308,4499,5475,15624
2022-06-13,26,1688,1464,3842,2659,2973,12626
2022-06-14,26,2652,2959,1780,2499,5070,14960
2022-06-15,26,4063,1617,1854,1927,4254,13715
2022-06-16,26,1842,2503,3962,3578,3663,15548
2022-06-17,26,3508,1971,1645,1894,2785,11803
2022-06-18,26,4915,1977,3020,3857,5417,19186
2022-06-19,26,1765,1173,3832,4370,4354,15494
2022-06-20,26,4213,2291,3100,4230,5135,18969
2022-06-21,26,1380,1221,2169,1820,2639,9229
2022-06-22,26,3503,1593,2041,3470,3164,13771
2022-06-23,26,2762,1974,2570,3114,4378,14798
2022-06-24,26,2485,873,2499,4493,3456,13806
2022-06-25,26,3766,1886,2263,4205,4026,16146
2022-06-26,26,3447,2390,1921,3561,4522,15841
2022-06-27,26,2117,2311,3445,2226,4862,14961
2022-06-28,26,3852,1014,2007,3309,5052,15234
2022-06-29,26,3177,2149,1739,1780,2426,11271
2022-06-30,26,1463,1950,2719,3397,2282,11811
2022-07-01,26,2819,2566,3963,2671,5679,17698
2022-07-02,26,1298,1740,3812,2574,4953,14377
2022-07-03,26,4928,2528,2627,4054,3380,17517
2022-07-04,26,3913,914,3096,2321,4246,14490
2022-07-05,26,3235,856,3091,2736,3595,13513
2022-07-06,26,1417,2610,1481,4013,5629,15150
2022-07-07,26,1579,1551,1682,2161,4148,11121
2022-07-08,26,2539,1347,2611,1994,3370,11861
2022-07-09,26,1471,2720,2042,4349,2533,13115
2022-07-10,26,2943,1710,3856,3973,5982,18464
2022-07-11,26,1309,2864,3186,3532,4054,14945
2022-07-12,26,1633,2795,3766,2225,4835,15254
2022-07-13,26,3473,816,2967,1513,5896,14665
2022-07-14,26,3240,1972,3057,3586,4726,16581
2022-07-15,26,2649,2687,3931,3971,3890,17128
2022-07-16,26,1046,1057,1551,3180,5847,12681
2022-07-17,26,4070,821,3534,2515,4159,15099
2022-07-18,26,4599,2451,1964,3179,4452,16645
2022-07-19,26,4700,1733,1993,4299,3162,15887
2022-07-20,26,2977,838,1547,3624,5024,14010
2022-07-21,26,4358,1687,3114,4318,4444,17921
2022-07-22,26,4742,2472,3887,1628,5555,18284
2022-07-23,26,3525,877,1992,1582,5493,13469
2022-07-24,26,1114,2371,2806,3831,4197,14319
2022-07-25,26,1383,2816,3492,4282,5002,16975
2022-07-26,26,4957,1774,3775,3299,2251,16056
2022-07-27,26,4271,2723,2834,3211,2949,15988
2022-07-28,26,1753,875,3799,3145,4327,13899
2022-07-29,26,1880,883,1679,2934,3892,11268
2022-07-30,26,4840,882,2351,2937,3364,14374
2022-07-31,26,3926,929,1903,1721,5714,14193
2022-08-01,26,3151,1595,1989,3719,3436,13890
2022-08-02,26,3649,1160,1766,4450,4990,16015
2022-08-03,26,2476,2783,2419,4321,2552,14551
2022-08-04,26,4302,1260,2790,1713,4629,14694
2022-08-05,26,4769,1491,1973,1650,2650,12533
2022-08-06,26,3089,1602,3278,3549,3727,15245
2022-08-07,26,4818,2267,3341,1930,5291,17647
2022-08-08,26,4423,2310,1925,3223,4624,16505
2022-08-09,26,3989,2614,2668,2894,3311,15476
2022-08-10,26,2002,1059,2102,3701,2555,11419
2022-08-11,26,4473,2868,1814,3615,5283,18053
2022-08-12,26,2492,1676,3363,4455,2615,14601
2022-08-13,26,4755,2375,3747,2654,5581,19112
2022-08-14,26,1464,2010,1979,2358,3789,11600
2022-08-15,26,3825,2639,1472,3305,2373,13614
2022-08-16,26,1851,923,2194,3560,5017,13545
2022-08-17,26,2954,2658,3962,1907,2726,14207
2022-08-18,26,3045,1071,1308,2519,4235,12178
2022-08-19,26,3004,2841,2767,4485,3416,16513
2022-08-20,26,1094,948,2451,2586,2425,9504
2022-08-21,26,3164,1959,1417,3087,4174,13801
2022-08-22,26,2774,2833,1348,3676,2528,13159
2022-08-23,26,2773,1277,2485,4165,2730,13430
2022-08-24,26,2478,1545,3744,3232,3353,14352
2022-08-25,26,2790,1922,2825,2833,3178,13548
2022-08-26,26,2909,1153,1481,4248,3075,12866
2022-08-27,26,2578,2967,2117,2901,5269,15832
2022-08-28,26,4632,1703,1205,3936,3534,15010
2022-08-29,26,4642,1836,2636,2117,5869,17100
2022-08-30,26,2431,2698,2260,1911,3870,13170
2022-08-31,26,2883,1248,2484,3196,5103,14914
2022-09-01,26,1469,2947,2023,3542,4686,14667
2022-09-02,26,3845,2602,1419,3672,4561,16099
2022-09-03,26,1276,2950,1834,2921,2739,11720
2022-09-04,26,1407,2759,3348,1970,4686,14170
2022-09-05,26,2754,1309,3242,1777,4056,13138
2022-09-06,26,3425,2663,1289,1624,2708,11709
2022-09-07,26,1006,815,3509,3601,5770,14701
2022-09-08,26,2498,1856,2581,3806,4308,15049
2022-09-09,26,3518,2627,2547,2168,2457,13317
2022-09-10,26,2594,816,3617,4269,4380,15676
2022-09-11,26,2009,2748,3661,2550,5268,16236
2022-09-12,26,1778,2501,1507,2147,4885,12818
2022-09-13,26,2637,1789,2185,3204,3575,13390
2022-09-14,26,4304,1333,3001,2660,5310,16608
2022-09-15,26,3150,2557,1838,3367,3288,14200
2022-09-16,26,4912,2678,3908,2144,4395,18037
2022-09-17,26,3014,931,3922,2999,4654,15520
2022-09-18,26,3805,1347,2437,2330,5960,15879
2022-09-19,26,3715,2320,1711,2099,3564,13409
2022-09-20,26,3461,2300,1273,1810,4960,13804
2022-09-21,26,4575,2568,3938,3747,3149,17977
2022-09-22,26,3671,2403,1743,2906,5892,16615
2022-09-23,26,3913,1852,2101,2434,5217,15517
2022-09-24,26,1184,1246,1761,1904,3426,9521
2022-09-25,26,4091,2637,3405,1575,2989,14697
2022-09-26,26,2306,2194,3593,1640,3050,12783
2022-09-27,26,1685,1275,2910,1564,2279,9713
2022-09-28,26,3577,1466,1726,2395,3716,12880
2022-09-29,26,2700,1747,1208,4275,4981,14911
2022-09-30,26,3575,1850,2255,4287,2069,14036
2022-10-01,26,1568,2158,3971,2118,5363,15178
2022-10-02,26,2773,2741,1467,1909,4315,13205
2022-10-03,26,1556,1910,1862,3379,3475,12182
2022-10-04,26,2193,2404,1803,2176,3144,11720
2022-10-05,26,1228,2951,2637,4151,5523,16490
2022-10-06,26,1685,945,1843,2698,4023,11194
2022-10-07,26,2651,2499,3552,2864,5705,17271
2022-10-08,26,2972,2713,2965,3952,2208,14810
2022-10-09,26,4502,991,2857,2220,2968,13538
2022-10-10,26,4675,885,1995,3158,5373,16086
2022-10-11,26,3481,1307,3335,3461,3960,15544
2022-10-12,26,1165,1485,1252,3423,4188,11513
2022-10-13,26,4538,2630,1972,3746,3145,16031
2022-10-14,26,3676,875,1606,1912,3286,11355
2022-10-15,26,3636,1866,1877,2703,5756,15838
2022-10-16,26,4928,2152,3506,2491,5227,18304
2022-10-17,26,4599,1139,2777,3228,3368,15111
2022-10-18,26,3759,1596,3769,1853,4765,15742
2022-10-19,26,3966,1679,2202,2703,5157,15707
2022-10-20,26,3359,2064,1767,1597,4876,13663
2022-10-21,26,2446,2512,3028,4229,5653,17868
2022-10-22,26,3205,1691,3186,3583,4763,16428
2022-10-23,26,4465,824,3615,1559,3555,14018
2022-10-24,26,1869,1992,2064,2922,4713,13560
2022-10-25,26,3727,1946,3968,2062,3551,15254
2022-10-26,26,2351,1216,1400,4080,3297,12344
2022-10-27,26,1793,1101,2199,4264,2339,11696
2022-10-28,26,1337,2726,1814,3620,4172,13669
2022-10-29,26,4685,1877,1505,2172,2571,12810
2022-10-30,26,3912,1198,1443,2594,2856,12003
2022-10-31,26,1813,2041,3810,1765,4154,13583
2022-11-01,26,1603,2696,3400,4280,3719,15698
2022-11-02,26,2461,1073,2806,1863,4772,12975
2022-11-03,26,3093,2160,3645,3318,5513,17729
2022-11-04,26,2180,1725,1970,3279,2043,11197
2022-11-05,26,2936,1684,1968,2167,2463,11218
2022-11-06,26,2860,890,1875,2413,4078,12116
2022-11-07,26,4342,1855,3413,1749,2062,13421
2022-11-08,26,3983,1224,3766,3099,2549,14621
2022-11-09,26,2250,2760,3667,3242,3145,15064
2022-11-10,26,2204,1709,1289,3645,2913,11760
2022-11-11,26,2188,2847,2390,2225,3607,13257
2022-11-12,26,4800,2156,3511,3017,4082,17566
2022-11-13,26,2981,2150,2844,2197,5098,15270
2022-11-14,26,4941,2475,2045,1758,5025,16244
2022-11-15,26,1855,995,3103,3492,3439,12884
2022-11-16,26,4839,821,2839,3784,5547,17830
2022-11-17,26,1751,2854,2424,3249,2914,13192
2022-11-18,26,2108,829,2278,4226,4815,14256
2022-11-19,26,2507,1979,2741,2543,4243,14013
2022-11-20,26,2038,1932,1579,1676,5441,12666
2022-11-21,26,4377,945,2287,3133,2406,13148
2022-11-22,26,3701,1066,1427,4439,2383,13016
2022-11-23,26,4548,1629,1885,1986,2726,12774
2022-11-24,26,1258,2486,2534,3389,2371,12038
2022-11-25,26,2990,2396,2532,3735,5463,17116
2022-11-26,26,2148,1900,1501,3117,3816,12482
2022-11-27,26,3807,867,3334,2962,2178,13148
2022-11-28,26,1322,2054,3697,3634,4875,15582
2022-11-29,26,4709,2818,1763,2159,5877,17326
2022-11-30,26,1806,2364,3431,2296,3972,13869
2022-12-01,26,3994,1457,1910,1769,5538,14668
2022-12-02,26,2257,2354,3106,3056,5022,15795
2022-12-03,26,3844,2854,3705,2035,5159,17597
2022-12-04,26,3875,2416,1329,2396,4953,14969
2022-12-05,26,4716,1223,3746,3917,4816,18418
2022-12-06,26,4553,1663,1354,1751,4153,13474
2022-12-07,26,2405,2448,3532,2780,5207,16372
2022-12-08,26,3363,2767,2627,4216,4229,17202
2022-12-09,26,3151,2758,2170,2911,5146,16136
2022-12-10,26,3373,1197,3913,3192,5839,17514
2022-12-11,26,2008,2551,2978,2816,2986,13339
2022-12-12,26,2762,1320,2757,3406,2878,13123
2022-12-13,26,1412,869,3003,3474,5841,14599
2022-12-14,26,2785,1447,1720,3949,4773,14674
2022-12-15,26,4482,1362,3618,2284,2037,13783
2022-12-16,26,4644,2106,3352,3242,3992,17336
2022-12-17,26,1584,1139,1855,4003,3606,12187
2022-12-18,26,2163,2573,1619,3033,2708,12096
2022-12-19,26,2659,2818,2276,4463,2946,15162
2022-12-20,26,1819,1238,3563,3855,4777,15252
2022-12-21,26,3004,2874,3297,1896,4681,15752
2022-12-22,26,2929,1622,1352,3755,3919,13577
2022-12-23,26,2157,1575,3848,3679,2703,13962
2022-12-24,26,2054,1227,2575,2530,3309,11695
2022-12-25,26,1805,1643,1832,3116,4914,13310
2022-12-26,26,2358,2308,2072,2624,5234,14596
2022-12-27,26,2749,1157,2972,2876,4857,14611
2022-12-28,26,4559,2942,3041,1738,2942,15222
2022-12-29,26,4465,2580,2353,2700,3161,15259
2022-12-30,26,4543,1899,2807,1666,5801,16716
2022-12-31,26,4192,2383,3439,1658,2839,14511
2023-01-01,26,1879,1270,1323,4363,4334,13169
2023-01-02,26,4876,2848,3433,2838,5983,19978
2023-01-03,26,2117,2927,3570,3680,2474,14768
2023-01-04,26,2608,2243,2025,3123,5167,15166
2023-01-05,26,1231,2985,1643,4340,2428,12627
2023-01-06,26,3573,2501,1478,2008,5852,15412
2023-01-07,26,1986,1317,3837,4395,5818,17353
2023-01-08,26,1280,2324,1551,2822,5427,13404
2023-01-09,26,4058,2063,1313,1968,5916,15318
2023-01-10,26,4346,891,3206,3272,5861,17576
2023-01-11,26,1211,2654,2888,4222,4068,15043
2023-01-12,26,4883,1574,2026,1532,5307,15322
2023-01-13,26,2112,2937,1492,3352,3938,13831
2023-01-14,26,4887,1696,2746,2519,5538,17386
2023-01-15,26,3724,1389,3706,1531,4392,14742
2023-01-16,26,1102,1548,1697,3964,3727,12038
2023-01-17,26,3572,1132,2979,4102,5315,17100
2023-01-18,26,1474,1748,1416,1519,5784,11941
2023-01-19,26,2225,2950,2673,3157,3400,14405
2023-01-20,26,3567,2625,1411,3294,2678,13575
2023-01-21,26,3913,1778,3155,4070,2476,15392
2023-01-22,26,2307,1369,2227,2627,2208,10738
2023-01-23,26,1041,1000,1784,1664,2817,8306
2023-01-24,26,3283,2200,3563,2603,2754,14403
2023-01-25,26,3746,1778,2400,2946,2169,13039
2023-01-26,26,2086,2681,1826,3093,4634,14320
2023-01-27,26,4324,1974,3809,3305,5382,18794
2023-01-28,26,3020,2975,1698,3538,5503,16734
2023-01-29,26,4474,1833,3455,1975,3347,15084
2023-01-30,26,2789,1010,3732,2384,3045,12960
2023-01-31,26,4305,2267,2797,3203,4812,17384
2023-02-01,26,2092,2773,2073,2390,3473,12801
2023-02-02,26,4499,1397,2029,4474,2292,14691
2023-02-03,26,3460,1178,2659,2319,3210,12826
2023-02-04,26,4246,971,2806,2921,3889,14833
2023-02-05,26,3016,1298,2703,4052,5117,16186
2023-02-06,26,1329,1248,3403,1668,2333,9981
2023-02-07,26,4806,2531,3005,2551,2531,15424
2023-02-08,26,4152,2669,2198,3836,2717,15572
2023-02-09,26,1148,1244,2564,3305,3884,12145
2023-02-10,26,2174,2739,2410,3414,4682,15419
2023-02-11,26,3035,1269,3395,3508,4174,15381
2023-02-12,26,4128,1290,1739,3395,5544,16096
2023-02-13,26,3116,1461,3993,3629,5596,17795
2023-02-14,26,2258,1903,3512,4488,5959,18120
2023-02-15,26,1641,1395,3923,1816,2428,11203
2023-02-16,26,1865,1915,1230,1978,4607,11595
2023-02-17,26,4693,2695,2110,2883,2284,14665
2023-02-18,26,3746,1858,3382,3384,3518,15888
2023-02-19,26,3403,1816,2569,2061,2256,12105
2023-02-20,26,2514,2510,3834,1974,2313,13145
2023-02-21,26,4615,858,3106,2475,5171,16225
2023-02-22,26,1022,2441,3062,3118,3980,13623
2023-02-23,26,3389,2490,2764,4135,5914,18692
2023-02-24,26,4957,2785,2463,2267,5126,17598
2023-02-25,26,3388,1477,2416,3075,2138,12494
2023-02-26,26,1521,1289,1888,4461,5233,14392
2023-02-27,26,3523,1628,3496,1924,5052,15623
2023-02-28,26,2249,1006,3959,4434,4486,16134
2023-03-01,26,2697,2936,1508,2032,3442,12615
2023-03-02,26,1019,1632,2567,3638,4653,13509
2023-03-03,26,1193,1067,3287,2759,4785,13091
2023-03-04,26,2651,1866,2752,2539,3190,12998
2023-03-05,26,2568,2181,2717,4017,4081,15564
2023-03-06,26,2179,912,1789,2396,2907,10183
2023-03-07,26,2958,2351,1688,2350,3199,12546
2023-03-08,26,1291,1714,2769,3064,5719,14557
2023-03-09,26,2278,1156,2609,2192,2014,10249
2023-03-10,26,2008,2440,3198,2124,4510,14280
2023-03-11,26,3132,1098,3495,2593,3379,13697
2023-03-12,26,1103,2772,3212,2391,3155,12633
2023-03-13,26,4224,2319,3997,3263,3316,17119
2023-03-14,26,1285,1056,2364,2496,3514,10715
2023-03-15,26,2446,1536,3990,2400,3442,13814
2023-03-16,26,1491,2309,2167,4327,5504,15798
2023-03-17,26,1437,2956,2890,2701,4386,14370
2023-03-18,26,1749,1548,3409,2137,2437,11280
2023-03-19,26,3941,868,3515,2696,3440,14460
2023-03-20,26,4546,2672,1853,3099,4462,16632
2023-03-21,26,3529,2434,2529,3156,5047,16695
2023-03-22,26,2012,880,2403,2355,2860,10510
2023-03-23,26,1185,2755,2027,2154,4041,12162
2023-03-24,26,3739,1340,3238,2304,2571,13192
2023-03-25,26,3184,2907,3918,2330,3077,15416
2023-03-26,26,4750,818,3712,3575,3348,16203
2023-03-27,26,4656,1584,3869,4330,2163,16602
2023-03-28,26,3332,1501,2225,3544,5767,16369
2023-03-29,26,2138,2948,1827,2475,5000,14388
2023-03-30,26,2553,1404,3972,3281,4381,15591
2023-03-31,26,3026,1161,3621,2874,2280,12962
2023-04-01,26,4282,2677,3134,3733,5067,18893
2023-04-02,26,2653,2048,3066,3582,5371,16720
2023-04-03,26,3855,1327,2166,3068,2689,13105
2023-04-04,26,4924,2636,3727,3928,3969,19184
2023-04-05,26,4862,1695,3244,2131,5343,17275
2023-04-06,26,4199,1735,3834,1536,5550,16854
2023-04-07,26,3106,898,1851,2467,4323,12645
2023-04-08,26,3123,2973,3414,2269,4094,15873
2023-04-09,26,2923,870,2141,2592,2298,10824
2023-04-10,26,4201,1006,1427,1990,2446,11070
2023-04-11,26,2275,1117,2935,2742,4373,13442
2023-04-12,26,3406,2045,2462,4062,4431,16406
2023-04-13,26,1742,2038,2147,4438,3123,13488
2023-04-14,26,3073,2868,1809,2496,5950,16196
2023-04-15,26,4484,1147,3857,3452,5336,18276
2023-04-16,26,2603,1499,3560,2023,5979,15664
2023-04-17,26,4301,810,1376,1511,5618,13616
2023-04-18,26,1334,1192,2400,2862,4405,12193
2023-04-19,26,4834,2487,1669,1800,4392,15182
2023-04-20,26,4041,2692,2792,1772,4339,15636
2023-04-21,26,3928,2125,1433,2316,4895,14697
2023-04-22,26,1548,2010,3720,3298,4906,15482
2023-04-23,26,4135,1095,2223,4078,2743,14274
2023-04-24,26,3726,1330,1697,3677,5521,15951
2023-04-25,26,1838,814,2898,3045,4669,13264
2023-04-26,26,4849,2532,3946,2486,5880,19693
2023-04-27,26,1891,2589,1425,2211,3737,11853
2023-04-28,26,1540,871,3694,2233,4789,13127
2023-04-29,26,2079,1875,1634,4062,2196,11846
2023-04-30,26,1788,1086,2201,2823,3334,11232
2023-05-01,26,4495,1953,1578,2789,3045,13860
2023-05-02,26,2412,2551,2245,2015,4579,13802
2023-05-03,26,2744,2079,3141,2052,2091,12107
2023-05-04,26,1030,2426,3165,3853,5079,15553
2023-05-05,26,3509,2125,1370,3605,2752,13361
2023-05-06,26,3873,2762,1741,4230,4875,17481
2023-05-07,26,2665,2154,1859,3164,4919,14761
2023-05-08,26,3741,2673,3985,3942,3097,17438
2023-05-09,26,4935,2040,3847,3000,2951,16773
2023-05-10,26,3308,2595,2461,2288,3374,14026
2023-05-11,26,2303,1319,1949,2191,3075,10837
2023-05-12,26,3269,1046,2133,3651,3903,14002
2023-05-13,26,1520,1170,2351,4469,5234,14744
2023-05-14,26,1765,2748,3586,1929,5600,15628
2023-05-15,26,4022,1156,2466,2975,5424,16043
2023-05-16,26,1764,2196,3559,4079,4682,16280
2023-05-17,26,2031,2618,3528,3483,5801,17461
2023-05-18,26,4256,2316,3065,2883,2559,15079
2023-05-19,26,2325,2467,1833,1967,5323,13915
2023-05-20,26,4380,2639,3975,1653,2007,14654
2023-05-21,26,1802,1588,2373,4369,2422,12554
2023-05-22,26,2144,1696,1263,2221,2705,10029
2023-05-23,26,2139,1478,3589,4384,5477,17067
2023-05-24,26,3832,2941,1365,1889,4223,14250
2023-05-25,26,1129,1214,1246,2453,4566,10608
2023-05-26,26,1423,2994,1528,4478,3452,13875
2023-05-27,26,2305,2896,3340,3520,5476,17537
2023-05-28,26,1218,1355,2066,4011,2295,10945
2023-05-29,26,1287,1835,2238,2482,5729,13571
2023-05-30,26,2348,2953,1349,1940,2691,11281
2023-05-31,26,3580,1320,2812,3337,2723,13772
2023-06-01,26,3294,1460,2708,1558,4540,13560
2023-06-02,26,4078,2244,1517,3514,4223,15576
2023-06-03,26,3765,1250,1842,3204,5606,15667
2023-06-04,26,3726,2161,1447,2781,2152,12267
2023-06-05,26,1378,1539,2739,2543,2958,11157
2023-06-06,26,3091,2081,2427,2752,4267,14618
2023-06-07,26,2489,988,3884,4153,4386,15900
2023-06-08,26,1528,1808,1365,2600,2804,10105
2023-06-09,26,2936,2721,3895,4294,5460,19306
2023-06-10,26,3466,2100,2837,3418,5084,16905
2023-06-11,26,2998,2967,2701,2880,5789,17335
2023-06-12,26,2192,2914,2711,4269,4318,16404
2023-06-13,26,2577,1844,3578,4437,3850,16286
2023-06-14,26,4026,2809,3122,2097,4948,17002
2023-06-15,26,2512,2397,3100,2259,2850,13118
2023-06-16,26,4543,1147,1458,2197,5354,14699
2023-06-17,26,3929,1407,1896,1966,2035,11233
2023-06-18,26,3552,1885,1706,2772,5093,15008
2023-06-19,26,4165,1834,1481,1727,2855,12062
2023-06-20,26,3986,1008,3844,4407,3360,16605
2023-06-21,26,4466,2120,3840,3094,2316,15836
2023-06-22,26,2353,2450,3812,3441,4396,16452
2023-06-23,26,1334,958,2026,2730,4661,11709
2023-06-24,26,3482,1671,2840,3021,5760,16774
2023-06-25,26,4892,2997,3827,2701,4497,18914
2023-06-26,26,2380,1290,2956,2400,4547,13573
2023-06-27,26,1476,1426,2321,2017,2259,9499
2023-06-28,26,4262,1408,2836,1950,2653,13109
2023-06-29,26,1259,926,3128,3868,3157,12338
2023-06-30,26,3401,2681,3294,1998,2457,13831
2023-07-01,26,4082,852,1388,3803,5015,15140
2023-07-02,26,4241,1146,1533,2334,2664,11918
2023-07-03,26,4029,2878,3247,2743,5590,18487
2023-07-04,26,2478,1983,3291,2981,2510,13243
2023-07-05,26,1049,2895,3306,3288,2100,12638
2023-07-06,26,1203,2032,3969,2340,5254,14798
2023-07-07,26,1241,1028,1985,4374,2453,11081
2023-07-08,26,3830,1220,2743,1597,6000,15390
2023-07-09,26,2954,929,1840,2833,2537,11093
2023-07-10,26,4826,1536,1865,3538,5514,17279
2023-07-11,26,2264,2601,2024,3955,3980,14824
2023-07-12,26,2727,2240,1931,2622,2083,11603
2023-07-13,26,1674,2352,3086,1628,5452,14192
2023-07-14,26,4413,2393,3643,3472,3305,17226
2023-07-15,26,3738,1939,2921,1769,3786,14153
2023-07-16,26,3006,2076,3570,3389,2540,14581
2023-07-17,26,3605,1038,3065,3579,3164,14451
2023-07-18,26,1944,2369,3477,3539,2381,13710
2023-07-19,26,1714,1154,3789,4028,5372,16057
2023-07-20,26,4250,2430,1573,2524,2006,12783
2023-07-21,26,4389,1512,1691,2244,2579,12415
2023-07-22,26,2829,1110,2860,2372,3542,12713
2023-07-23,26,1760,2380,2410,3324,5085,14959
2023-07-24,26,3333,837,2168,3627,3402,13367
2023-07-25,26,3110,2487,2753,4188,3958,16496
2023-07-26,26,1104,854,2466,3468,3535,11427
2023-07-27,26,4500,2761,1721,2117,3969,15068
2023-07-28,26,3096,892,2206,2611,3831,12636
2023-07-29,26,1439,2102,1322,1963,3463,10289
2023-07-30,26,4945,2206,2538,2847,2148,14684
2023-07-31,26,1218,2015,1763,1679,4404,11079
2023-08-01,26,3521,1824,1477,2607,3205,12634
2023-08-02,26,4741,2356,2700,2737,5288,17822
2023-08-03,26,3939,1856,1506,3283,3761,14345
2023-08-04,26,1797,1953,3105,2793,4929,14577
2023-08-05,26,4465,1905,1873,2184,3585,14012
2023-08-06,26,2590,1919,3273,3291,5402,16475
2023-08-07,26,1747,1761,3415,2320,5879,15122
2023-08-08,26,1553,2326,1601,3020,4352,12852
2023-08-09,26,4021,2814,2758,2818,2793,15204
2023-08-10,26,3585,2001,1575,1860,2876,11897
2023-08-11,26,2396,1502,2287,1846,3535,11566
2023-08-12,26,3589,1802,1351,3912,4459,15113
2023-08-13,26,3214,2699,2220,3912,3270,15315
2023-08-14,26,4613,2794,3234,2994,3590,17225
2023-08-15,26,4315,1730,2697,1992,5080,15814
2023-08-16,26,3485,2272,2379,2369,3412,13917
2023-08-17,26,3635,1745,2693,3019,5304,16396
2023-08-18,26,1852,2614,2563,2310,2922,12261
2023-08-19,26,2513,2690,3039,4474,5500,18216
2023-08-20,26,3297,2047,2891,3694,5251,17180
2023-08-21,26,4732,827,1974,3742,4721,15996
2023-08-22,26,1454,1141,2458,3405,5567,14025
2023-08-23,26,3790,1273,2411,3941,5730,17145
2023-08-24,26,2003,1247,3523,4484,2785,14042
2023-08-25,26,3654,2536,1846,2251,3570,13857
2023-08-26,26,2254,949,3517,3543,2672,12935
2023-08-27,26,1520,2129,1795,4055,3447,12946
2023-08-28,26,4152,1265,1438,3896,2877,13628
2023-08-29,26,1702,2214,3277,2993,3573,13759
2023-08-30,26,3708,2345,1267,3684,4316,15320
2023-08-31,26,1501,2879,1994,2429,5952,14755
2023-09-01,26,4914,2907,3785,2287,2941,16834
2023-09-02,26,4417,1427,3557,2633,3124,15158
2023-09-03,26,2336,2486,1801,1537,5568,13728
2023-09-04,26,2268,1811,1636,2437,2927,11079
2023-09-05,26,4513,2557,2412,3193,4741,17416
2023-09-06,26,2954,1767,3061,3482,5136,16400
2023-09-07,26,2455,1843,2384,2313,2959,11954
2023-09-08,26,3717,2190,3623,4204,5108,18842
2023-09-09,26,3768,1201,2906,3419,5559,16853
2023-09-10,26,2067,1456,2490,4178,4326,14517
2023-09-11,26,1638,2691,1535,2677,3902,12443
2023-09-12,26,3168,2161,2504,3227,4672,15732
2023-09-13,26,1304,1782,2330,3698,4682,13796
2023-09-14,26,1799,2168,2719,4421,2680,13787
2023-09-15,26,1968,1863,1808,2954,4168,12761
2023-09-16,26,3644,1602,2673,1940,5183,15042
2023-09-17,26,3596,2733,3422,4013,5040,18804
2023-09-18,26,2791,1478,1204,3260,3601,12334
2023-09-19,26,3719,1077,2004,2565,4031,13396
2023-09-20,26,1500,2756,2132,2443,4164,12995
2023-09-21,26,3019,1812,3655,3181,4598,16265
2023-09-22,26,4074,2034,2083,4414,3965,16570
2023-09-23,26,3366,1744,1601,1587,3486,11784
2023-09-24,26,1423,2276,2873,2558,4164,13294
2023-09-25,26,3835,1583,1793,3768,3883,14862
2023-09-26,26,1990,1388,3850,3550,4652,15430
2023-09-27,26,2753,1997,2503,2795,2303,12351
2023-09-28,26,2726,2831,2429,1839,4497,14322
2023-09-29,26,1795,1187,1675,4189,4717,13563
2023-09-30,26,1635,2457,2170,3585,4858,14705
2023-10-01,26,3302,1253,2711,3454,2101,12821
2023-10-02,26,4848,2661,1999,2826,2126,14460
2023-10-03,26,2047,1559,3569,3077,5267,15519
2023-10-04,26,4825,2107,1795,2343,3207,14277
2023-10-05,26,4981,2182,1634,3551,5068,17416
2023-10-06,26,2601,2911,1865,1890,3535,12802
2023-10-07,26,4373,1616,2518,2394,5767,16668
2023-10-08,26,4419,2657,3521,3446,5544,19587
2023-10-09,26,4557,1914,3635,2824,3410,16340
2023-10-10,26,4013,1472,2333,1819,5336,14973
2023-10-11,26,2604,979,2291,3449,5733,15056
2023-10-12,26,1800,947,2226,2261,2195,9429
2023-10-13,26,4074,2209,1275,3448,5413,16419
2023-10-14,26,2215,2038,2618,1514,5219,13604
2023-10-15,26,2794,2624,1497,3779,5664,16358
2023-10-16,26,2954,1342,1325,3357,2827,11805
2023-10-17,26,3565,1327,1926,3436,4402,14656
2023-10-18,26,3791,2057,3324,3768,3392,16332
2023-10-19,26,3096,1856,3936,3667,2190,14745
2023-10-20,26,3978,2971,2653,4341,3565,17508
2023-10-21,26,4541,2614,2109,3016,2933,15213
2023-10-22,26,2598,1376,3206,2872,3841,13893
2023-10-23,26,2190,1473,3535,2822,3140,13160
2023-10-24,26,1921,1510,2069,3737,2744,11981
2023-10-25,26,3902,1937,2544,3924,2830,15137
2023-10-26,26,1158,2041,2267,2112,5386,12964
2023-10-27,26,2011,922,3622,2314,5200,14069
2023-10-28,26,4263,2512,3394,2869,3976,17014
2023-10-29,26,2083,2959,3842,2802,5349,17035
2023-10-30,26,3403,1590,3626,3565,2646,14830
2023-10-31,26,3657,1783,3195,3892,2136,14663
2023-11-01,26,2019,1538,1999,2577,2895,11028
2023-11-02,26,3366,2246,2367,3776,5216,16971
2023-11-03,26,4898,1067,2247,2805,3052,14069
2023-11-04,26,3692,920,2384,3875,4001,14872
2023-11-05,26,4883,868,2716,2821,3560,14848
2023-11-06,26,3322,2856,1695,2499,5561,15933
2023-11-07,26,1815,1990,3345,2379,3851,13380
2023-11-08,26,3936,1792,3606,3424,4147,16905
2023-11-09,26,1871,2476,1388,2220,2032,9987
2023-11-10,26,1378,1623,1669,2583,3171,10424
2023-11-11,26,3778,2548,3103,1807,4982,16218
2023-11-12,26,2956,2100,3427,2335,5574,16392
2023-11-13,26,2422,2184,1246,3850,5563,15265
2023-11-14,26,3495,877,3874,2940,4241,15427
2023-11-15,26,1985,1618,2768,2784,3818,12973
2023-11-16,26,1245,2831,2961,2923,2396,12356
2023-11-17,26,1388,1462,1240,3502,2992,10584
2023-11-18,26,3470,2796,1865,4419,3405,15955
2023-11-19,26,3164,2984,1213,2459,5123,14943
2023-11-20,26,4233,2653,3670,4171,3652,18379
2023-11-21,26,1561,2666,1683,3463,4719,14092
2023-11-22,26,4864,2457,1547,2373,3065,14306
2023-11-23,26,1149,2332,2587,3012,3655,12735
2023-11-24,26,3059,2192,3969,1712,3942,14874
2023-11-25,26,3498,2522,2173,1996,5863,16052
2023-11-26,26,1662,1875,1524,2599,2349,10009
2023-11-27,26,4002,2128,2790,2370,2053,13343
2023-11-28,26,1709,1135,2057,2697,2753,10351
2023-11-29,26,1432,1347,2828,2443,4178,12228
2023-11-30,26,1229,2424,2585,4091,5624,15953
2023-12-01,26,2581,2934,1817,3286,5909,16527
2023-12-02,26,4316,884,1476,2444,3029,12149
2023-12-03,26,2773,1072,2587,2172,5032,13636
2023-12-04,26,2372,2314,2693,3639,4234,15252
2023-12-05,26,1166,2269,2185,1710,3480,10810
2023-12-06,26,4470,1147,1737,2386,4609,14349
2023-12-07,26,2994,1920,2291,1744,3993,12942
2023-12-08,26,1812,1419,3498,4298,5313,16340
2023-12-09,26,2420,2412,3454,3308,2680,14274
2023-12-10,26,2601,1047,1693,2573,4792,12706
2023-12-11,26,3361,921,1638,3405,3227,12552
2023-12-12,26,2661,2300,1487,4045,5093,15586
2023-12-13,26,1094,1233,2743,2973,3759,11802
2023-12-14,26,2889,1818,2170,2033,2265,11175
2023-12-15,26,3187,1109,3126,2067,2276,11765
2023-12-16,26,4262,804,3356,1987,2503,12912
2023-12-17,26,4364,2454,3550,1771,5080,17219
2023-12-18,26,4700,820,2103,1549,4524,13696
2023-12-19,26,1091,1628,1675,1880,4948,11222
2023-12-20,26,3593,1134,2471,1724,2935,11857
2023-12-21,26,4003,1117,3981,3520,2579,15200
2023-12-22,26,1831,2792,3433,1627,5817,15500
2023-12-23,26,4438,1642,1710,3384,5876,17050
2023-12-24,26,4618,1646,2427,2233,2621,13545
2023-12-25,26,1500,2403,1550,4239,3549,13241
2023-12-26,26,2724,2555,3266,4421,3394,16360
2023-12-27,26,2796,2911,3231,3517,5945,18400
2023-12-28,26,2857,2010,3019,1652,5242,14780
2023-12-29,26,1064,2113,3657,1805,3422,12061
2023-12-30,26,3204,1743,2041,3515,3519,14022
2023-12-31,26,4858,1794,3630,1527,3267,15076
2022-01-01,27,1754,2793,3326,3667,4434,15974
2022-01-02,27,3016,2830,3815,4072,5468,19201
2022-01-03,27,1660,2303,1851,2889,4890,13593
2022-01-04,27,3832,2874,3550,1933,2532,14721
2022-01-05,27,2923,2508,1272,2867,2959,12529
2022-01-06,27,4680,2924,1996,3335,2842,15777
2022-01-07,27,2174,2742,2596,3135,5746,16393
2022-01-08,27,3174,1427,1488,4023,4036,14148
2022-01-09,27,4285,1219,2498,1938,5828,15768
2022-01-10,27,4655,1389,1467,3494,3076,14081
2022-01-11,27,3845,1205,1515,2932,2400,11897
2022-01-12,27,1321,2810,3676,3008,3409,14224
2022-01-13,27,4118,1234,2183,3415,4692,15642
2022-01-14,27,1727,2554,3346,4375,3765,15767
2022-01-15,27,4647,1913,2692,2827,5133,17212
2022-01-16,27,2792,1003,3575,2471,4122,13963
2022-01-17,27,1301,1490,1767,2119,5618,12295
2022-01-18,27,3705,1754,1935,2120,5655,15169
2022-01-19,27,3065,1471,1321,2848,2552,11257
2022-01-20,27,1762,1028,3526,3892,4266,14474
2022-01-21,27,3597,1175,1379,2867,4125,13143
2022-01-22,27,3635,2480,3136,3049,4032,16332
2022-01-23,27,2632,2565,1533,3528,3182,13440
2022-01-24,27,4990,2624,3502,1662,4731,17509
2022-01-25,27,2965,810,3764,2751,4100,14390
2022-01-26,27,1901,2100,2862,1811,4459,13133
2022-01-27,27,1037,2194,2330,4390,3712,13663
2022-01-28,27,3981,1785,3675,3320,5305,18066
2022-01-29,27,2088,2702,2157,1811,5879,14637
2022-01-30,27,1309,1680,1535,4138,3893,12555
2022-01-31,27,2400,2516,3277,2307,3012,13512
2022-02-01,27,1142,1845,2962,2354,3930,12233
2022-02-02,27,4720,1778,1320,4364,4865,17047
2022-02-03,27,4185,2563,1709,3014,4510,15981
2022-02-04,27,2561,1319,3911,2962,2429,13182
2022-02-05,27,4417,1250,2438,3246,5623,16974
2022-02-06,27,1798,2172,2134,3763,4771,14638
2022-02-07,27,4370,2501,1552,2957,2314,13694
2022-02-08,27,1096,1320,2775,3597,3248,12036
2022-02-09,27,2528,2371,3202,3366,2559,14026
2022-02-10,27,3453,1597,2391,2539,3722,13702
2022-02-11,27,3408,2946,2923,3829,5863,18969
2022-02-12,27,1854,1241,3554,3226,3025,12900
2022-02-13,27,2735,1094,3626,1644,5625,14724
2022-02-14,27,4673,1844,2728,2430,5364,17039
2022-02-15,27,1182,1340,1973,3895,2780,11170
2022-02-16,27,2938,1220,1758,2197,2064,10177
2022-02-17,27,1900,963,2904,2282,2922,10971
2022-02-18,27,2414,1060,2042,4061,3280,12857
2022-02-19,27,2511,2262,1659,3430,4351,14213
2022-02-20,27,2822,1640,2480,3638,3032,13612
2022-02-21,27,1599,2659,2493,4052,5275,16078
2022-02-22,27,3950,1667,2750,1731,3741,13839
2022-02-23,27,4807,921,3242,4033,3412,16415
2022-02-24,27,2795,2875,2904,2843,3708,15125
2022-02-25,27,4915,1705,1896,1704,5964,16184
2022-02-26,27,2148,2699,2734,2065,3649,13295
2022-02-27,27,4241,2247,2530,1710,2808,13536
2022-02-28,27,2824,1871,2109,2087,2894,11785
2022-03-01,27,3154,2638,3200,3248,4562,16802
2022-03-02,27,2595,1732,1251,3524,4062,13164
2022-03-03,27,3130,990,2935,3309,5454,15818
2022-03-04,27,3891,1679,2912,2118,5558,16158
2022-03-05,27,3453,2924,1634,1759,4922,14692
2022-03-06,27,1176,2622,3251,2298,2196,11543
2022-03-07,27,2197,2035,3252,1888,5299,14671
2022-03-08,27,1298,2419,1249,3629,4097,12692
2022-03-09,27,3748,910,2024,4295,4478,15455
2022-03-10,27,4101,2326,1652,1742,2612,12433
2022-03-11,27,2350,2230,1899,1689,3253,11421
2022-03-12,27,3784,930,3867,4289,4246,17116
2022-03-13,27,1969,2160,2967,4202,5242,16540
2022-03-14,27,2062,2408,3848,3343,2070,13731
2022-03-15,27,3753,1492,3508,1870,3763,14386
2022-03-16,27,4784,1751,2801,1706,5500,16542
2022-03-17,27,3805,1057,2550,1549,5051,14012
2022-03-18,27,4274,2704,3801,4016,4101,18896
2022-03-19,27,3026,2435,2542,4084,4662,16749
2022-03-20,27,4111,2575,2783,2269,4061,15799
2022-03-21,27,4368,2143,1233,4459,3542,15745
2022-03-22,27,2650,1221,2329,2118,2325,10643
2022-03-23,27,4634,1570,1296,3358,2826,13684
2022-03-24,27,2577,1305,1315,4201,2155,11553
2022-03-25,27,2962,2159,2849,2622,3603,14195
2022-03-26,27,4065,1403,1432,3339,2258,12497
2022-03-27,27,1766,1433,3818,1803,4565,13385
2022-03-28,27,1753,2016,1639,3929,5743,15080
2022-03-29,27,2464,1636,1225,2715,3941,11981
2022-03-30,27,3762,2497,1472,3734,4833,16298
2022-03-31,27,1324,2391,3487,4033,3464,14699
2022-04-01,27,4500,1302,2739,4458,2836,15835
2022-04-02,27,3802,1858,1363,1889,5451,14363
2022-04-03,27,4296,2998,2593,2060,4316,16263
2022-04-04,27,3396,2030,1575,3450,3722,14173
2022-04-05,27,1569,2737,3516,3043,3945,14810
2022-04-06,27,3447,1891,2698,2202,4176,14414
2022-04-07,27,3740,2134,3892,3562,3681,17009
2022-04-08,27,4150,874,3227,2951,2213,13415
2022-04-09,27,2341,2891,1251,2281,5671,14435
2022-04-10,27,4014,1611,2612,3565,2756,14558
2022-04-11,27,3202,1807,2363,3710,4240,15322
2022-04-12,27,1298,1376,2923,3213,2877,11687
2022-04-13,27,2888,2862,2339,2570,5203,15862
2022-04-14,27,1954,1243,2827,3545,4621,14190
2022-04-15,27,2300,1569,1902,2583,2630,10984
2022-04-16,27,4104,1673,2459,2550,4466,15252
2022-04-17,27,1698,2197,1431,2868,2994,11188
2022-04-18,27,3617,940,3375,3803,4133,15868
2022-04-19,27,4924,2449,2808,3257,3280,16718
2022-04-20,27,2552,1384,2312,4041,5646,15935
2022-04-21,27,2973,2200,2916,3855,3003,14947
2022-04-22,27,4654,2008,3057,3503,4307,17529
2022-04-23,27,1162,2690,3086,3055,4398,14391
2022-04-24,27,2120,2156,3594,2752,5692,16314
2022-04-25,27,2606,831,2814,3430,5615,15296
2022-04-26,27,2546,2632,2093,3922,2746,13939
2022-04-27,27,2134,1710,2056,3399,5085,14384
2022-04-28,27,1979,1823,3908,4242,2383,14335
2022-04-29,27,4779,2119,1749,4160,4413,17220
2022-04-30,27,4027,2692,2901,3514,4758,17892
2022-05-01,27,3245,1546,2495,2919,3047,13252
2022-05-02,27,1602,1159,1325,4084,3835,12005
2022-05-03,27,3853,2436,1245,3224,2645,13403
2022-05-04,27,3956,1120,3505,2001,2137,12719
2022-05-05,27,1716,2311,3969,4500,3771,16267
2022-05-06,27,4739,1649,2443,2933,3047,14811
2022-05-07,27,3941,2784,3098,4045,3813,17681
2022-05-08,27,3871,1685,1908,3322,2248,13034
2022-05-09,27,4145,1036,2089,1984,4439,13693
2022-05-10,27,1493,1434,1793,2609,5138,12467
2022-05-11,27,2764,908,3111,3216,3709,13708
2022-05-12,27,2718,1581,2253,3131,5984,15667
2022-05-13,27,4974,1774,3730,1909,3409,15796
2022-05-14,27,4624,1120,3285,1809,3288,14126
2022-05-15,27,4546,1915,1500,3895,4024,15880
2022-05-16,27,4088,802,2464,1963,3127,12444
2022-05-17,27,3537,2641,3010,4376,5072,18636
2022-05-18,27,2243,2186,3116,3986,2194,13725
2022-05-19,27,3465,1139,1301,2050,2689,10644
2022-05-20,27,2994,2717,1216,3072,5576,15575
2022-05-21,27,2142,1364,1209,2684,4448,11847
2022-05-22,27,2974,2311,3566,4215,4653,17719
2022-05-23,27,3176,1354,1803,4149,5284,15766
2022-05-24,27,2481,1337,3858,3216,2216,13108
2022-05-25,27,1509,1720,2592,3370,5647,14838
2022-05-26,27,2401,1888,3228,3613,2328,13458
2022-05-27,27,3166,2400,2568,1528,4239,13901
2022-05-28,27,1236,2783,3362,2189,4542,14112
2022-05-29,27,1406,1254,1626,2876,3702,10864
2022-05-30,27,2240,2646,3047,3950,4098,15981
2022-05-31,27,1762,814,3776,3469,5954,15775
2022-06-01,27,2484,2959,3228,3526,2660,14857
2022-06-02,27,4899,1293,3644,2625,5988,18449
2022-06-03,27,1283,2818,2175,4122,4294,14692
2022-06-04,27,4908,2958,1772,3083,5656,18377
2022-06-05,27,4934,2682,1569,3055,3234,15474
2022-06-06,27,1449,1539,3917,4466,5385,16756
2022-06-07,27,2457,2545,2042,4491,2617,14152
2022-06-08,27,4749,2089,3590,2323,2200,14951
2022-06-09,27,2304,1583,3421,4033,4387,15728
2022-06-10,27,2109,1595,3833,3101,4724,15362
2022-06-11,27,3580,1987,3585,2841,4017,16010
2022-06-12,27,3678,2739,3388,4355,3143,17303
2022-06-13,27,3708,1947,2481,1637,5923,15696
2022-06-14,27,3775,1765,3709,2447,5541,17237
2022-06-15,27,4675,1380,1624,4238,2246,14163
2022-06-16,27,3813,2078,1777,1982,2790,12440
2022-06-17,27,2570,873,2398,3540,4590,13971
2022-06-18,27,2672,1036,3478,1801,4545,13532
2022-06-19,27,2465,2025,3366,3143,2118,13117
2022-06-20,27,2046,3000,3251,2273,5100,15670
2022-06-21,27,1043,1852,1987,4209,3341,12432
2022-06-22,27,1800,1775,2859,2010,2947,11391
2022-06-23,27,4175,2911,3435,2841,3571,16933
2022-06-24,27,4844,916,2467,4118,2823,15168
2022-06-25,27,1399,1264,2934,1791,2971,10359
2022-06-26,27,1322,2581,1833,2872,3838,12446
2022-06-27,27,4517,2508,3197,1936,5827,17985
2022-06-28,27,4660,2580,3423,2041,2389,15093
2022-06-29,27,4561,2982,2597,2149,2172,14461
2022-06-30,27,2015,2693,3434,3361,4421,15924
2022-07-01,27,4403,1556,1257,3966,2521,13703
2022-07-02,27,3347,1815,1596,3761,3324,13843
2022-07-03,27,4138,1502,1919,3942,2631,14132
2022-07-04,27,1212,2594,2981,2684,4198,13669
2022-07-05,27,4646,2619,1868,4370,4499,18002
2022-07-06,27,3639,2751,1529,2076,4968,14963
2022-07-07,27,1809,2225,1418,2375,4249,12076
2022-07-08,27,1113,1785,1982,3012,5078,12970
2022-07-09,27,4519,2866,3277,2447,5186,18295
2022-07-10,27,3986,1879,3680,3894,5393,18832
2022-07-11,27,1311,801,2949,3846,4851,13758
2022-07-12,27,2792,919,1349,2793,4756,12609
2022-07-13,27,2087,1571,1563,1847,4469,11537
2022-07-14,27,3696,1097,2261,4312,2704,14070
2022-07-15,27,3521,1174,3459,2758,2704,13616
2022-07-16,27,2709,2199,3342,2584,3729,14563
2022-07-17,27,2959,2958,3301,2206,5373,16797
2022-07-18,27,2425,2719,1356,3655,4051,14206
2022-07-19,27,3410,1837,3295,3276,4314,16132
2022-07-20,27,2679,1055,3770,2358,3130,12992
2022-07-21,27,2252,1918,2959,3033,4827,14989
2022-07-22,27,4234,1015,2567,4259,3983,16058
2022-07-23,27,1355,2632,2559,3438,3104,13088
2022-07-24,27,3196,1528,2963,3388,4231,15306
2022-07-25,27,4278,1947,3175,4007,3018,16425
2022-07-26,27,3944,2220,1330,4280,5113,16887
2022-07-27,27,2055,1916,2770,3695,5594,16030
2022-07-28,27,2762,2960,3536,4073,2656,15987
2022-07-29,27,1334,2592,2883,2379,2043,11231
2022-07-30,27,2255,2529,2583,3720,5201,16288
2022-07-31,27,1421,1767,1699,3178,3196,11261
2022-08-01,27,4155,2901,3621,2132,3589,16398
2022-08-02,27,4735,1774,2599,1504,5451,16063
2022-08-03,27,2095,1003,2922,3123,5061,14204
2022-08-04,27,3297,1647,3796,3874,3745,16359
2022-08-05,27,2642,1058,3632,2243,2922,12497
2022-08-06,27,4609,1160,3652,2716,4075,16212
2022-08-07,27,2575,1822,1643,3913,2831,12784
2022-08-08,27,4878,2131,2554,3699,2161,15423
2022-08-09,27,1957,2609,3164,2926,4848,15504
2022-08-10,27,4635,1924,3332,2281,5326,17498
2022-08-11,27,1724,2316,2619,4042,5944,16645
2022-08-12,27,3393,2601,3672,4397,5407,19470
2022-08-13,27,4907,2432,2198,4162,2512,16211
2022-08-14,27,2453,915,2421,4135,2023,11947
2022-08-15,27,2018,2856,3845,2483,4932,16134
2022-08-16,27,4948,1909,3250,3853,5189,19149
2022-08-17,27,3509,1127,2043,3702,5482,15863
2022-08-18,27,4062,1768,2572,3168,4188,15758
2022-08-19,27,2181,1899,2710,4267,3013,14070
2022-08-20,27,1930,1789,2276,1588,4951,12534
2022-08-21,27,3824,2431,3888,4365,4442,18950
2022-08-22,27,1026,2157,2401,4345,4804,14733
2022-08-23,27,2365,2621,1861,2760,3149,12756
2022-08-24,27,2042,1231,3742,2040,5320,14375
2022-08-25,27,4765,2436,1365,2873,4086,15525
2022-08-26,27,1360,2467,1813,2751,4287,12678
2022-08-27,27,1358,2328,3042,2133,3779,12640
2022-08-28,27,4441,2019,2153,2786,4297,15696
2022-08-29,27,1734,1241,1483,1659,3647,9764
2022-08-30,27,1315,896,3299,4066,4930,14506
2022-08-31,27,2892,888,3679,3507,2839,13805
2022-09-01,27,1168,2552,2432,2218,4064,12434
2022-09-02,27,3385,1810,1667,3122,2925,12909
2022-09-03,27,2209,821,2334,2614,4873,12851
2022-09-04,27,2671,1807,3218,2203,4902,14801
2022-09-05,27,3910,2891,2987,1938,2805,14531
2022-09-06,27,3851,2414,2184,2063,2194,12706
2022-09-07,27,1558,895,1568,3622,5994,13637
2022-09-08,27,1839,1048,1829,4322,5848,14886
2022-09-09,27,1545,884,3639,2667,3924,12659
2022-09-10,27,3677,2300,3289,4125,5709,19100
2022-09-11,27,1935,1628,1883,2723,5870,14039
2022-09-12,27,2265,1985,2370,4210,3250,14080
2022-09-13,27,3410,853,1958,1851,5820,13892
2022-09-14,27,4015,2611,3910,3008,4741,18285
2022-09-15,27,3689,2429,3618,2338,4469,16543
2022-09-16,27,2537,967,3032,3771,3056,13363
2022-09-17,27,1806,2756,1300,4121,5533,15516
2022-09-18,27,4980,1607,1846,1640,2943,13016
2022-09-19,27,1982,2718,3988,3838,4899,17425
2022-09-20,27,3942,2476,1801,4383,5924,18526
2022-09-21,27,4824,2468,3734,3557,5773,20356
2022-09-22,27,1429,1442,3391,2463,4278,13003
2022-09-23,27,4032,2493,1344,3930,2388,14187
2022-09-24,27,1002,1419,3465,4107,3423,13416
2022-09-25,27,1335,2425,3496,1863,5733,14852
2022-09-26,27,4030,1015,3415,3684,3372,15516
2022-09-27,27,3165,1546,2673,4234,3767,15385
2022-09-28,27,1174,1904,1821,3648,4320,12867
2022-09-29,27,1090,877,2511,2927,2904,10309
2022-09-30,27,4004,2210,2337,1810,3264,13625
2022-10-01,27,4219,1261,2823,3068,2032,13403
2022-10-02,27,2764,2028,3158,4130,5298,17378
2022-10-03,27,3527,1361,3506,2643,4542,15579
2022-10-04,27,3533,2854,2235,1946,4084,14652
2022-10-05,27,2009,2021,3340,1978,3696,13044
2022-10-06,27,3344,1280,1771,2362,2932,11689
2022-10-07,27,4275,2980,3269,3708,4195,18427
2022-10-08,27,4753,2127,3180,2496,5018,17574
2022-10-09,27,2643,2750,3716,3052,3418,15579
2022-10-10,27,2873,2476,2938,2535,5922,16744
2022-10-11,27,4635,1229,3215,3354,3204,15637
2022-10-12,27,3866,1263,3920,2322,2927,14298
2022-10-13,27,3471,2597,2064,1784,2724,12640
2022-10-14,27,2070,2518,1766,1657,2885,10896
2022-10-15,27,2592,2712,1910,3316,2651,13181
2022-10-16,27,3744,2590,1943,1634,5337,15248
2022-10-17,27,2403,2802,2542,2372,2435,12554
2022-10-18,27,3312,1499,1283,2276,2297,10667
2022-10-19,27,3708,2992,1224,3253,3302,14479
2022-10-20,27,2614,1203,3786,1718,4002,13323
2022-10-21,27,1903,1868,1311,3457,4350,12889
2022-10-22,27,3229,1517,1204,4111,2214,12275
2022-10-23,27,3447,1337,2465,2534,4332,14115
2022-10-24,27,1895,957,1293,2280,2858,9283
2022-10-25,27,4775,1514,3787,2999,2825,15900
2022-10-26,27,3659,2418,3865,3352,2281,15575
2022-10-27,27,1555,1535,2423,2278,5781,13572
2022-10-28,27,2875,1642,2793,4419,5745,17474
2022-10-29,27,4784,2384,1341,2501,5209,16219
2022-10-30,27,2106,2072,1631,2660,2473,10942
2022-10-31,27,3290,1980,3948,2127,4402,15747
2022-11-01,27,1314,1081,3009,4131,2860,12395
2022-11-02,27,1387,2736,2246,2979,2346,11694
2022-11-03,27,1130,1598,2488,2384,2895,10495
2022-11-04,27,3148,1384,1895,4218,2346,12991
2022-11-05,27,2789,804,2732,1938,4503,12766
2022-11-06,27,3695,2467,1719,4174,4374,16429
2022-11-07,27,3718,1611,3424,3308,3028,15089
2022-11-08,27,4400,2531,3385,3842,4851,19009
2022-11-09,27,1203,2335,1490,2750,2823,10601
2022-11-10,27,4560,2370,2437,1613,4817,15797
2022-11-11,27,1194,2234,2982,3506,3714,13630
2022-11-12,27,3345,2863,1718,3573,4420,15919
2022-11-13,27,3671,888,2314,1832,5027,13732
2022-11-14,27,4787,1021,2463,2319,2802,13392
2022-11-15,27,2050,1652,1299,3055,2346,10402
2022-11-16,27,1161,1470,2005,4147,4386,13169
2022-11-17,27,4778,1588,3045,4289,2212,15912
2022-11-18,27,3187,2368,2493,3544,5738,17330
2022-11-19,27,3478,915,1964,1698,4279,12334
2022-11-20,27,4257,2234,3888,2282,4236,16897
2022-11-21,27,1656,1369,2224,2836,2333,10418
2022-11-22,27,2520,2695,3757,4412,4976,18360
2022-11-23,27,2311,1009,1200,1873,4471,10864
2022-11-24,27,1414,2696,2485,2202,2071,10868
2022-11-25,27,2042,2509,3383,2114,3368,13416
2022-11-26,27,3987,2628,2232,2484,4705,16036
2022-11-27,27,1689,2427,1343,3124,2616,11199
2022-11-28,27,2475,2703,1891,3612,5520,16201
2022-11-29,27,1692,1912,3917,1959,4903,14383
2022-11-30,27,3798,2830,3071,3232,5079,18010
2022-12-01,27,2980,2909,1983,4206,4280,16358
2022-12-02,27,3797,2976,2634,1753,5097,16257
2022-12-03,27,1454,2342,1613,4359,4391,14159
2022-12-04,27,2609,2797,1546,2301,4487,13740
2022-12-05,27,4929,2351,2882,3158,4142,17462
2022-12-06,27,1905,1424,3999,2678,3800,13806
2022-12-07,27,2869,2908,2269,3019,4087,15152
2022-12-08,27,2994,1991,1341,3782,5676,15784
2022-12-09,27,3565,1035,2935,2995,4078,14608
2022-12-10,27,3786,1766,3720,2664,5082,17018
2022-12-11,27,2089,915,1407,3665,2582,10658
2022-12-12,27,1970,1570,2206,4194,2556,12496
2022-12-13,27,2856,2446,3237,2163,2231,12933
2022-12-14,27,3042,1972,3373,3723,3536,15646
2022-12-15,27,2699,1966,2347,4007,3705,14724
2022-12-16,27,2270,1387,1646,1512,3253,10068
2022-12-17,27,4682,1324,2375,4073,5004,17458
2022-12-18,27,2651,2368,1341,1508,4232,12100
2022-12-19,27,2023,2928,3999,3579,2620,15149
2022-12-20,27,2039,2201,3983,2609,2959,13791
2022-12-21,27,4521,2829,3212,3592,4405,18559
2022-12-22,27,3234,1412,3036,3644,4628,15954
2022-12-23,27,2443,1220,3555,3975,2749,13942
2022-12-24,27,1560,953,1367,3310,4965,12155
2022-12-25,27,2084,2019,1667,3876,2532,12178
2022-12-26,27,1513,1424,2272,3963,5697,14869
2022-12-27,27,3744,1281,2436,2799,2055,12315
2022-12-28,27,2037,2143,1847,1900,2875,10802
2022-12-29,27,4060,2737,1953,2482,5528,16760
2022-12-30,27,3759,1815,1839,2509,4614,14536
2022-12-31,27,4028,1189,3087,3121,4218,15643
2023-01-01,27,2795,1966,1773,1815,2996,11345
2023-01-02,27,3919,1858,1574,3658,3980,14989
2023-01-03,27,2392,813,2451,3650,5837,15143
2023-01-04,27,2066,933,2413,3646,5303,14361
2023-01-05,27,2185,2487,2674,2167,3177,12690
2023-01-06,27,3319,1757,1264,1530,4331,12201
2023-01-07,27,1922,2917,3306,3090,4873,16108
2023-01-08,27,3192,2108,3727,2913,5602,17542
2023-01-09,27,1515,1321,3998,3214,3358,13406
2023-01-10,27,3894,1885,3031,2436,2201,13447
2023-01-11,27,2946,1697,1417,3012,5971,15043
2023-01-12,27,2371,2903,2327,4146,3069,14816
2023-01-13,27,4026,2929,1536,4377,4399,17267
2023-01-14,27,3607,1534,2746,2237,3398,13522
2023-01-15,27,4795,2238,3128,2384,3555,16100
2023-01-16,27,4045,1763,3869,4472,5212,19361
2023-01-17,27,3442,2024,3627,3027,3072,15192
2023-01-18,27,2948,2732,1643,3200,2957,13480
2023-01-19,27,1070,2152,1323,3120,5847,13512
2023-01-20,27,4825,2803,3114,3933,5753,20428
2023-01-21,27,2446,2277,2341,1755,3508,12327
2023-01-22,27,2051,2977,2233,3380,4060,14701
2023-01-23,27,1311,922,2179,2767,2094,9273
2023-01-24,27,3498,2211,2697,2684,4080,15170
2023-01-25,27,2958,2643,3019,3331,3795,15746
2023-01-26,27,2996,1026,3015,3868,2625,13530
2023-01-27,27,1063,2218,2057,2102,4442,11882
2023-01-28,27,2733,1513,1985,1917,4780,12928
2023-01-29,27,3522,899,1390,1594,5019,12424
2023-01-30,27,1954,1576,1686,4139,4909,14264
2023-01-31,27,2734,2172,3638,3499,2919,14962
2023-02-01,27,1311,2027,3792,3126,5270,15526
2023-02-02,27,1704,1517,3243,4302,2795,13561
2023-02-03,27,1375,2244,1997,2400,3048,11064
2023-02-04,27,1566,1728,1678,1693,2882,9547
2023-02-05,27,3697,2126,1563,3841,4690,15917
2023-02-06,27,3526,2298,3252,2791,4401,16268
2023-02-07,27,4516,1425,1204,4240,5585,16970
2023-02-08,27,3170,1699,2237,3492,4823,15421
2023-02-09,27,2361,1859,3093,2794,4482,14589
2023-02-10,27,4376,1178,2045,1890,5888,15377
2023-02-11,27,2431,2312,1680,1594,5757,13774
2023-02-12,27,1485,2862,1208,3017,4876,13448
2023-02-13,27,4784,967,2752,2661,2285,13449
2023-02-14,27,3276,1718,1648,1718,3273,11633
2023-02-15,27,1534,2286,2892,2558,3672,12942
2023-02-16,27,4482,1155,2280,3051,3349,14317
2023-02-17,27,2225,1491,3385,2345,3557,13003
2023-02-18,27,3422,2562,1390,4460,4508,16342
2023-02-19,27,3111,1313,1342,2307,4471,12544
2023-02-20,27,4013,2612,3672,2661,4986,17944
2023-02-21,27,2805,1649,3433,3191,3069,14147
2023-02-22,27,3705,1424,2072,2907,2527,12635
2023-02-23,27,3214,1062,1480,1864,5475,13095
2023-02-24,27,3366,1400,2785,1606,4426,13583
2023-02-25,27,1519,1620,3616,3679,4033,14467
2023-02-26,27,4578,2966,1415,4171,2053,15183
2023-02-27,27,1411,1173,3383,2821,3446,12234
2023-02-28,27,2003,2145,3968,3508,5835,17459
2023-03-01,27,3343,2049,2815,2474,4833,15514
2023-03-02,27,2981,2564,3623,3468,5701,18337
2023-03-03,27,1225,1956,2690,3126,4842,13839
2023-03-04,27,4960,990,2488,1692,4150,14280
2023-03-05,27,3918,1711,1302,4038,2080,13049
2023-03-06,27,2132,1835,2772,3683,5057,15479
2023-03-07,27,4151,2360,1553,3163,2059,13286
2023-03-08,27,1605,2792,3183,2145,3010,12735
2023-03-09,27,1224,1958,2143,1729,2037,9091
2023-03-10,27,1737,1506,1783,1646,3249,9921
2023-03-11,27,4904,1526,3802,2155,2070,14457
2023-03-12,27,2147,2263,3374,2676,3716,14176
2023-03-13,27,1908,2005,1686,2245,2078,9922
2023-03-14,27,3598,2922,3170,2099,5371,17160
2023-03-15,27,2777,1484,1275,1867,4148,11551
2023-03-16,27,4212,2024,3895,2344,3192,15667
2023-03-17,27,4924,2455,1825,1680,3990,14874
2023-03-18,27,2954,969,3553,2689,2752,12917
2023-03-19,27,2559,815,2079,3734,4311,13498
2023-03-20,27,4891,2849,2940,4347,4813,19840
2023-03-21,27,4877,2224,2765,4130,3053,17049
2023-03-22,27,4767,1154,2969,2121,2371,13382
2023-03-23,27,3245,1614,2421,3536,3472,14288
2023-03-24,27,3697,2531,3876,3553,2980,16637
2023-03-25,27,3534,1299,2656,3300,4090,14879
2023-03-26,27,4841,1217,3254,2042,5898,17252
2023-03-27,27,1034,2989,1339,3954,3182,12498
2023-03-28,27,3706,1370,3182,3489,3748,15495
2023-03-29,27,1817,2899,2146,3131,5449,15442
2023-03-30,27,3279,823,3653,1905,4291,13951
2023-03-31,27,2021,1755,3095,2757,4243,13871
2023-04-01,27,4334,2533,1685,2752,4266,15570
2023-04-02,27,2942,2431,3002,4351,5122,17848
2023-04-03,27,1378,1003,2739,3532,5169,13821
2023-04-04,27,4622,2597,2773,3123,4346,17461
2023-04-05,27,2479,2191,1588,2053,4847,13158
2023-04-06,27,4847,2210,1472,3804,2987,15320
2023-04-07,27,4962,2873,3885,2049,2486,16255
2023-04-08,27,2707,2992,3298,1564,2501,13062
2023-04-09,27,3431,1759,2691,1892,5366,15139
2023-04-10,27,2907,2204,3219,2165,4604,15099
2023-04-11,27,4512,2133,2415,2715,5317,17092
2023-04-12,27,4273,1497,3558,1785,4772,15885
2023-04-13,27,2938,965,3277,3899,5363,16442
2023-04-14,27,3487,2912,3857,3998,4646,18900
2023-04-15,27,1021,1852,1887,3763,5325,13848
2023-04-16,27,3287,2394,2441,3230,5289,16641
2023-04-17,27,3871,1412,3199,1866,3565,13913
2023-04-18,27,1391,1146,1492,4352,3223,11604
2023-04-19,27,1058,2338,1845,2974,3661,11876
2023-04-20,27,2292,1422,3572,4036,5294,16616
2023-04-21,27,4059,2881,3167,3901,3984,17992
2023-04-22,27,3750,1439,3638,3613,3576,16016
2023-04-23,27,4177,1659,2427,2933,3662,14858
2023-04-24,27,3687,1061,1762,2170,3792,12472
2023-04-25,27,1076,1481,1468,3287,4959,12271
2023-04-26,27,3143,1376,2567,2211,4246,13543
2023-04-27,27,4343,2285,1713,1950,4154,14445
2023-04-28,27,3355,1598,1549,4153,3878,14533
2023-04-29,27,2362,1399,2124,2012,5900,13797
2023-04-30,27,3341,2035,2488,2151,4786,14801
2023-05-01,27,3578,1548,3393,2379,4914,15812
2023-05-02,27,4334,1732,2458,4208,2243,14975
2023-05-03,27,4313,2384,2401,3531,2156,14785
2023-05-04,27,3471,1437,3141,2920,2867,13836
2023-05-05,27,4310,1096,2981,4119,2518,15024
2023-05-06,27,2764,2929,1819,2985,3109,13606
2023-05-07,27,2915,1457,1575,2907,3818,12672
2023-05-08,27,1371,1540,3927,2808,4650,14296
2023-05-09,27,1171,1718,1360,1686,4276,10211
2023-05-10,27,2677,2440,1452,2213,2345,11127
2023-05-11,27,4874,2677,2487,2189,2345,14572
2023-05-12,27,1659,2481,1604,3727,3579,13050
2023-05-13,27,3574,1771,3856,4029,2112,15342
2023-05-14,27,4015,2654,3647,2969,2728,16013
2023-05-15,27,4875,2407,3962,4256,2692,18192
2023-05-16,27,4221,2488,2563,2583,3587,15442
2023-05-17,27,2519,1486,3564,2748,5483,15800
2023-05-18,27,1635,1601,1273,4367,4101,12977
2023-05-19,27,1557,1987,1595,2144,5681,12964
2023-05-20,27,3317,1143,1637,2648,4137,12882
2023-05-21,27,1682,2821,3638,4160,4968,17269
2023-05-22,27,1995,1742,3746,2203,4233,13919
2023-05-23,27,4677,2186,2882,3364,4654,17763
2023-05-24,27,1550,1322,1438,4461,4016,12787
2023-05-25,27,4709,1933,2154,4102,3277,16175
2023-05-26,27,1959,1657,3351,1881,2963,11811
2023-05-27,27,1155,1897,2606,3581,2123,11362
2023-05-28,27,2449,1023,1755,2131,4409,11767
2023-05-29,27,2094,1203,3408,3318,3363,13386
2023-05-30,27,2680,1954,3724,3790,4722,16870
2023-05-31,27,3147,2122,2805,4054,3677,15805
2023-06-01,27,2229,1955,1237,4137,3530,13088
2023-06-02,27,2858,2541,2110,1681,3528,12718
2023-06-03,27,3864,2716,3279,3781,3297,16937
2023-06-04,27,3017,2538,1826,3633,5262,16276
2023-06-05,27,2146,851,2543,1872,3658,11070
2023-06-06,27,4536,1124,2596,2084,2331,12671
2023-06-07,27,1970,1847,1212,2879,4089,11997
2023-06-08,27,2188,1269,3838,3709,5651,16655
2023-06-09,27,4567,2754,1921,4165,2177,15584
2023-06-10,27,1707,2718,1576,4056,5422,15479
2023-06-11,27,3769,918,2437,3198,3886,14208
2023-06-12,27,1363,1200,2793,3885,3662,12903
2023-06-13,27,4324,1051,1287,3046,4693,14401
2023-06-14,27,1823,1699,3079,3159,4554,14314
2023-06-15,27,2592,2688,2410,2533,5713,15936
2023-06-16,27,2950,2922,2242,1566,4563,14243
2023-06-17,27,3533,1097,1286,3004,5928,14848
2023-06-18,27,3037,1602,2272,2241,4727,13879
2023-06-19,27,1950,1086,3602,2894,3792,13324
2023-06-20,27,4764,1396,2281,4173,3500,16114
2023-06-21,27,4159,2416,1541,3659,3920,15695
2023-06-22,27,2866,2586,2394,3952,5423,17221
2023-06-23,27,1690,2567,2960,3519,3883,14619
2023-06-24,27,2188,1337,2871,1871,2420,10687
2023-06-25,27,3794,815,2915,1989,2143,11656
2023-06-26,27,1889,1566,1731,3666,5624,14476
2023-06-27,27,2542,2215,2623,3908,4436,15724
2023-06-28,27,3684,2451,1593,4471,2463,14662
2023-06-29,27,2615,2970,1807,3167,2143,12702
2023-06-30,27,2634,1332,2980,1795,2391,11132
2023-07-01,27,2004,1125,1301,3476,2393,10299
2023-07-02,27,4177,2480,2325,4123,4985,18090
2023-07-03,27,1498,2431,3060,1551,4860,13400
2023-07-04,27,4315,1080,3025,4301,4944,17665
2023-07-05,27,1420,2714,3402,2655,3752,13943
2023-07-06,27,3546,2253,1859,1716,3940,13314
2023-07-07,27,4099,2516,2369,3785,5641,18410
2023-07-08,27,3604,2115,2503,2800,3969,14991
2023-07-09,27,3398,2988,3444,2005,3649,15484
2023-07-10,27,1093,1929,2536,3243,2162,10963
2023-07-11,27,3585,2575,2052,3772,4001,15985
2023-07-12,27,2114,2182,2608,2616,3977,13497
2023-07-13,27,2236,1025,3054,3245,4879,14439
2023-07-14,27,3117,1042,2930,1840,4800,13729
2023-07-15,27,3417,2836,2147,2331,4570,15301
2023-07-16,27,4415,2952,3418,4326,2909,18020
2023-07-17,27,4316,866,2110,4280,2412,13984
2023-07-18,27,2550,2345,2213,2550,3619,13277
2023-07-19,27,2980,2471,2215,3784,2232,13682
2023-07-20,27,2158,2756,1671,3748,4972,15305
2023-07-21,27,1248,1127,1856,1655,4060,9946
2023-07-22,27,3191,965,2106,4337,5114,15713
2023-07-23,27,2323,964,2233,2525,3065,11110
2023-07-24,27,4078,1140,3013,2517,4932,15680
2023-07-25,27,3375,2814,2150,3645,5770,17754
2023-07-26,27,1347,2810,3945,2775,5037,15914
2023-07-27,27,4928,959,3730,3946,5500,19063
2023-07-28,27,2369,1233,1411,1736,5196,11945
2023-07-29,27,4703,2266,3309,2239,4197,16714
2023-07-30,27,2496,2747,3902,2065,5163,16373
2023-07-31,27,3560,2964,3555,3340,3626,17045
2023-08-01,27,4984,1349,3824,4036,2949,17142
2023-08-02,27,2310,2287,3316,2037,5968,15918
2023-08-03,27,2218,1165,1319,1580,2290,8572
2023-08-04,27,4161,2561,1323,4250,2954,15249
2023-08-05,27,1075,2375,1333,2713,3002,10498
2023-08-06,27,2757,2789,3704,3547,4693,17490
2023-08-07,27,2137,1664,3828,3390,2449,13468
2023-08-08,27,2295,1408,2671,2644,2978,11996
2023-08-09,27,4967,2695,2733,4255,4840,19490
2023-08-10,27,2917,2304,3615,2036,2277,13149
2023-08-11,27,4108,2892,1614,2893,4878,16385
2023-08-12,27,3110,1776,2010,2751,5876,15523
2023-08-13,27,1145,2200,2146,1845,2465,9801
2023-08-14,27,3095,2743,3595,4150,3229,16812
2023-08-15,27,2393,828,1230,3183,2316,9950
2023-08-16,27,1792,2565,2338,1606,2758,11059
2023-08-17,27,1922,2815,2292,2631,4195,13855
2023-08-18,27,1845,2169,3986,2931,5337,16268
2023-08-19,27,3382,2070,3044,4086,3711,16293
2023-08-20,27,3983,2656,1246,2822,4664,15371
2023-08-21,27,4320,1202,2035,3269,3515,14341
2023-08-22,27,4413,895,3044,1864,4270,14486
2023-08-23,27,2049,2244,3328,1812,3382,12815
2023-08-24,27,4890,2386,2410,3528,2533,15747
2023-08-25,27,2850,1857,3383,3450,2149,13689
2023-08-26,27,3296,2224,3946,1719,4980,16165
2023-08-27,27,1592,1081,3185,2660,5529,14047
2023-08-28,27,1431,1371,3491,3792,2724,12809
2023-08-29,27,1643,1190,3203,3998,4050,14084
2023-08-30,27,4373,2293,2409,2260,3345,14680
2023-08-31,27,3827,1651,1777,2551,5310,15116
2023-09-01,27,2569,2838,2186,4471,4072,16136
2023-09-02,27,4490,2932,3589,3896,4127,19034
2023-09-03,27,2354,1117,3165,1909,4994,13539
2023-09-04,27,1979,1711,2897,2509,5051,14147
2023-09-05,27,2175,2661,2423,3642,2349,13250
2023-09-06,27,2892,2031,1243,3529,3962,13657
2023-09-07,27,3733,1635,1554,4274,3384,14580
2023-09-08,27,4320,2600,2947,1838,5017,16722
2023-09-09,27,1771,1859,3629,4261,2058,13578
2023-09-10,27,1647,1434,3700,3645,2201,12627
2023-09-11,27,4080,2703,3180,1573,4501,16037
2023-09-12,27,3393,979,1917,2830,5707,14826
2023-09-13,27,1037,2690,1828,2245,4370,12170
2023-09-14,27,3206,2516,1228,3030,5326,15306
2023-09-15,27,1274,2261,3990,2606,3940,14071
2023-09-16,27,3774,1663,1671,3218,4054,14380
2023-09-17,27,1773,1614,3025,1832,4217,12461
2023-09-18,27,1705,2179,2055,4164,2416,12519
2023-09-19,27,2712,1659,2387,1776,3780,12314
2023-09-20,27,3725,2223,3757,4321,4627,18653
2023-09-21,27,1572,2903,1372,2685,5166,13698
2023-09-22,27,2035,2666,3425,1946,3397,13469
2023-09-23,27,3425,2286,3085,2862,5304,16962
2023-09-24,27,3001,2216,3940,2900,2776,14833
2023-09-25,27,1504,1377,1452,3666,3166,11165
2023-09-26,27,3413,879,3545,1767,5343,14947
2023-09-27,27,4291,1756,1425,3564,2200,13236
2023-09-28,27,1418,2632,3670,3069,5351,16140
2023-09-29,27,1548,1038,3641,2841,4513,13581
2023-09-30,27,4120,2351,3452,4016,5830,19769
2023-10-01,27,4975,2232,1365,4047,5623,18242
2023-10-02,27,2661,2248,1832,3916,2550,13207
2023-10-03,27,2595,1499,1565,3553,2475,11687
2023-10-04,27,4458,2726,3887,3914,5987,20972
2023-10-05,27,3988,1821,3527,3866,4667,17869
2023-10-06,27,1392,1732,3123,3439,2014,11700
2023-10-07,27,3673,2989,3352,1665,3116,14795
2023-10-08,27,4457,1815,1835,2041,4397,14545
2023-10-09,27,2914,1460,1578,4165,5832,15949
2023-10-10,27,2415,2441,3460,3745,4774,16835
2023-10-11,27,4291,2716,2920,2946,3992,16865
2023-10-12,27,2766,1819,3281,1653,3087,12606
2023-10-13,27,1245,2771,2560,2680,3804,13060
2023-10-14,27,3755,2385,1850,2183,3569,13742
2023-10-15,27,1017,980,3270,2548,5166,12981
2023-10-16,27,2521,2068,2380,2790,4207,13966
2023-10-17,27,3763,1023,2840,4004,2052,13682
2023-10-18,27,2490,1984,3282,3586,3398,14740
2023-10-19,27,1193,2131,3609,3664,3294,13891
2023-10-20,27,3262,1627,2918,4096,2314,14217
2023-10-21,27,2932,2889,1792,2482,3713,13808
2023-10-22,27,3438,900,2638,4379,5371,16726
2023-10-23,27,2356,1289,1767,2750,5159,13321
2023-10-24,27,2950,1343,3885,4135,4988,17301
2023-10-25,27,4465,1384,2555,2757,5454,16615
2023-10-26,27,2399,1262,3420,3127,4089,14297
2023-10-27,27,1459,2466,1392,3717,5414,14448
2023-10-28,27,3487,2449,1419,1985,3646,12986
2023-10-29,27,3704,2258,2022,4137,2185,14306
2023-10-30,27,1940,1619,1967,2419,2381,10326
2023-10-31,27,4624,1069,1997,2576,5509,15775
2023-11-01,27,2824,2206,2536,3776,4894,16236
2023-11-02,27,3234,2758,3813,3566,5363,18734
2023-11-03,27,2617,1607,1485,3610,3429,12748
2023-11-04,27,2992,1924,3243,2969,2822,13950
2023-11-05,27,1935,2171,2384,3566,2210,12266
2023-11-06,27,4281,1519,2908,3607,2043,14358
2023-11-07,27,4210,814,3489,1551,4321,14385
2023-11-08,27,2914,1542,3117,3212,4616,15401
2023-11-09,27,2759,855,3659,3173,5663,16109
2023-11-10,27,2475,1336,1477,4307,3703,13298
2023-11-11,27,4332,2354,3467,4011,5973,20137
2023-11-12,27,3936,860,2299,3288,5372,15755
2023-11-13,27,2416,1034,3196,2879,4758,14283
2023-11-14,27,3378,2484,1520,1769,4105,13256
2023-11-15,27,3946,1303,2024,4048,2912,14233
2023-11-16,27,4193,1254,1313,1543,3909,12212
2023-11-17,27,1391,2003,1613,3924,3800,12731
2023-11-18,27,4207,2605,2908,1645,4910,16275
2023-11-19,27,4535,1859,2286,1657,2347,12684
2023-11-20,27,1313,1385,1588,3384,4115,11785
2023-11-21,27,3296,2739,3408,3056,5437,17936
2023-11-22,27,3474,1198,2402,2059,4224,13357
2023-11-23,27,4987,2113,1431,2183,3170,13884
2023-11-24,27,3998,2321,3544,2170,5738,17771
2023-11-25,27,2535,1223,3891,1858,3105,12612
2023-11-26,27,1565,895,3823,1635,2644,10562
2023-11-27,27,4653,2499,2283,3777,2096,15308
2023-11-28,27,2104,2507,2913,3995,4335,15854
2023-11-29,27,3709,2899,2233,2057,3745,14643
2023-11-30,27,4211,2212,2117,2504,4862,15906
2023-12-01,27,3606,1117,3378,2891,5779,16771
2023-12-02,27,1240,1303,1587,4089,5925,14144
2023-12-03,27,3213,1818,3747,2952,2864,14594
2023-12-04,27,2737,2049,1620,1572,5823,13801
2023-12-05,27,4901,1367,2989,2124,3221,14602
2023-12-06,27,4677,2963,1393,1590,3302,13925
2023-12-07,27,3161,2016,3248,3075,2190,13690
2023-12-08,27,2435,1062,2401,4123,5499,15520
2023-12-09,27,4260,2292,3960,2435,3715,16662
2023-12-10,27,3882,1810,3722,1929,5105,16448
2023-12-11,27,2636,2633,2322,3598,3387,14576
2023-12-12,27,3921,1682,2942,2281,4986,15812
2023-12-13,27,4561,1035,2552,3373,5524,17045
2023-12-14,27,1523,856,2917,2024,4188,11508
2023-12-15,27,2605,1279,3080,3033,3957,13954
2023-12-16,27,1380,1346,1831,1916,2777,9250
2023-12-17,27,3403,1121,3682,4429,2946,15581
2023-12-18,27,3866,1522,3148,1535,2088,12159
2023-12-19,27,1804,1551,3520,2535,3633,13043
2023-12-20,27,2112,2973,1447,3468,2998,12998
2023-12-21,27,3373,1923,1821,4034,3402,14553
2023-12-22,27,4529,1991,3004,3748,2083,15355
2023-12-23,27,3455,1916,3579,3186,3447,15583
2023-12-24,27,4777,1522,3488,3404,5490,18681
2023-12-25,27,3379,1802,2588,2187,5507,15463
2023-12-26,27,4444,2904,2436,2486,5424,17694
2023-12-27,27,4440,2282,1238,4308,3504,15772
2023-12-28,27,4186,1680,1847,3550,5160,16423
2023-12-29,27,2425,2522,3757,3342,4584,16630
2023-12-30,27,1705,1365,2759,2358,4059,12246
2023-12-31,27,3680,902,1883,3375,3064,12904
2022-01-01,28,1271,1298,1693,1995,5392,11649
2022-01-02,28,1019,1640,3147,3159,3911,12876
2022-01-03,28,1665,2291,1508,3609,4269,13342
2022-01-04,28,2577,1368,3287,2230,5981,15443
2022-01-05,28,3324,1700,3385,3261,5497,17167
2022-01-06,28,2803,2703,3103,1797,4026,14432
2022-01-07,28,2427,1170,2379,1712,4425,12113
2022-01-08,28,3077,2570,2169,3098,3817,14731
2022-01-09,28,1982,2094,2155,3879,4709,14819
2022-01-10,28,4330,2324,3869,4135,4508,19166
2022-01-11,28,2558,2235,3728,2323,3212,14056
2022-01-12,28,1250,2260,3794,3171,2424,12899
2022-01-13,28,4595,988,1458,2341,2257,11639
2022-01-14,28,1167,1887,1851,3342,3604,11851
2022-01-15,28,3396,1052,1258,2110,2082,9898
2022-01-16,28,1913,1740,2600,2888,4740,13881
2022-01-17,28,4080,2827,2645,3964,2420,15936
2022-01-18,28,4779,1356,1780,3420,5125,16460
2022-01-19,28,1239,1494,2992,3722,4122,13569
2022-01-20,28,3826,2107,2827,1564,3133,13457
2022-01-21,28,2641,1317,3063,3932,4212,15165
2022-01-22,28,1222,1160,2128,1941,5350,11801
2022-01-23,28,1383,2919,3362,4046,5078,16788
2022-01-24,28,1564,2747,2931,4202,4837,16281
2022-01-25,28,3155,2856,1672,1696,4811,14190
2022-01-26,28,4502,1763,3944,3608,3159,16976
2022-01-27,28,3510,2803,2578,3432,4502,16825
2022-01-28,28,1506,2944,3486,4465,2507,14908
2022-01-29,28,1602,1820,1543,1812,3596,10373
2022-01-30,28,4024,2759,1640,2246,5092,15761
2022-01-31,28,3820,1914,1679,1642,5416,14471
2022-02-01,28,1743,1364,2278,4221,4646,14252
2022-02-02,28,1671,982,3714,2886,2616,11869
2022-02-03,28,1480,850,2329,1622,3082,9363
2022-02-04,28,2058,1684,3022,4265,5028,16057
2022-02-05,28,2685,820,1726,2825,5768,13824
2022-02-06,28,4929,2873,3492,2648,4858,18800
2022-02-07,28,1535,2128,2402,2414,4093,12572
2022-02-08,28,3139,933,3683,1544,2747,12046
2022-02-09,28,4813,1281,3194,1990,2979,14257
2022-02-10,28,2794,1505,3657,2808,5173,15937
2022-02-11,28,3055,2277,1642,2428,3543,12945
2022-02-12,28,4457,912,1922,2326,3455,13072
2022-02-13,28,4459,1952,3186,3312,4657,17566
2022-02-14,28,4690,1651,3069,3591,3197,16198
2022-02-15,28,2006,1509,1584,2282,5870,13251
2022-02-16,28,3337,2364,3654,4278,4050,17683
2022-02-17,28,3416,1496,3462,4310,2983,15667
2022-02-18,28,2292,2759,1760,4322,2944,14077
2022-02-19,28,4026,2484,3372,1598,3581,15061
2022-02-20,28,1310,1297,2381,2031,5044,12063
2022-02-21,28,3122,2196,3822,3834,3971,16945
2022-02-22,28,3559,2429,1537,2199,4993,14717
2022-02-23,28,3437,1350,2581,1991,2242,11601
2022-02-24,28,2817,2495,2199,3736,4561,15808
2022-02-25,28,1147,1359,3510,3055,2141,11212
2022-02-26,28,1327,2563,1658,1794,5531,12873
2022-02-27,28,4851,1884,1863,3415,4489,16502
2022-02-28,28,2747,959,1491,3558,5847,14602
2022-03-01,28,2832,1773,3966,1894,3145,13610
2022-03-02,28,4214,1432,2273,1983,4116,14018
2022-03-03,28,2051,1759,1883,4050,3472,13215
2022-03-04,28,3589,1085,2616,3082,3355,13727
2022-03-05,28,3239,960,3725,3666,4350,15940
2022-03-06,28,2198,1661,2211,3236,2235,11541
2022-03-07,28,4012,938,3214,2655,4314,15133
2022-03-08,28,4702,988,3320,2170,2097,13277
2022-03-09,28,1403,1222,3653,3885,5535,15698
2022-03-10,28,2420,2700,2646,3739,2593,14098
2022-03-11,28,1238,2113,2609,2908,2746,11614
2022-03-12,28,4333,853,2142,4456,3645,15429
2022-03-13,28,1808,1505,3735,1598,5349,13995
2022-03-14,28,1196,1684,3070,2351,3439,11740
2022-03-15,28,2798,2858,3678,4227,5961,19522
2022-03-16,28,4744,2247,3248,4355,2282,16876
2022-03-17,28,1208,2044,3118,3738,3809,13917
2022-03-18,28,1004,2178,3887,4426,5145,16640
2022-03-19,28,3572,2420,3613,3019,4667,17291
2022-03-20,28,4614,2899,2863,4467,5220,20063
2022-03-21,28,3604,2192,1460,2272,2935,12463
2022-03-22,28,3502,2054,1268,1505,3723,12052
2022-03-23,28,4531,2811,2401,3871,5953,19567
2022-03-24,28,3472,2900,3464,2633,5645,18114
2022-03-25,28,1320,2362,2193,1962,5818,13655
2022-03-26,28,3981,1540,2801,3841,5954,18117
2022-03-27,28,2099,2510,3922,3244,5842,17617
2022-03-28,28,3020,1859,3418,4373,5335,18005
2022-03-29,28,2010,1022,1628,4488,3574,12722
2022-03-30,28,1806,871,3928,2553,3720,12878
2022-03-31,28,3723,1367,1272,2806,4795,13963
2022-04-01,28,2359,1495,2341,3145,3330,12670
2022-04-02,28,1018,2337,3292,3709,3111,13467
2022-04-03,28,1531,1105,1279,3211,2788,9914
2022-04-04,28,2233,1893,1622,3889,4238,13875
2022-04-05,28,2169,1309,2907,1970,5231,13586
2022-04-06,28,1864,1789,2256,2760,3389,12058
2022-04-07,28,1777,2300,2200,1598,2764,10639
2022-04-08,28,2603,1558,3252,3881,2340,13634
2022-04-09,28,2574,2232,3496,3901,3432,15635
2022-04-10,28,4870,1197,1881,3321,4072,15341
2022-04-11,28,3484,1586,2056,1889,5702,14717
2022-04-12,28,4953,1194,1713,4325,5505,17690
2022-04-13,28,3319,1713,1784,4298,3371,14485
2022-04-14,28,1628,1034,3470,1646,3845,11623
2022-04-15,28,3281,1193,2833,4295,3419,15021
2022-04-16,28,2805,1077,2032,1506,4184,11604
2022-04-17,28,2670,2492,2191,3368,2846,13567
2022-04-18,28,3137,1337,3158,3644,5043,16319
2022-04-19,28,4048,1969,2581,2418,5334,16350
2022-04-20,28,3210,927,1987,1792,5024,12940
2022-04-21,28,2207,2666,3729,2738,5440,16780
2022-04-22,28,2142,2143,3322,2161,3698,13466
2022-04-23,28,4698,983,1774,3493,3486,14434
2022-04-24,28,1645,2882,3387,3384,5896,17194
2022-04-25,28,2001,1502,3935,3228,5967,16633
2022-04-26,28,3156,2293,1913,3618,5281,16261
2022-04-27,28,4530,2012,2357,2030,5703,16632
2022-04-28,28,4055,849,3736,1787,5572,15999
2022-04-29,28,2658,1971,3751,4118,3192,15690
2022-04-30,28,1538,1392,2084,2430,3392,10836
2022-05-01,28,2698,2014,3208,2884,3759,14563
2022-05-02,28,3532,898,3086,3003,3390,13909
2022-05-03,28,3364,2018,1547,4331,4824,16084
2022-05-04,28,4631,1411,1620,3909,3694,15265
2022-05-05,28,4016,2091,2314,2619,3893,14933
2022-05-06,28,4357,2279,3569,2111,4351,16667
2022-05-07,28,4601,1361,3541,4044,5152,18699
2022-05-08,28,2898,2006,1720,3800,4534,14958
2022-05-09,28,2592,2828,1580,1762,5522,14284
2022-05-10,28,2689,1673,3012,3984,3687,15045
2022-05-11,28,1027,1140,1591,4424,4369,12551
2022-05-12,28,3408,2886,3247,4383,5920,19844
2022-05-13,28,3975,2931,2618,2994,3496,16014
2022-05-14,28,2708,2759,1507,3868,4678,15520
2022-05-15,28,2792,2043,1979,4225,3784,14823
2022-05-16,28,4264,822,2625,2113,4741,14565
2022-05-17,28,4512,2764,2834,3219,3953,17282
2022-05-18,28,3455,1268,1675,4308,4347,15053
2022-05-19,28,3564,998,3008,2686,3283,13539
2022-05-20,28,4347,1242,2296,2172,4827,14884
2022-05-21,28,2520,2180,2696,2264,5070,14730
2022-05-22,28,2972,2913,2758,4333,2635,15611
2022-05-23,28,2821,1146,1375,2483,4013,11838
2022-05-24,28,2703,2134,2992,2735,2440,13004
2022-05-25,28,2411,1255,1727,4311,4893,14597
2022-05-26,28,4799,949,3559,3541,4267,17115
2022-05-27,28,2272,1472,3866,3857,3529,14996
2022-05-28,28,1479,1928,2892,2538,5977,14814
2022-05-29,28,1679,1728,3779,2015,4723,13924
2022-05-30,28,1951,1191,3138,2499,4302,13081
2022-05-31,28,4934,1102,2903,2459,2441,13839
2022-06-01,28,2859,1246,2242,2610,2785,11742
2022-06-02,28,1139,2118,3333,4399,5573,16562
2022-06-03,28,1766,2739,2895,3183,2050,12633
2022-06-04,28,2164,1375,2990,2800,3951,13280
2022-06-05,28,2449,2436,2893,1646,4180,13604
2022-06-06,28,4507,2660,3121,3231,5255,18774
2022-06-07,28,3329,1736,2923,3069,5691,16748
2022-06-08,28,2402,1298,2902,2886,4844,14332
2022-06-09,28,2267,2717,3233,3984,4082,16283
2022-06-10,28,3646,1280,3944,2085,3498,14453
2022-06-11,28,1000,1924,1330,2042,4306,10602
2022-06-12,28,2161,921,1891,4478,5973,15424
2022-06-13,28,4336,2896,1957,3553,3211,15953
2022-06-14,28,3485,2751,1854,3701,2151,13942
2022-06-15,28,4405,1361,1391,2649,5723,15529
2022-06-16,28,4063,1075,3465,3514,5600,17717
2022-06-17,28,1314,970,3098,4248,4513,14143
2022-06-18,28,4619,1205,2450,2187,4611,15072
2022-06-19,28,1231,2773,2781,4335,5867,16987
2022-06-20,28,3660,2715,2689,2358,2900,14322
2022-06-21,28,1773,1093,2161,2898,4346,12271
2022-06-22,28,3448,2389,3931,2063,3653,15484
2022-06-23,28,4776,2310,2092,3741,4317,17236
2022-06-24,28,2511,2659,1795,3527,4881,15373
2022-06-25,28,3159,1244,2423,2582,3407,12815
2022-06-26,28,2510,2806,3874,1952,2810,13952
2022-06-27,28,4550,1598,1543,2655,5823,16169
2022-06-28,28,3144,1402,2464,2722,5733,15465
2022-06-29,28,3140,1987,1603,4241,4948,15919
2022-06-30,28,1449,2104,3994,2947,4109,14603
2022-07-01,28,3530,2199,3805,1831,3690,15055
2022-07-02,28,3636,824,2909,2030,2017,11416
2022-07-03,28,4380,1676,2908,3370,4007,16341
2022-07-04,28,3121,1360,1278,2236,3004,10999
2022-07-05,28,2602,1345,3982,4394,4982,17305
2022-07-06,28,1768,2184,3552,1588,5241,14333
2022-07-07,28,1407,2887,2407,3324,4175,14200
2022-07-08,28,1987,1010,2108,3405,3316,11826
2022-07-09,28,3438,1779,1370,3334,3915,13836
2022-07-10,28,1602,1515,3962,2135,5518,14732
2022-07-11,28,1301,1365,2777,1673,5759,12875
2022-07-12,28,3438,1162,3682,3129,5704,17115
2022-07-13,28,2219,1538,1636,3649,2781,11823
2022-07-14,28,1622,2446,2481,3908,3211,13668
2022-07-15,28,4677,2826,3834,3337,3507,18181
2022-07-16,28,1821,1148,3151,2458,2435,11013
2022-07-17,28,4495,2456,3680,2763,4704,18098
2022-07-18,28,2671,1488,1730,3157,4586,13632
2022-07-19,28,1869,1949,1944,3314,3418,12494
2022-07-20,28,1952,1808,1464,2341,5829,13394
2022-07-21,28,2528,2159,3739,1920,3094,13440
2022-07-22,28,2145,2376,2961,2617,2274,12373
2022-07-23,28,1380,1758,1664,3427,3873,12102
2022-07-24,28,1051,2631,1284,4382,5456,14804
2022-07-25,28,1728,1865,1449,1905,2944,9891
2022-07-26,28,3805,1375,1685,2243,2832,11940
2022-07-27,28,2234,1683,3613,4042,5210,16782
2022-07-28,28,1204,2832,1746,2779,2014,10575
2022-07-29,28,2748,1272,1892,3708,4474,14094
2022-07-30,28,2230,1794,2368,4188,5390,15970
2022-07-31,28,3569,2896,2173,2506,3079,14223
2022-08-01,28,4972,2738,2009,2053,5657,17429
2022-08-02,28,3167,993,1863,2874,5153,14050
2022-08-03,28,1444,2120,1757,4023,2393,11737
2022-08-04,28,2918,881,3971,3587,4155,15512
2022-08-05,28,4340,1142,3960,2272,5624,17338
2022-08-06,28,2751,2356,2061,4086,4991,16245
2022-08-07,28,2938,972,1534,4438,2438,12320
2022-08-08,28,3820,1831,3751,1675,4796,15873
2022-08-09,28,2078,2952,2780,3373,3003,14186
2022-08-10,28,4569,2732,3701,2527,5532,19061
2022-08-11,28,1145,2927,2608,3428,2677,12785
2022-08-12,28,1397,1952,2181,2360,4834,12724
2022-08-13,28,2049,2248,2432,3077,4005,13811
2022-08-14,28,4995,2514,2179,1575,4296,15559
2022-08-15,28,1850,1740,2252,4022,3620,13484
2022-08-16,28,3957,900,3547,2398,5535,16337
2022-08-17,28,2858,1062,3072,3840,4160,14992
2022-08-18,28,1452,2180,2328,1706,2719,10385
2022-08-19,28,1524,2372,1976,1565,3160,10597
2022-08-20,28,1753,2427,2561,2615,4266,13622
2022-08-21,28,3542,989,1691,2900,4086,13208
2022-08-22,28,1006,1452,2550,4165,2039,11212
2022-08-23,28,4571,2776,2796,3163,3436,16742
2022-08-24,28,4211,1524,2151,2102,5232,15220
2022-08-25,28,3681,1172,1210,2224,3478,11765
2022-08-26,28,3356,2494,2441,4275,3231,15797
2022-08-27,28,2715,1115,3391,3060,4547,14828
2022-08-28,28,4265,2382,3599,1566,4045,15857
2022-08-29,28,1839,2627,1456,4454,3180,13556
2022-08-30,28,2676,1278,1795,2309,2207,10265
2022-08-31,28,2791,936,2516,2168,4764,13175
2022-09-01,28,1398,1124,2868,2669,2870,10929
2022-09-02,28,1518,1483,2685,2652,5724,14062
2022-09-03,28,2721,1143,1434,1635,5003,11936
2022-09-04,28,1896,1804,3073,3568,4205,14546
2022-09-05,28,1463,2995,1659,4260,5599,15976
2022-09-06,28,4878,2173,3694,3821,3578,18144
2022-09-07,28,2037,1875,3090,3958,5755,16715
2022-09-08,28,1171,2780,2183,3518,2996,12648
2022-09-09,28,2680,1907,1262,1612,4168,11629
2022-09-10,28,2478,1303,3038,3740,2636,13195
2022-09-11,28,2656,2083,1375,3648,5722,15484
2022-09-12,28,1976,1692,1805,2879,2324,10676
2022-09-13,28,3855,2947,3934,4017,5261,20014
2022-09-14,28,1438,1027,1534,1800,4584,10383
2022-09-15,28,4276,1616,2690,2812,5381,16775
2022-09-16,28,2424,1295,2975,1612,2771,11077
2022-09-17,28,2185,1666,2340,3607,4462,14260
2022-09-18,28,3261,1555,2475,2606,4076,13973
2022-09-19,28,1466,1209,3212,4378,5594,15859
2022-09-20,28,2449,851,1857,1787,5755,12699
2022-09-21,28,2641,1650,1243,3243,2421,11198
2022-09-22,28,4541,1751,2420,3922,4524,17158
2022-09-23,28,4712,2724,2121,1888,4050,15495
2022-09-24,28,2469,841,1361,2277,2032,8980
2022-09-25,28,3277,1475,2837,3162,5001,15752
2022-09-26,28,3905,1874,1963,3392,2076,13210
2022-09-27,28,2973,2384,2642,2835,3327,14161
2022-09-28,28,1206,2862,3613,2541,3401,13623
2022-09-29,28,3585,1060,1993,3936,4695,15269
2022-09-30,28,2680,2123,2996,2922,2826,13547
2022-10-01,28,1301,2142,1810,4101,5439,14793
2022-10-02,28,1302,2788,1895,3646,5539,15170
2022-10-03,28,1606,2500,2218,2994,4361,13679
2022-10-04,28,3698,2366,1445,4430,3062,15001
2022-10-05,28,3311,1248,2136,3321,5915,15931
2022-10-06,28,1522,2959,2141,1661,3550,11833
2022-10-07,28,4203,2740,2423,3521,2094,14981
2022-10-08,28,3332,2780,3776,1535,4013,15436
2022-10-09,28,4350,1105,3858,3170,5629,18112
2022-10-10,28,4692,1205,3616,3900,5060,18473
2022-10-11,28,1455,1486,2109,1760,4625,11435
2022-10-12,28,1020,1572,2395,2900,5256,13143
2022-10-13,28,3747,2318,2069,3044,3098,14276
2022-10-14,28,1622,1933,2341,3706,3221,12823
2022-10-15,28,4850,2566,2485,1841,5908,17650
2022-10-16,28,1045,1698,1399,4414,5309,13865
2022-10-17,28,4468,1179,1784,3983,4034,15448
2022-10-18,28,1676,2871,3066,2342,4889,14844
2022-10-19,28,3219,2794,1660,2384,4922,14979
2022-10-20,28,3091,1995,3129,2927,5263,16405
2022-10-21,28,2262,869,1603,2753,4297,11784
2022-10-22,28,3163,1761,1499,3436,3905,13764
2022-10-23,28,4688,886,3485,1582,4358,14999
2022-10-24,28,2321,1984,3163,4327,4310,16105
2022-10-25,28,1623,1165,1302,3284,3277,10651
2022-10-26,28,2763,2989,3326,4462,4176,17716
2022-10-27,28,1969,1936,2892,2476,4188,13461
2022-10-28,28,3939,1664,1560,3303,2906,13372
2022-10-29,28,3134,2658,1297,1991,4810,13890
2022-10-30,28,2084,2384,2236,3133,2017,11854
2022-10-31,28,3064,2705,2029,1789,3476,13063
2022-11-01,28,3032,1624,3938,1529,5353,15476
2022-11-02,28,3581,2636,3433,1784,3052,14486
2022-11-03,28,4448,1833,2590,4393,5677,18941
2022-11-04,28,3849,897,2767,1888,4938,14339
2022-11-05,28,2823,1641,1450,1750,2767,10431
2022-11-06,28,4043,1331,1366,4090,5784,16614
2022-11-07,28,3861,1665,2632,2960,2771,13889
2022-11-08,28,4734,988,1425,2649,2155,11951
2022-11-09,28,4821,2255,3649,2150,4516,17391
2022-11-10,28,4129,2466,3611,2906,3065,16177
2022-11-11,28,3134,1684,1894,4303,2643,13658
2022-11-12,28,4617,1609,3637,3518,2332,15713
2022-11-13,28,1234,1637,1275,2454,5068,11668
2022-11-14,28,3293,2863,2268,2663,5519,16606
2022-11-15,28,1757,1252,1536,4075,5211,13831
2022-11-16,28,3567,1021,3730,3142,2625,14085
2022-11-17,28,4372,843,1870,2941,2845,12871
2022-11-18,28,1706,1477,3656,3748,3175,13762
2022-11-19,28,3795,1201,2241,2994,2527,12758
2022-11-20,28,4905,2733,1331,4130,3815,16914
2022-11-21,28,2372,1380,3115,4111,2277,13255
2022-11-22,28,2233,1820,1727,3040,3333,12153
2022-11-23,28,1900,908,1455,2294,5207,11764
2022-11-24,28,3757,2714,3792,2251,5070,17584
2022-11-25,28,3725,891,3729,2227,4067,14639
2022-11-26,28,2698,1022,2043,3507,5216,14486
2022-11-27,28,1600,1416,2000,1757,3116,9889
2022-11-28,28,2093,2948,1281,4400,4599,15321
2022-11-29,28,2925,1071,1353,4393,5017,14759
2022-11-30,28,4236,2343,3135,2695,2104,14513
2022-12-01,28,1062,2640,1969,4490,2792,12953
2022-12-02,28,1436,2129,2290,1670,4164,11689
2022-12-03,28,2348,1115,2202,2308,4316,12289
2022-12-04,28,2091,1961,2994,4100,3418,14564
2022-12-05,28,4332,2355,2366,2869,3547,15469
2022-12-06,28,1498,802,1674,1953,5391,11318
2022-12-07,28,1104,1572,2619,1574,5227,12096
2022-12-08,28,2844,1252,3901,2809,5501,16307
2022-12-09,28,3349,1805,1507,2198,2340,11199
2022-12-10,28,2275,2114,2912,2417,5293,15011
2022-12-11,28,1754,2707,3373,4275,5322,17431
2022-12-12,28,3636,1370,2961,3782,4805,16554
2022-12-13,28,2055,2227,3968,4179,5281,17710
2022-12-14,28,4074,1227,1958,2872,3586,13717
2022-12-15,28,1980,2546,3841,2913,2707,13987
2022-12-16,28,2816,1139,2126,3210,2468,11759
2022-12-17,28,3388,1100,2608,1649,3346,12091
2022-12-18,28,1488,1302,2694,2057,4791,12332
2022-12-19,28,4360,1035,2500,1863,4848,14606
2022-12-20,28,1647,2476,3964,1865,5349,15301
2022-12-21,28,2840,1073,1324,4045,3565,12847
2022-12-22,28,1642,2889,3143,2807,5253,15734
2022-12-23,28,1169,1986,2704,2455,5434,13748
2022-12-24,28,2790,865,2903,2601,2437,11596
2022-12-25,28,3739,1097,2411,3472,3494,14213
2022-12-26,28,4781,2610,1913,3947,4008,17259
2022-12-27,28,3777,1807,1414,4481,5740,17219
2022-12-28,28,4888,1293,3849,2654,2514,15198
2022-12-29,28,1163,2982,2477,3049,2126,11797
2022-12-30,28,1304,1028,1542,4440,3902,12216
2022-12-31,28,3979,1764,1654,3658,5109,16164
2023-01-01,28,4276,2308,1585,3885,3837,15891
2023-01-02,28,4497,1266,2800,3014,3608,15185
2023-01-03,28,2975,1899,2882,2733,3138,13627
2023-01-04,28,2507,1189,1547,3941,3881,13065
2023-01-05,28,1102,2696,1320,3429,2137,10684
2023-01-06,28,4691,2373,1684,2273,2679,13700
2023-01-07,28,4366,1697,2538,1596,2607,12804
2023-01-08,28,4417,1730,3375,3846,3879,17247
2023-01-09,28,3841,1170,1788,2752,5867,15418
2023-01-10,28,3367,2319,3291,3790,4907,17674
2023-01-11,28,3365,1441,3801,3529,2847,14983
2023-01-12,28,1945,2150,2753,4236,3092,14176
2023-01-13,28,2152,2696,1467,2236,5435,13986
2023-01-14,28,3996,2906,2121,2109,4939,16071
2023-01-15,28,3724,1029,1334,2358,2100,10545
2023-01-16,28,1742,2959,1983,4298,4093,15075
2023-01-17,28,1596,1630,3490,3910,5918,16544
2023-01-18,28,1831,1612,2743,1771,2201,10158
2023-01-19,28,2229,1542,2301,3162,3930,13164
2023-01-20,28,4226,1511,2491,2938,5794,16960
2023-01-21,28,4133,1436,1262,2466,4260,13557
2023-01-22,28,3823,2391,2325,2507,5705,16751
2023-01-23,28,1522,2191,2429,1825,2746,10713
2023-01-24,28,4969,1420,1523,3119,3116,14147
2023-01-25,28,3506,1442,2852,3404,3607,14811
2023-01-26,28,2130,1703,3918,2898,5588,16237
2023-01-27,28,1505,2271,3762,4493,2181,14212
2023-01-28,28,3222,2255,1282,2527,2095,11381
2023-01-29,28,4339,2262,1622,2643,4985,15851
2023-01-30,28,2097,1752,2004,2953,5022,13828
2023-01-31,28,4882,1356,1763,3661,4102,15764
2023-02-01,28,2349,1105,2546,2551,5198,13749
2023-02-02,28,3989,2029,2506,2655,2459,13638
2023-02-03,28,3511,1848,2065,1944,2001,11369
2023-02-04,28,4381,1746,3229,2977,5669,18002
2023-02-05,28,1554,2862,1922,3839,5544,15721
2023-02-06,28,4766,2369,3282,1524,5734,17675
2023-02-07,28,1772,1342,3162,3449,5202,14927
2023-02-08,28,4312,925,2173,4331,2586,14327
2023-02-09,28,4503,2038,2717,2513,4755,16526
2023-02-10,28,1745,1548,2810,3335,5300,14738
2023-02-11,28,1477,1354,1587,2752,2117,9287
2023-02-12,28,3532,1844,2966,2402,4364,15108
2023-02-13,28,2781,2032,3491,1687,3050,13041
2023-02-14,28,3654,2449,2384,3886,2786,15159
2023-02-15,28,1914,1508,1522,3560,4482,12986
2023-02-16,28,2479,2576,3375,3720,5958,18108
2023-02-17,28,4258,2276,3092,3617,5659,18902
2023-02-18,28,1118,2837,3196,1565,4477,13193
2023-02-19,28,1152,1446,1412,3231,4711,11952
2023-02-20,28,2463,1721,1760,3117,4125,13186
2023-02-21,28,4356,2694,2860,1643,5562,17115
2023-02-22,28,3129,944,3040,2518,5173,14804
2023-02-23,28,3426,1141,3700,2959,2120,13346
2023-02-24,28,4650,1417,3479,3050,5040,17636
2023-02-25,28,2144,2721,2958,3052,3512,14387
2023-02-26,28,4660,1317,3868,4195,5599,19639
2023-02-27,28,2908,897,2235,2560,4837,13437
2023-02-28,28,2183,2014,2088,3726,2331,12342
2023-03-01,28,1006,1944,2518,2853,5173,13494
2023-03-02,28,3465,1053,1612,1911,5461,13502
2023-03-03,28,3266,1772,3412,2843,5313,16606
2023-03-04,28,3678,1739,2364,3235,5755,16771
2023-03-05,28,4703,833,3955,2304,4103,15898
2023-03-06,28,3386,2391,2543,1884,5830,16034
2023-03-07,28,4583,1649,3097,2064,5243,16636
2023-03-08,28,3978,2833,3922,4025,2445,17203
2023-03-09,28,4321,875,2577,3459,4313,15545
2023-03-10,28,2907,884,2910,3307,2010,12018
2023-03-11,28,3735,1045,2519,2114,4642,14055
2023-03-12,28,2524,987,3350,3969,4071,14901
2023-03-13,28,3916,1208,3387,3582,5801,17894
2023-03-14,28,4863,1251,3376,4296,4087,17873
2023-03-15,28,2622,2659,3564,1525,4196,14566
2023-03-16,28,2936,2499,1204,1729,5367,13735
2023-03-17,28,4468,1071,1719,3413,4922,15593
2023-03-18,28,2555,2692,1837,4432,3821,15337
2023-03-19,28,4750,2429,3467,2779,2134,15559
2023-03-20,28,3585,2528,2099,3690,2146,14048
2023-03-21,28,4170,937,3784,3951,5914,18756
2023-03-22,28,1439,1639,3532,1634,3767,12011
2023-03-23,28,2045,2907,1654,2265,5667,14538
2023-03-24,28,4089,1532,2549,3957,4782,16909
2023-03-25,28,1062,2516,3865,3398,5582,16423
2023-03-26,28,2708,2926,3448,3343,3835,16260
2023-03-27,28,1812,1192,2495,2000,4561,12060
2023-03-28,28,3045,2113,1822,1605,2830,11415
2023-03-29,28,2451,1598,1494,4462,4582,14587
2023-03-30,28,4251,2736,2407,2121,4225,15740
2023-03-31,28,2745,957,2080,4101,4924,14807
2023-04-01,28,4756,1976,2783,2764,4996,17275
2023-04-02,28,3117,1112,3865,4151,2260,14505
2023-04-03,28,1721,2558,2899,4310,4391,15879
2023-04-04,28,3254,854,2389,3888,2584,12969
2023-04-05,28,3697,1269,2214,4075,4869,16124
2023-04-06,28,3022,916,3237,3345,4811,15331
2023-04-07,28,4513,2237,3337,3677,4326,18090
2023-04-08,28,1243,2940,2827,3411,3008,13429
2023-04-09,28,4587,2845,2147,3728,2417,15724
2023-04-10,28,1598,1462,1839,3073,5807,13779
2023-04-11,28,4368,946,2540,1788,2381,12023
2023-04-12,28,3962,2018,2672,1970,4532,15154
2023-04-13,28,3721,2505,3724,2493,2044,14487
2023-04-14,28,3663,2847,3416,2464,4762,17152
2023-04-15,28,4802,2969,2038,4238,5318,19365
2023-04-16,28,1586,2746,3682,1540,2124,11678
2023-04-17,28,3714,1857,1994,2538,3381,13484
2023-04-18,28,2292,2155,2042,2565,3049,12103
2023-04-19,28,2449,2315,2997,2214,2277,12252
2023-04-20,28,4565,2944,1534,3491,5827,18361
2023-04-21,28,3727,1247,2894,1932,2316,12116
2023-04-22,28,3672,1768,3326,3462,5908,18136
2023-04-23,28,1727,2957,2067,3142,5005,14898
2023-04-24,28,4992,1120,3962,2315,2286,14675
2023-04-25,28,1114,1992,1778,2581,5359,12824
2023-04-26,28,1118,931,1250,3148,3710,10157
2023-04-27,28,2637,2424,2071,2825,3003,12960
2023-04-28,28,4091,2239,3392,3655,5498,18875
2023-04-29,28,1052,2921,1891,4401,2122,12387
2023-04-30,28,2980,2971,3007,3078,4916,16952
2023-05-01,28,1686,2920,1575,1690,3799,11670
2023-05-02,28,3165,1084,3614,2546,5718,16127
2023-05-03,28,3199,1371,2272,2785,4487,14114
2023-05-04,28,2470,2748,2214,1645,4306,13383
2023-05-05,28,1222,2581,1756,2858,3638,12055
2023-05-06,28,3471,1611,2044,2636,3530,13292
2023-05-07,28,4587,2348,3208,4456,2391,16990
2023-05-08,28,2300,1360,1994,1737,3592,10983
2023-05-09,28,2274,956,3314,3288,3807,13639
2023-05-10,28,1537,2317,2833,3222,3564,13473
2023-05-11,28,4490,2682,2285,3142,2154,14753
2023-05-12,28,3416,2679,3947,3272,2995,16309
2023-05-13,28,3516,1421,2167,3652,5784,16540
2023-05-14,28,3477,992,1845,3731,3580,13625
2023-05-15,28,3704,2975,3496,4222,3674,18071
2023-05-16,28,3769,2199,3217,1649,4439,15273
2023-05-17,28,2781,1168,2636,3387,4485,14457
2023-05-18,28,1142,1065,1699,2032,5391,11329
2023-05-19,28,2062,1150,2067,3085,3377,11741
2023-05-20,28,4869,1845,2415,2911,4523,16563
2023-05-21,28,3306,2675,2038,1812,5654,15485
2023-05-22,28,1257,2953,2923,2406,4388,13927
2023-05-23,28,2551,1270,3608,3479,3038,13946
2023-05-24,28,4707,1973,2472,4398,2712,16262
2023-05-25,28,1280,1881,2405,4321,3941,13828
2023-05-26,28,4409,2156,2352,4259,5775,18951
2023-05-27,28,3428,2272,2334,1580,5847,15461
2023-05-28,28,1964,1489,1962,2748,2311,10474
2023-05-29,28,4558,2104,2811,4308,5351,19132
2023-05-30,28,4078,1535,3468,1655,3369,14105
2023-05-31,28,4278,2593,1507,3682,3374,15434
2023-06-01,28,2045,1316,1803,1589,2418,9171
2023-06-02,28,3023,1951,3945,3234,4416,16569
2023-06-03,28,1776,1231,1716,3350,4557,12630
2023-06-04,28,4817,951,2935,3138,4438,16279
2023-06-05,28,1278,873,1313,3405,4382,11251
2023-06-06,28,4140,2904,3789,3793,4358,18984
2023-06-07,28,2989,1009,3505,4360,5244,17107
2023-06-08,28,4198,1798,2884,1722,2828,13430
2023-06-09,28,3499,958,2853,3375,3719,14404
2023-06-10,28,3665,1205,3954,2650,2340,13814
2023-06-11,28,1369,2800,1834,3681,4139,13823
2023-06-12,28,2821,2033,3013,3646,3595,15108
2023-06-13,28,4394,1203,1543,1820,2129,11089
2023-06-14,28,2456,2948,3278,2330,5443,16455
2023-06-15,28,2553,853,2341,2641,2035,10423
2023-06-16,28,4859,1442,3244,2416,3688,15649
2023-06-17,28,2219,1300,3980,4172,5416,17087
2023-06-18,28,3888,2699,3822,3564,3276,17249
2023-06-19,28,3654,2367,3781,2446,4699,16947
2023-06-20,28,2789,2183,2387,1795,5374,14528
2023-06-21,28,3590,2000,1718,2487,5010,14805
2023-06-22,28,4631,1151,2989,4103,3463,16337
2023-06-23,28,3806,2769,1680,4220,5370,17845
2023-06-24,28,2438,1690,1824,3020,4509,13481
2023-06-25,28,4179,2178,3871,3786,3144,17158
2023-06-26,28,1651,943,3560,2167,5135,13456
2023-06-27,28,3222,1244,2117,1665,5953,14201
2023-06-28,28,4656,1402,2368,4055,3331,15812
2023-06-29,28,2790,1140,1208,4227,3098,12463
2023-06-30,28,4878,2094,2786,3483,2600,15841
2023-07-01,28,1755,865,2190,1895,4365,11070
2023-07-02,28,2866,861,1732,4226,2726,12411
2023-07-03,28,4248,1265,2334,3699,4952,16498
2023-07-04,28,3335,900,3578,2617,4196,14626
2023-07-05,28,4152,2466,2604,1575,5643,16440
2023-07-06,28,4228,865,1537,4498,4325,15453
2023-07-07,28,4387,2691,3313,4110,2317,16818
2023-07-08,28,3463,836,1772,2096,5746,13913
2023-07-09,28,4612,967,1921,2615,2579,12694
2023-07-10,28,4443,2515,3515,3074,3313,16860
2023-07-11,28,2865,2902,1629,1571,4110,13077
2023-07-12,28,2275,2672,3619,1917,3207,13690
2023-07-13,28,1811,973,3778,2127,3890,12579
2023-07-14,28,1106,2549,2435,2944,2428,11462
2023-07-15,28,4528,863,2579,1665,3344,12979
2023-07-16,28,2701,2668,3644,3568,4922,17503
2023-07-17,28,4021,914,1952,2971,3767,13625
2023-07-18,28,4917,1532,3995,3236,2872,16552
2023-07-19,28,3005,940,1905,1772,2096,9718
2023-07-20,28,3698,2828,3831,4494,4954,19805
2023-07-21,28,2831,2274,1363,3248,3279,12995
2023-07-22,28,2645,2436,3581,3378,4343,16383
2023-07-23,28,2883,1532,2472,1603,2189,10679
2023-07-24,28,1174,2799,3838,4131,3424,15366
2023-07-25,28,2351,2516,1815,2957,2489,12128
2023-07-26,28,4209,999,3007,3346,4842,16403
2023-07-27,28,4636,2557,3707,4185,2667,17752
2023-07-28,28,1376,1658,2215,3452,4614,13315
2023-07-29,28,2417,1736,3648,4180,4157,16138
2023-07-30,28,4973,2017,3004,4329,2547,16870
2023-07-31,28,3294,1464,3417,3059,5412,16646
2023-08-01,28,3616,1662,1211,3331,2780,12600
2023-08-02,28,1043,2387,1765,3612,3599,12406
2023-08-03,28,3661,2199,3738,2089,2910,14597
2023-08-04,28,1052,861,1504,3268,3731,10416
2023-08-05,28,2510,1002,3851,2896,5274,15533
2023-08-06,28,1291,1582,3723,3618,5236,15450
2023-08-07,28,4062,1731,1593,3910,5053,16349
2023-08-08,28,4984,1146,2517,4219,2210,15076
2023-08-09,28,4986,1328,2866,2358,4055,15593
2023-08-10,28,1027,1211,3836,3952,5648,15674
2023-08-11,28,3713,2115,3922,2254,2059,14063
2023-08-12,28,2179,1361,2181,2835,3385,11941
2023-08-13,28,1523,1738,1482,2089,2524,9356
2023-08-14,28,4446,1846,2547,3863,4080,16782
2023-08-15,28,1402,2820,1606,3293,5746,14867
2023-08-16,28,4496,2992,1359,2944,4172,15963
2023-08-17,28,4028,1850,2711,2026,5066,15681
2023-08-18,28,1357,1653,3363,2994,4633,14000
2023-08-19,28,1748,1782,3774,2823,3311,13438
2023-08-20,28,2766,2199,3393,3126,2887,14371
2023-08-21,28,2056,1181,1784,4342,2250,11613
2023-08-22,28,3682,906,3850,4229,2805,15472
2023-08-23,28,1522,2057,3316,2821,3885,13601
2023-08-24,28,4296,961,1748,1541,5374,13920
2023-08-25,28,3001,2420,3267,3614,3808,16110
2023-08-26,28,4186,2989,1377,4184,2092,14828
2023-08-27,28,2048,2203,2063,4346,4776,15436
2023-08-28,28,2070,2847,3398,2789,2778,13882
2023-08-29,28,3557,2656,1486,2636,4300,14635
2023-08-30,28,1691,2546,3353,2463,3221,13274
2023-08-31,28,4549,1285,2382,2045,5463,15724
2023-09-01,28,3732,2465,2631,4012,5066,17906
2023-09-02,28,1490,1390,1938,1504,5401,11723
2023-09-03,28,3516,1484,3136,2015,3711,13862
2023-09-04,28,4813,2948,2668,3497,4735,18661
2023-09-05,28,4208,1500,2345,2346,2253,12652
2023-09-06,28,2747,1137,3237,2332,3952,13405
2023-09-07,28,4855,1944,2620,3740,3654,16813
2023-09-08,28,2580,1682,3168,1889,2074,11393
2023-09-09,28,1372,2295,2278,1550,5172,12667
2023-09-10,28,1574,2840,1333,1701,3974,11422
2023-09-11,28,4736,2456,1429,2977,5677,17275
2023-09-12,28,1653,2926,3708,3283,4621,16191
2023-09-13,28,2986,2917,1802,3933,3662,15300
2023-09-14,28,3620,2811,2132,2556,4725,15844
2023-09-15,28,2313,1049,3083,2760,2383,11588
2023-09-16,28,1897,1730,1647,3224,2549,11047
2023-09-17,28,1594,851,1494,2156,3559,9654
2023-09-18,28,1815,2223,3488,1600,5648,14774
2023-09-19,28,1906,2934,3277,3270,3278,14665
2023-09-20,28,3775,1768,2940,1873,3590,13946
2023-09-21,28,3214,1244,3682,2759,5625,16524
2023-09-22,28,1422,2348,3767,4060,2118,13715
2023-09-23,28,2148,2383,1860,1530,3254,11175
2023-09-24,28,1691,2192,1600,2999,5853,14335
2023-09-25,28,2159,2636,1486,2565,2651,11497
2023-09-26,28,2319,2140,3374,2244,3387,13464
2023-09-27,28,3061,2264,3397,2976,5894,17592
2023-09-28,28,4203,2232,1517,3595,3347,14894
2023-09-29,28,4118,836,3790,4421,4571,17736
2023-09-30,28,4916,852,2939,3045,2970,14722
2023-10-01,28,4598,2439,1531,3699,4941,17208
2023-10-02,28,3003,1531,2347,4231,5849,16961
2023-10-03,28,2902,1662,3666,2498,4652,15380
2023-10-04,28,4022,1019,3371,3463,2964,14839
2023-10-05,28,3495,1604,3529,2565,4538,15731
2023-10-06,28,1441,2353,1626,1936,5856,13212
2023-10-07,28,4662,1523,2830,4328,5085,18428
2023-10-08,28,4856,1732,1261,3190,4141,15180
2023-10-09,28,4257,1852,1810,1955,4157,14031
2023-10-10,28,2963,1283,1851,2499,4535,13131
2023-10-11,28,2399,2783,3431,3784,2039,14436
2023-10-12,28,3925,1411,3409,2887,5752,17384
2023-10-13,28,1431,1810,2119,4016,4099,13475
2023-10-14,28,3414,2915,2200,2440,4783,15752
2023-10-15,28,1655,2310,3351,3973,3516,14805
2023-10-16,28,4375,2360,2970,2850,4655,17210
2023-10-17,28,3241,2859,1898,3528,2815,14341
2023-10-18,28,4456,2743,2169,2211,4221,15800
2023-10-19,28,1462,1660,2000,4196,3279,12597
2023-10-20,28,3062,2793,3945,3739,5211,18750
2023-10-21,28,3704,2773,3771,1898,3868,16014
2023-10-22,28,3086,1052,3290,1561,5931,14920
2023-10-23,28,1919,1106,3680,1635,4950,13290
2023-10-24,28,4857,2461,2343,2637,5775,18073
2023-10-25,28,2765,1422,3287,1521,4906,13901
2023-10-26,28,4377,2615,1586,4320,4387,17285
2023-10-27,28,4478,1636,1956,3026,3448,14544
2023-10-28,28,4648,2425,3560,3545,5003,19181
2023-10-29,28,1523,1763,2873,4028,4547,14734
2023-10-30,28,2554,1842,3358,3066,2765,13585
2023-10-31,28,2787,846,1435,2870,3594,11532
2023-11-01,28,4208,966,3643,2847,2562,14226
2023-11-02,28,2846,2059,3871,4316,3852,16944
2023-11-03,28,2687,969,3520,2066,4280,13522
2023-11-04,28,3587,1661,2856,2777,3191,14072
2023-11-05,28,3053,1793,2267,2280,3482,12875
2023-11-06,28,4456,877,1732,2567,4765,14397
2023-11-07,28,2268,2520,2075,3325,3703,13891
2023-11-08,28,1514,2605,2927,4451,4341,15838
2023-11-09,28,3098,2551,3158,3758,5671,18236
2023-11-10,28,2921,2351,2643,1665,3693,13273
2023-11-11,28,4420,1269,1986,3121,3247,14043
2023-11-12,28,2463,1734,1856,3401,5779,15233
2023-11-13,28,3369,2954,2417,4464,2996,16200
2023-11-14,28,3928,2611,3166,2061,4944,16710
2023-11-15,28,2073,1921,1383,3907,3347,12631
2023-11-16,28,1176,2660,2110,4101,3067,13114
2023-11-17,28,4441,2051,2779,3469,2536,15276
2023-11-18,28,2212,2348,1495,4108,2129,12292
2023-11-19,28,1592,920,2667,2785,4725,12689
2023-11-20,28,1205,1720,3371,2542,5444,14282
2023-11-21,28,1847,1356,1919,3185,2384,10691
2023-11-22,28,2935,2466,1435,1862,2983,11681
2023-11-23,28,4574,2047,2377,4377,5228,18603
2023-11-24,28,2986,813,3298,4098,3204,14399
2023-11-25,28,3579,940,3456,2177,4794,14946
2023-11-26,28,3862,2970,2320,1897,4200,15249
2023-11-27,28,3633,2026,2256,2184,3959,14058
2023-11-28,28,4672,2960,2560,3496,5354,19042
2023-11-29,28,3688,1473,1982,3903,4830,15876
2023-11-30,28,2566,2598,1760,1521,2892,11337
2023-12-01,28,3069,1782,1918,3832,5207,15808
2023-12-02,28,1498,2651,3883,2352,4335,14719
2023-12-03,28,1629,1492,3613,3558,3214,13506
2023-12-04,28,1615,1637,2134,2738,2573,10697
2023-12-05,28,3854,1287,1283,2441,2280,11145
2023-12-06,28,2709,2819,2695,2378,3526,14127
2023-12-07,28,4205,2077,2825,3480,4348,16935
2023-12-08,28,2021,1033,2818,1571,5550,12993
2023-12-09,28,3993,1360,2030,3687,3628,14698
2023-12-10,28,4731,1172,3649,2979,2986,15517
2023-12-11,28,3276,1732,3317,2623,3989,14937
2023-12-12,28,1592,1650,2798,3371,5482,14893
2023-12-13,28,3294,2416,2633,1968,5164,15475
2023-12-14,28,4533,995,3451,1705,3987,14671
2023-12-15,28,2666,1236,3011,3866,2761,13540
2023-12-16,28,1136,2768,2400,2801,4143,13248
2023-12-17,28,3775,2630,1511,3596,2559,14071
2023-12-18,28,2473,2076,2439,3891,2948,13827
2023-12-19,28,2085,1096,3616,2141,5676,14614
2023-12-20,28,2872,1814,1537,2315,3271,11809
2023-12-21,28,4206,1538,2206,2811,5479,16240
2023-12-22,28,1106,1678,2500,4072,4027,13383
2023-12-23,28,4944,1252,2498,2975,4288,15957
2023-12-24,28,2406,2628,1466,3348,5097,14945
2023-12-25,28,4851,2866,1378,3194,2187,14476
2023-12-26,28,2317,1297,2607,4320,3941,14482
2023-12-27,28,2704,2063,3064,4399,2920,15150
2023-12-28,28,4836,2320,3712,1728,5700,18296
2023-12-29,28,2534,2452,2435,2018,4893,14332
2023-12-30,28,1924,1319,2579,3107,3728,12657
2023-12-31,28,2575,2077,2761,3355,4314,15082
2022-01-01,29,2371,2670,2193,3927,2746,13907
2022-01-02,29,1358,1976,1358,1977,4436,11105
2022-01-03,29,2434,1850,3412,2278,2558,12532
2022-01-04,29,1316,926,1460,1882,3555,9139
2022-01-05,29,3538,2943,3314,2924,4656,17375
2022-01-06,29,1223,929,3361,3161,2158,10832
2022-01-07,29,1204,1464,2658,2403,2125,9854
2022-01-08,29,1375,1019,2934,3823,3763,12914
2022-01-09,29,2679,2579,2818,2764,5706,16546
2022-01-10,29,3173,1527,3404,3856,5034,16994
2022-01-11,29,2094,1921,2402,2627,2103,11147
2022-01-12,29,2937,2500,2652,2445,3324,13858
2022-01-13,29,1948,1799,3184,1597,4315,12843
2022-01-14,29,4491,2565,2099,4316,2768,16239
2022-01-15,29,2695,2905,1888,4462,3419,15369
2022-01-16,29,4227,812,2700,2023,3297,13059
2022-01-17,29,1127,1320,2549,3585,3625,12206
2022-01-18,29,1308,2606,2426,2705,3279,12324
2022-01-19,29,2766,1150,2138,2699,3498,12251
2022-01-20,29,1979,1215,1547,2597,3792,11130
2022-01-21,29,3231,2239,3972,2298,4672,16412
2022-01-22,29,4662,1524,1238,1818,4387,13629
2022-01-23,29,2572,2301,3469,2018,5593,15953
2022-01-24,29,1585,1791,3389,4271,2078,13114
2022-01-25,29,2884,1300,2440,3082,5017,14723
2022-01-26,29,4560,2125,3213,1564,3589,15051
2022-01-27,29,3912,2703,3100,3483,2577,15775
2022-01-28,29,2700,2884,2038,2239,2187,12048
2022-01-29,29,3875,2794,2739,3360,5420,18188
2022-01-30,29,1967,2220,1760,3493,3089,12529
2022-01-31,29,4547,2069,3785,1786,4072,16259
2022-02-01,29,3126,1127,3628,3874,4844,16599
2022-02-02,29,4856,1169,1892,3919,2639,14475
2022-02-03,29,2927,2052,2457,3670,3677,14783
2022-02-04,29,4819,1053,2271,4383,3354,15880
2022-02-05,29,4825,870,3295,3013,4715,16718
2022-02-06,29,4004,2591,1762,2760,3898,15015
2022-02-07,29,1486,1888,2140,3944,2885,12343
2022-02-08,29,1716,2722,2109,3688,3924,14159
2022-02-09,29,1508,2902,3031,2306,4692,14439
2022-02-10,29,1064,2711,2144,2852,3001,11772
2022-02-11,29,4880,1049,1427,3522,3929,14807
2022-02-12,29,2741,1578,2980,2005,4862,14166
2022-02-13,29,1277,1962,1657,2828,2833,10557
2022-02-14,29,2622,901,2218,2062,3228,11031
2022-02-15,29,3249,1008,1515,3597,4422,13791
2022-02-16,29,3060,1895,2238,4130,2888,14211
2022-02-17,29,4162,915,3103,3836,4511,16527
2022-02-18,29,1630,2741,3715,3646,4428,16160
2022-02-19,29,3313,1306,1433,3966,3529,13547
2022-02-20,29,2586,2239,1669,2012,2821,11327
2022-02-21,29,1800,2631,1256,2815,2067,10569
2022-02-22,29,1783,2223,1896,3782,2033,11717
2022-02-23,29,3671,1055,1667,2969,2704,12066
2022-02-24,29,3285,1455,3806,2596,5929,17071
2022-02-25,29,2087,2542,1709,3613,3846,13797
2022-02-26,29,1637,2502,1790,3786,2003,11718
2022-02-27,29,1232,1222,2292,2366,4811,11923
2022-02-28,29,2470,1452,3304,2083,5736,15045
2022-03-01,29,1554,2767,2502,3554,3644,14021
2022-03-02,29,2110,1040,3679,2658,3347,12834
2022-03-03,29,4118,2860,3935,3395,5863,20171
2022-03-04,29,2166,1922,1756,3158,3262,12264
2022-03-05,29,2710,1650,2251,3102,4768,14481
2022-03-06,29,1715,1500,3386,2610,4451,13662
2022-03-07,29,3215,2190,1239,3103,4218,13965
2022-03-08,29,4168,1743,3881,1508,3119,14419
2022-03-09,29,4714,1118,2719,2067,2385,13003
2022-03-10,29,2688,2620,3690,2330,3193,14521
2022-03-11,29,1818,2363,2273,2924,2400,11778
2022-03-12,29,1731,1062,2703,2886,5030,13412
2022-03-13,29,3999,1194,3293,2619,3890,14995
2022-03-14,29,4764,1936,3817,2785,2136,15438
2022-03-15,29,4577,1987,1843,2978,2156,13541
2022-03-16,29,3275,2896,3227,3010,2920,15328
2022-03-17,29,1114,1027,1770,3915,2227,10053
2022-03-18,29,1985,2134,2456,1944,5929,14448
2022-03-19,29,3953,2403,1524,2510,3965,14355
2022-03-20,29,2041,1372,3672,2646,4563,14294
2022-03-21,29,1049,2657,2321,2110,5923,14060
2022-03-22,29,2926,2415,1950,4179,4364,15834
2022-03-23,29,4618,2561,1412,4304,5691,18586
2022-03-24,29,1545,903,2054,3070,4999,12571
2022-03-25,29,4113,2712,1885,1956,2283,12949
2022-03-26,29,2371,2702,3109,3278,4870,16330
2022-03-27,29,3923,1430,2014,3261,4168,14796
2022-03-28,29,2540,1068,3605,1670,5741,14624
2022-03-29,29,3959,2420,2890,2800,2042,14111
2022-03-30,29,4184,1692,3201,2842,3874,15793
2022-03-31,29,2531,2499,1903,3030,4039,14002
2022-04-01,29,1176,2616,3432,4071,3076,14371
2022-04-02,29,3529,1618,3608,1698,5611,16064
2022-04-03,29,4934,2620,2619,3552,2879,16604
2022-04-04,29,3089,2050,1574,1657,2122,10492
2022-04-05,29,3584,1975,2111,3157,4868,15695
2022-04-06,29,3413,2623,2281,3431,2416,14164
2022-04-07,29,4571,826,3252,2818,5573,17040
2022-04-08,29,4954,2208,3095,2522,3507,16286
2022-04-09,29,1915,1218,3329,2573,3552,12587
2022-04-10,29,1216,2430,2070,2649,3438,11803
2022-04-11,29,1085,2877,2737,4411,5141,16251
2022-04-12,29,3099,811,1557,1824,3590,10881
2022-04-13,29,2048,2812,2109,1722,3604,12295
2022-04-14,29,1422,2614,2103,2288,5268,13695
2022-04-15,29,3401,1839,1553,3248,3264,13305
2022-04-16,29,2346,2153,1798,2118,2720,11135
2022-04-17,29,3185,1130,2709,3287,5486,15797
2022-04-18,29,3762,1985,2009,2937,5409,16102
2022-04-19,29,3283,2751,1522,3293,4931,15780
2022-04-20,29,1332,2788,3456,4439,2952,14967
2022-04-21,29,2375,838,1911,2695,3979,11798
2022-04-22,29,1506,1445,3454,4183,5293,15881
2022-04-23,29,4891,2638,3068,3870,3686,18153
2022-04-24,29,4905,1449,1520,4222,3321,15417
2022-04-25,29,2538,2244,1388,2345,2451,10966
2022-04-26,29,2306,2684,2180,3776,5655,16601
2022-04-27,29,3781,2386,2680,3544,5125,17516
2022-04-28,29,3475,1576,3152,1608,2835,12646
2022-04-29,29,3596,1372,2844,3807,3301,14920
2022-04-30,29,3627,1460,1615,3397,2597,12696
2022-05-01,29,3330,1158,1511,1773,3018,10790
2022-05-02,29,1607,1036,3704,2232,5871,14450
2022-05-03,29,2558,1757,3646,2554,3214,13729
2022-05-04,29,1308,2325,2622,3284,5772,15311
2022-05-05,29,2780,936,1603,2914,4299,12532
2022-05-06,29,3239,918,2562,3439,2359,12517
2022-05-07,29,1563,2735,1222,3659,3841,13020
2022-05-08,29,2236,1157,1310,4090,4443,13236
2022-05-09,29,2632,1436,2507,4480,5499,16554
2022-05-10,29,2992,1111,1296,4126,5849,15374
2022-05-11,29,2166,1957,2204,2959,2676,11962
2022-05-12,29,1812,2933,2553,3773,4178,15249
2022-05-13,29,3133,2665,1453,2311,4115,13677
2022-05-14,29,4953,1106,2977,3225,5456,17717
2022-05-15,29,3376,944,2587,2211,3454,12572
2022-05-16,29,1874,2817,2109,2790,2253,11843
2022-05-17,29,4164,2018,3227,4347,2859,16615
2022-05-18,29,3751,953,1349,2045,3724,11822
2022-05-19,29,4819,1266,3673,2885,5606,18249
2022-05-20,29,2954,1763,3270,2093,2312,12392
2022-05-21,29,2398,1551,1982,1947,2952,10830
2022-05-22,29,4400,1756,3043,2730,2275,14204
2022-05-23,29,1290,2873,3998,3056,3463,14680
2022-05-24,29,3724,2053,1757,2608,2242,12384
2022-05-25,29,2227,854,2097,4378,2415,11971
2022-05-26,29,3297,2274,2900,1640,3419,13530
2022-05-27,29,2033,2036,2966,2337,4518,13890
2022-05-28,29,4658,2640,3604,4282,3081,18265
2022-05-29,29,1041,2765,3241,4335,3464,14846
2022-05-30,29,2183,890,1678,3475,4725,12951
2022-05-31,29,1545,2622,3256,2884,3841,14148
2022-06-01,29,2471,1993,3560,2392,5655,16071
2022-06-02,29,3074,2203,1509,3713,3033,13532
2022-06-03,29,4008,1218,1865,2522,2027,11640
2022-06-04,29,2182,2135,3858,2256,5624,16055
2022-06-05,29,2770,1924,2076,4429,5842,17041
2022-06-06,29,1798,2240,3599,3384,2518,13539
2022-06-07,29,1284,2608,3585,2940,5189,15606
2022-06-08,29,1129,1800,2748,2733,2822,11232
2022-06-09,29,2512,2598,1898,1595,5867,14470
2022-06-10,29,2136,1136,1557,1634,2912,9375
2022-06-11,29,2866,1444,2535,1549,4094,12488
2022-06-12,29,3694,2748,3505,2630,4610,17187
2022-06-13,29,4150,1676,1646,4255,3402,15129
2022-06-14,29,2589,1608,2097,3620,2307,12221
2022-06-15,29,2274,1515,2576,4434,4478,15277
2022-06-16,29,3318,2600,3697,3870,5651,19136
2022-06-17,29,3186,2582,1281,2520,2065,11634
2022-06-18,29,1694,1554,1894,2956,5643,13741
2022-06-19,29,1270,921,3882,2762,2191,11026
2022-06-20,29,2387,1973,2677,2990,4771,14798
2022-06-21,29,3662,978,1240,3324,2592,11796
2022-06-22,29,1800,1020,3148,1685,4538,12191
2022-06-23,29,4589,1483,2481,2500,4876,15929
2022-06-24,29,1993,1440,3169,2165,4755,13522
2022-06-25,29,3614,2797,3870,2437,4035,16753
2022-06-26,29,2665,1660,1485,3974,2266,12050
2022-06-27,29,4440,2762,3621,3678,3187,17688
2022-06-28,29,1047,2722,3650,2090,2606,12115
2022-06-29,29,1778,2740,3091,2968,2299,12876
2022-06-30,29,3198,1701,1695,1656,5755,14005
2022-07-01,29,2283,2379,3140,1826,2526,12154
2022-07-02,29,2908,1535,2055,3152,2311,11961
2022-07-03,29,2242,1376,1561,1905,5396,12480
2022-07-04,29,3871,2175,2963,3603,2426,15038
2022-07-05,29,3168,1812,3468,3513,5977,17938
2022-07-06,29,1773,2752,3694,3553,5755,17527
2022-07-07,29,2011,2385,3654,3664,4275,15989
2022-07-08,29,2391,1214,1971,3884,4533,13993
2022-07-09,29,2130,1017,3717,2877,3248,12989
2022-07-10,29,2237,1539,3984,3198,5048,16006
2022-07-11,29,3602,1970,3722,2037,4098,15429
2022-07-12,29,1117,1288,1375,2674,3787,10241
2022-07-13,29,2579,1292,3585,3178,4134,14768
2022-07-14,29,4245,1324,1567,3439,4821,15396
2022-07-15,29,3840,2370,3599,2444,3737,15990
2022-07-16,29,2131,2315,3565,3077,4997,16085
2022-07-17,29,2807,2175,1544,4497,4724,15747
2022-07-18,29,2381,1948,2945,4119,2544,13937
2022-07-19,29,4070,2686,3133,4150,2002,16041
2022-07-20,29,2687,1703,1787,4041,2548,12766
2022-07-21,29,3129,2949,2354,3838,4924,17194
2022-07-22,29,3657,2117,1585,3709,3477,14545
2022-07-23,29,2533,1031,2402,2353,3747,12066
2022-07-24,29,3430,1809,3458,3462,2195,14354
2022-07-25,29,3613,1018,3082,2659,5116,15488
2022-07-26,29,1659,1244,1414,2881,4419,11617
2022-07-27,29,3099,2085,2721,3427,2530,13862
2022-07-28,29,3836,2634,3878,3336,5251,18935
2022-07-29,29,3309,2670,3816,2428,2893,15116
2022-07-30,29,3655,1962,2258,4206,3994,16075
2022-07-31,29,2766,1596,3943,3231,3577,15113
2022-08-01,29,1245,1195,3229,2500,4356,12525
2022-08-02,29,4233,2362,3974,3137,5543,19249
2022-08-03,29,4931,2792,3673,3948,2790,18134
2022-08-04,29,3875,2797,3527,3170,5831,19200
2022-08-05,29,1197,984,2002,2613,3437,10233
2022-08-06,29,2156,1009,3936,3283,3435,13819
2022-08-07,29,2863,1307,3195,2271,4424,14060
2022-08-08,29,4620,2754,2099,2093,2633,14199
2022-08-09,29,1883,2793,1894,3219,5911,15700
2022-08-10,29,3033,2753,3797,2266,4945,16794
2022-08-11,29,4873,1901,1388,3459,3508,15129
2022-08-12,29,3237,2838,3586,3655,5169,18485
2022-08-13,29,3552,2727,2530,2240,5638,16687
2022-08-14,29,1514,1438,2382,2481,3892,11707
2022-08-15,29,2524,816,3939,1633,5131,14043
2022-08-16,29,2439,808,2445,3688,2886,12266
2022-08-17,29,1999,857,2668,1686,2053,9263
2022-08-18,29,3101,2044,3255,1997,4857,15254
2022-08-19,29,1516,2501,1463,3993,4214,13687
2022-08-20,29,1374,2621,1595,2401,3409,11400
2022-08-21,29,2939,1016,3708,2878,3273,13814
2022-08-22,29,2497,2925,2327,3486,4290,15525
2022-08-23,29,2738,1111,1207,3941,2317,11314
2022-08-24,29,4563,1927,3280,3000,2222,14992
2022-08-25,29,4328,2137,3052,3745,2576,15838
2022-08-26,29,4976,996,1610,2909,3606,14097
2022-08-27,29,1936,2315,3841,4218,3037,15347
2022-08-28,29,3188,1723,3354,3671,3950,15886
2022-08-29,29,4621,1843,2833,2478,2400,14175
2022-08-30,29,1640,1771,1960,2210,4419,12000
2022-08-31,29,4904,955,2393,1932,2327,12511
2022-09-01,29,4261,2657,2688,3014,3807,16427
2022-09-02,29,2775,2171,1480,3528,2256,12210
2022-09-03,29,4910,2503,2060,4434,5817,19724
2022-09-04,29,4005,1062,3063,2818,4781,15729
2022-09-05,29,3756,1481,2210,4455,4658,16560
2022-09-06,29,3787,1014,3446,3445,4994,16686
2022-09-07,29,2407,2386,3425,4346,3752,16316
2022-09-08,29,1210,1997,3350,3100,5883,15540
2022-09-09,29,2193,1983,3841,4031,4621,16669
2022-09-10,29,4797,1738,3799,3333,5642,19309
2022-09-11,29,2208,2502,1738,2973,3988,13409
2022-09-12,29,1063,2781,3934,2475,3494,13747
2022-09-13,29,1360,2980,1781,4415,3207,13743
2022-09-14,29,1585,1568,2284,3695,3431,12563
2022-09-15,29,2925,2080,3413,3178,5763,17359
2022-09-16,29,4797,2606,3060,2790,2932,16185
2022-09-17,29,4403,2154,1259,4123,2965,14904
2022-09-18,29,1137,2008,2563,3996,5219,14923
2022-09-19,29,1571,1018,2351,2906,5965,13811
2022-09-20,29,4637,862,2329,1806,5631,15265
2022-09-21,29,4524,2419,1253,4215,3768,16179
2022-09-22,29,2579,899,1514,1849,3507,10348
2022-09-23,29,3602,1958,1444,2423,2044,11471
2022-09-24,29,4015,2769,2409,2745,2790,14728
2022-09-25,29,4533,1853,2705,2908,3968,15967
2022-09-26,29,4650,2549,3925,2212,3351,16687
2022-09-27,29,4772,2493,3495,2339,2934,16033
2022-09-28,29,3041,1833,1800,3111,5567,15352
2022-09-29,29,2116,1617,1761,1787,3252,10533
2022-09-30,29,2280,2953,3502,3630,3009,15374
2022-10-01,29,1288,1615,3217,4431,3753,14304
2022-10-02,29,3854,2360,3816,4451,5600,20081
2022-10-03,29,3361,2322,1600,3132,5031,15446
2022-10-04,29,2362,2142,1217,2266,5696,13683
2022-10-05,29,2168,2179,1403,3769,3068,12587
2022-10-06,29,2752,2820,1711,4034,3506,14823
2022-10-07,29,2430,2521,3136,2630,4447,15164
2022-10-08,29,2763,2831,1780,4216,4216,15806
2022-10-09,29,2093,2830,2687,4035,5969,17614
2022-10-10,29,3390,1627,1710,4118,2252,13097
2022-10-11,29,2562,1736,3519,2484,2444,12745
2022-10-12,29,3462,1743,2360,4016,5820,17401
2022-10-13,29,3598,1003,3176,1589,2373,11739
2022-10-14,29,2618,1829,3639,3339,4380,15805
2022-10-15,29,3459,1944,2750,4177,4912,17242
2022-10-16,29,1290,2728,3830,3799,4245,15892
2022-10-17,29,1310,2791,3945,4057,2888,14991
2022-10-18,29,4143,1951,3732,1602,4093,15521
2022-10-19,29,4702,1136,2790,3755,2273,14656
2022-10-20,29,1136,2342,3118,1829,5473,13898
2022-10-21,29,1517,2881,3061,1569,4609,13637
2022-10-22,29,2075,2280,3930,2775,3203,14263
2022-10-23,29,2196,2209,2044,3283,4707,14439
2022-10-24,29,1148,1434,2735,1687,2930,9934
2022-10-25,29,3266,1968,2306,2062,3995,13597
2022-10-26,29,2431,2072,3778,3329,3129,14739
2022-10-27,29,1123,2899,3387,4217,4380,16006
2022-10-28,29,3755,1967,2934,3696,5578,17930
2022-10-29,29,3182,2269,3242,4246,5391,18330
2022-10-30,29,4430,1207,1625,1733,4390,13385
2022-10-31,29,1234,1012,1896,3404,4651,12197
2022-11-01,29,2284,1094,2080,3481,5541,14480
2022-11-02,29,1198,2206,3307,3317,4917,14945
2022-11-03,29,1988,1089,3319,2767,5905,15068
2022-11-04,29,4916,2003,1645,2938,3972,15474
2022-11-05,29,2345,1017,2552,2919,5832,14665
2022-11-06,29,2937,1279,1501,3929,2428,12074
2022-11-07,29,4739,980,3985,3997,3608,17309
2022-11-08,29,1052,1312,1476,2281,4348,10469
2022-11-09,29,4804,1578,3038,2955,2815,15190
2022-11-10,29,4599,1332,1743,2779,4553,15006
2022-11-11,29,3292,2103,2354,3939,3640,15328
2022-11-12,29,1823,2957,4000,3320,3328,15428
2022-11-13,29,1446,1262,1685,2254,4031,10678
2022-11-14,29,2591,2453,2980,1584,5914,15522
2022-11-15,29,1823,1007,2180,3400,4438,12848
2022-11-16,29,1344,1324,1326,1955,4018,9967
2022-11-17,29,4942,1272,1716,2815,3863,14608
2022-11-18,29,3138,2985,1354,3147,5434,16058
2022-11-19,29,1052,2191,2005,3313,5999,14560
2022-11-20,29,4196,2705,2583,2721,3443,15648
2022-11-21,29,1920,2990,2413,2624,3517,13464
2022-11-22,29,3670,1494,2689,3791,3165,14809
2022-11-23,29,3828,1685,3971,4451,2172,16107
2022-11-24,29,1415,1063,1372,2522,2649,9021
2022-11-25,29,1964,2127,3325,3800,5696,16912
2022-11-26,29,4383,889,3190,3394,5487,17343
2022-11-27,29,1775,1645,3038,2680,5171,14309
2022-11-28,29,1289,1456,3427,3985,4702,14859
2022-11-29,29,2680,909,3531,1566,3719,12405
2022-11-30,29,1177,1088,2842,3575,2661,11343
2022-12-01,29,4337,1066,3266,2755,5318,16742
2022-12-02,29,1420,1343,2165,1777,5132,11837
2022-12-03,29,1193,1244,1799,3162,4208,11606
2022-12-04,29,2808,1785,2608,3769,2460,13430
2022-12-05,29,1550,1802,3169,3567,4224,14312
2022-12-06,29,3479,2989,1466,2700,4315,14949
2022-12-07,29,4900,959,1622,3406,3027,13914
2022-12-08,29,3914,2182,2616,3853,2631,15196
2022-12-09,29,1184,1806,2958,3190,4877,14015
2022-12-10,29,3989,1011,2347,2747,4174,14268
2022-12-11,29,4330,1654,3099,2405,4891,16379
2022-12-12,29,3353,1454,1779,3617,2879,13082
2022-12-13,29,4604,2601,1865,3561,3653,16284
2022-12-14,29,3604,1155,2004,2545,3865,13173
2022-12-15,29,1441,930,3338,1901,5566,13176
2022-12-16,29,3884,891,1587,2373,2278,11013
2022-12-17,29,2059,2785,3007,1607,4375,13833
2022-12-18,29,4319,2380,2834,1717,3058,14308
2022-12-19,29,3542,2271,3663,1776,2987,14239
2022-12-20,29,1255,2362,3286,1915,5833,14651
2022-12-21,29,1731,1944,3204,3675,5099,15653
2022-12-22,29,4206,1273,3650,3487,3089,15705
2022-12-23,29,2963,1384,2441,1801,4711,13300
2022-12-24,29,2249,1955,3531,2630,2071,12436
2022-12-25,29,2310,1795,3881,1514,2545,12045
2022-12-26,29,4770,2175,3299,4121,4781,19146
2022-12-27,29,1764,1857,3980,2668,3326,13595
2022-12-28,29,2096,2079,2404,2443,4905,13927
2022-12-29,29,4721,1591,3195,3960,5306,18773
2022-12-30,29,4597,2706,2533,4143,2178,16157
2022-12-31,29,1999,2397,2202,4210,5256,16064
2023-01-01,29,2507,1276,3531,3688,2113,13115
2023-01-02,29,3008,1543,2750,2924,4431,14656
2023-01-03,29,2844,2190,3953,2405,3325,14717
2023-01-04,29,2043,1174,2825,2104,2269,10415
2023-01-05,29,1947,944,3255,2934,3108,12188
2023-01-06,29,1550,2905,2197,2297,4113,13062
2023-01-07,29,3427,2733,3167,3181,5485,17993
2023-01-08,29,3928,845,1239,3227,2472,11711
2023-01-09,29,2889,2314,3912,3277,5373,17765
2023-01-10,29,2193,2341,2458,3622,3248,13862
2023-01-11,29,2853,1474,3475,2183,3434,13419
2023-01-12,29,4123,2565,2256,4264,4983,18191
2023-01-13,29,3019,1619,3616,3833,3531,15618
2023-01-14,29,2699,1488,3586,4198,4041,16012
2023-01-15,29,4345,2640,1618,3028,5566,17197
2023-01-16,29,1775,2884,2178,2825,4288,13950
2023-01-17,29,3171,2301,2776,3090,2484,13822
2023-01-18,29,2300,1016,1338,3869,5238,13761
2023-01-19,29,4444,2426,2643,4068,2514,16095
2023-01-20,29,2774,811,3198,2750,3463,12996
2023-01-21,29,4658,2170,2851,2244,5307,17230
2023-01-22,29,2060,920,3831,2152,4996,13959
2023-01-23,29,1426,2896,3086,4369,5272,17049
2023-01-24,29,4780,1909,3521,1850,5391,17451
2023-01-25,29,4445,2136,3384,2601,5159,17725
2023-01-26,29,1133,1971,2135,2636,3586,11461
2023-01-27,29,3844,1853,2209,3402,5709,17017
2023-01-28,29,4613,2693,3923,3077,3868,18174
2023-01-29,29,1015,1237,3050,2527,2115,9944
2023-01-30,29,3875,2629,2543,4468,5665,19180
2023-01-31,29,4642,1018,1273,1950,2016,10899
2023-02-01,29,3173,2310,3344,4350,2622,15799
2023-02-02,29,2028,2637,2648,3784,3594,14691
2023-02-03,29,4517,1457,2563,2345,5955,16837
2023-02-04,29,2859,2897,3992,1955,3717,15420
2023-02-05,29,3795,1276,3860,1968,4625,15524
2023-02-06,29,2589,1269,2383,4127,4650,15018
2023-02-07,29,1920,2784,1619,2786,2453,11562
2023-02-08,29,1138,2279,3324,3704,3015,13460
2023-02-09,29,3169,2287,2146,3763,5686,17051
2023-02-10,29,3467,1401,3869,4043,2522,15302
2023-02-11,29,4544,1633,2094,2873,5923,17067
2023-02-12,29,1440,2133,3591,2281,5168,14613
2023-02-13,29,3720,1353,2549,3452,2274,13348
2023-02-14,29,4052,1367,3843,4233,5059,18554
2023-02-15,29,1904,927,1469,3339,3193,10832
2023-02-16,29,3337,2691,3519,2229,2228,14004
2023-02-17,29,1290,2710,3309,1811,2851,11971
2023-02-18,29,2312,1043,3678,2914,3222,13169
2023-02-19,29,2954,2878,3734,2068,2827,14461
2023-02-20,29,4135,2388,2716,3915,4884,18038
2023-02-21,29,1655,877,1327,2872,2431,9162
2023-02-22,29,2887,1529,2231,2677,5596,14920
2023-02-23,29,4752,933,2077,2552,2250,12564
2023-02-24,29,2916,1762,1621,4122,2500,12921
2023-02-25,29,4178,2375,3570,1649,4298,16070
2023-02-26,29,1373,1659,1297,2258,4946,11533
2023-02-27,29,2383,2380,2341,3092,4422,14618
2023-02-28,29,4202,1206,3277,3706,3244,15635
2023-03-01,29,4072,1035,2252,2358,3985,13702
2023-03-02,29,3367,833,3574,1734,3133,12641
2023-03-03,29,4310,2499,3290,2556,5688,18343
2023-03-04,29,1464,2355,2755,3541,5638,15753
2023-03-05,29,3589,2060,3420,4419,5605,19093
2023-03-06,29,4868,2292,3508,3983,3647,18298
2023-03-07,29,2168,2899,1607,4459,4733,15866
2023-03-08,29,1180,1848,1530,4067,3011,11636
2023-03-09,29,4634,1304,3078,3251,5260,17527
2023-03-10,29,1150,1501,1589,3207,5953,13400
2023-03-11,29,4129,1232,1950,2490,5887,15688
2023-03-12,29,2139,1595,1846,1614,3198,10392
2023-03-13,29,4719,2315,3454,4356,2357,17201
2023-03-14,29,3779,858,2517,2356,5984,15494
2023-03-15,29,1185,1678,3905,3739,4035,14542
2023-03-16,29,1429,1148,3650,2942,5796,14965
2023-03-17,29,3403,2821,2763,4439,2407,15833
2023-03-18,29,1171,800,2184,4040,4439,12634
2023-03-19,29,2914,1272,2220,2050,5380,13836
2023-03-20,29,3205,831,3072,2824,2512,12444
2023-03-21,29,1077,1633,1523,3390,5936,13559
2023-03-22,29,4726,1568,1969,1637,2050,11950
2023-03-23,29,2231,1329,1495,2702,2102,9859
2023-03-24,29,1458,2938,1504,2975,2031,10906
2023-03-25,29,3920,2073,1746,3401,2614,13754
2023-03-26,29,3881,1949,3962,3963,3289,17044
2023-03-27,29,1357,2692,2505,3470,4853,14877
2023-03-28,29,3132,1009,2416,4105,4939,15601
2023-03-29,29,2040,2614,1499,3268,2413,11834
2023-03-30,29,1886,1094,1617,4264,2834,11695
2023-03-31,29,2073,2408,2587,2354,2721,12143
2023-04-01,29,3864,2123,2937,3491,5092,17507
2023-04-02,29,3150,2871,3980,1509,5985,17495
2023-04-03,29,4719,1071,3092,2481,5434,16797
2023-04-04,29,3498,952,2389,3389,2422,12650
2023-04-05,29,3459,2271,3850,4449,4532,18561
2023-04-06,29,3275,1800,2309,2584,3882,13850
2023-04-07,29,2414,2575,2884,4206,3893,15972
2023-04-08,29,3617,2291,3566,2604,5679,17757
2023-04-09,29,4686,1447,2510,3850,5185,17678
2023-04-10,29,3334,1293,2985,2567,5166,15345
2023-04-11,29,1479,2462,1796,2326,4561,12624
2023-04-12,29,4358,2448,2314,1894,4393,15407
2023-04-13,29,1719,1841,3633,2848,5412,15453
2023-04-14,29,4073,2336,3793,4381,3826,18409
2023-04-15,29,3305,1188,1399,2939,5727,14558
2023-04-16,29,3706,2891,3905,3493,3430,17425
2023-04-17,29,4526,2904,2472,2295,3078,15275
2023-04-18,29,1057,2259,1412,2569,4924,12221
2023-04-19,29,2967,1673,3154,1819,2000,11613
2023-04-20,29,3805,2754,3025,2146,2057,13787
2023-04-21,29,3497,943,1793,2588,2910,11731
2023-04-22,29,4553,949,2775,3574,3236,15087
2023-04-23,29,4198,2201,3328,2880,5101,17708
2023-04-24,29,4014,1713,3068,2741,3493,15029
2023-04-25,29,3596,2292,2950,1904,5182,15924
2023-04-26,29,4428,2182,3805,3778,3438,17631
2023-04-27,29,3588,898,1937,1881,3672,11976
2023-04-28,29,3919,2105,2329,1780,2170,12303
2023-04-29,29,2801,1342,2990,3179,5992,16304
2023-04-30,29,3721,2800,2287,3696,3399,15903
2023-05-01,29,3353,2157,3617,1987,4181,15295
2023-05-02,29,4343,2065,2369,3159,2964,14900
2023-05-03,29,1459,1893,3977,1990,4986,14305
2023-05-04,29,1248,2095,1665,3456,4323,12787
2023-05-05,29,1827,1423,2930,2941,3665,12786
2023-05-06,29,3205,1707,3449,3746,4043,16150
2023-05-07,29,4242,2347,2492,2043,2710,13834
2023-05-08,29,2905,1179,1499,3960,3883,13426
2023-05-09,29,4243,2053,2438,4374,3876,16984
2023-05-10,29,3191,976,3046,2305,5801,15319
2023-05-11,29,4126,2170,2918,2943,4651,16808
2023-05-12,29,3461,1096,3587,1695,3845,13684
2023-05-13,29,2821,2906,1864,3930,3680,15201
2023-05-14,29,3624,2442,1609,3426,4669,15770
2023-05-15,29,3821,2764,2314,4372,2531,15802
2023-05-16,29,3397,1127,2314,3343,5426,15607
2023-05-17,29,2752,2682,3468,2846,3960,15708
2023-05-18,29,4971,2989,3004,4001,2379,17344
2023-05-19,29,3636,2912,2016,1949,5316,15829
2023-05-20,29,1289,2000,3181,3940,2486,12896
2023-05-21,29,4512,2432,2726,3142,2296,15108
2023-05-22,29,4788,1503,3324,3167,2732,15514
2023-05-23,29,3739,2587,2003,3445,5332,17106
2023-05-24,29,3346,1803,1202,3472,3366,13189
2023-05-25,29,4047,1050,2971,3438,5173,16679
2023-05-26,29,1361,2273,1360,2683,2192,9869
2023-05-27,29,3397,2094,2238,2576,2908,13213
2023-05-28,29,4938,1025,3970,1545,2567,14045
2023-05-29,29,2908,2846,3582,1500,4501,15337
2023-05-30,29,4906,1191,3009,2348,3901,15355
2023-05-31,29,1845,2192,1905,3493,5577,15012
2023-06-01,29,1112,2329,3100,3286,5976,15803
2023-06-02,29,3643,2262,4000,1963,4470,16338
2023-06-03,29,3403,1675,1316,4171,5578,16143
2023-06-04,29,4680,2221,1396,2033,3326,13656
2023-06-05,29,3714,2904,1345,4129,2515,14607
2023-06-06,29,3984,2126,3856,3847,2970,16783
2023-06-07,29,4433,2284,3953,4195,4668,19533
2023-06-08,29,3078,2090,2449,4368,2997,14982
2023-06-09,29,3237,1658,2213,2906,4407,14421
2023-06-10,29,1882,2401,1261,4005,4932,14481
2023-06-11,29,2635,2534,2416,1696,2107,11388
2023-06-12,29,1589,1707,1730,3230,5431,13687
2023-06-13,29,4710,1064,2089,4373,4388,16624
2023-06-14,29,1278,1404,2831,3412,2099,11024
2023-06-15,29,3543,1051,2690,2073,4910,14267
2023-06-16,29,2376,2061,1978,2313,4718,13446
2023-06-17,29,3706,2142,2587,2741,2254,13430
2023-06-18,29,1262,1277,3525,2506,4092,12662
2023-06-19,29,4220,2298,3561,3941,5241,19261
2023-06-20,29,1316,1679,3249,2075,5180,13499
2023-06-21,29,2754,2340,2027,1516,5281,13918
2023-06-22,29,3920,2246,2666,2109,2055,12996
2023-06-23,29,4758,2319,2508,1888,3047,14520
2023-06-24,29,2124,850,3520,1626,4465,12585
2023-06-25,29,2649,2523,1763,3501,4972,15408
2023-06-26,29,1523,944,1396,3211,4376,11450
2023-06-27,29,2861,1523,2896,2525,2281,12086
2023-06-28,29,1188,1575,3758,2817,2409,11747
2023-06-29,29,2794,1303,3486,4296,4132,16011
2023-06-30,29,1779,1430,3569,1629,4831,13238
2023-07-01,29,3451,2022,3726,3965,3777,16941
2023-07-02,29,4857,1248,2925,3821,5627,18478
2023-07-03,29,3787,1533,1789,1792,4252,13153
2023-07-04,29,4754,2296,2367,3081,3134,15632
2023-07-05,29,4820,2146,1227,1514,3479,13186
2023-07-06,29,2885,2987,1772,1899,2429,11972
2023-07-07,29,1218,945,2179,3796,4567,12705
2023-07-08,29,4850,930,2616,2752,5157,16305
2023-07-09,29,3089,2190,1276,2048,5604,14207
2023-07-10,29,3172,2758,3539,2257,4136,15862
2023-07-11,29,1335,1379,2628,2855,3039,11236
2023-07-12,29,3139,1815,3322,2320,4188,14784
2023-07-13,29,2457,1625,1239,3357,2526,11204
2023-07-14,29,3455,1227,1982,2682,5422,14768
2023-07-15,29,4830,2645,2424,2543,4764,17206
2023-07-16,29,2710,1486,2837,1716,5040,13789
2023-07-17,29,3739,1020,1770,1846,4347,12722
2023-07-18,29,4138,2559,3223,4253,2691,16864
2023-07-19,29,3230,2715,2675,1927,5404,15951
2023-07-20,29,4405,2712,3049,2134,2384,14684
2023-07-21,29,3055,2193,3817,3417,3449,15931
2023-07-22,29,2133,2114,2417,3709,2059,12432
2023-07-23,29,4959,1119,2027,3961,2713,14779
2023-07-24,29,2787,900,3298,2533,2233,11751
2023-07-25,29,1285,1758,3756,2574,4819,14192
2023-07-26,29,3829,800,2059,2620,4252,13560
2023-07-27,29,1970,2200,3541,3803,2303,13817
2023-07-28,29,3971,1001,2201,3356,2796,13325
2023-07-29,29,4309,2016,2925,3054,3789,16093
2023-07-30,29,1858,1396,3970,1950,5969,15143
2023-07-31,29,2908,2958,3789,3308,2250,15213
2023-08-01,29,3118,979,2101,2591,2312,11101
2023-08-02,29,1131,1381,2395,2468,4456,11831
2023-08-03,29,4298,1897,1897,3794,3106,14992
2023-08-04,29,1082,2362,2421,3901,3564,13330
2023-08-05,29,1581,2011,3874,4290,4788,16544
2023-08-06,29,2858,1086,2429,2622,2730,11725
2023-08-07,29,4500,2687,1871,3644,5536,18238
2023-08-08,29,1161,2792,3562,2429,2461,12405
2023-08-09,29,1986,1273,2050,2758,4897,12964
2023-08-10,29,1145,850,3151,1774,3009,9929
2023-08-11,29,2903,2355,1432,4060,2381,13131
2023-08-12,29,3782,968,1745,4266,3576,14337
2023-08-13,29,2062,2697,1762,4196,3342,14059
2023-08-14,29,2065,2144,3815,2983,2095,13102
2023-08-15,29,4530,2874,2012,2571,5794,17781
2023-08-16,29,4151,2809,3099,2584,2850,15493
2023-08-17,29,2553,804,1595,2851,5711,13514
2023-08-18,29,1709,2021,3188,3274,5698,15890
2023-08-19,29,3081,904,3471,1538,5282,14276
2023-08-20,29,3531,2752,3787,3115,2147,15332
2023-08-21,29,1177,2222,2574,2996,4241,13210
2023-08-22,29,3727,2647,3604,3786,5212,18976
2023-08-23,29,2739,1362,3612,1658,5181,14552
2023-08-24,29,1826,1226,1480,4452,5494,14478
2023-08-25,29,2950,1334,3246,2090,3399,13019
2023-08-26,29,3341,2376,3582,2661,5022,16982
2023-08-27,29,2205,2082,1875,2081,5016,13259
2023-08-28,29,4026,2440,3728,3260,3339,16793
2023-08-29,29,2783,984,1289,1720,2256,9032
2023-08-30,29,3844,2050,2393,3652,5250,17189
2023-08-31,29,1263,1895,3769,2610,4405,13942
2023-09-01,29,1095,1411,3893,3872,5783,16054
2023-09-02,29,2394,2430,2769,3079,5987,16659
2023-09-03,29,2971,1892,2020,4173,5098,16154
2023-09-04,29,2180,1532,3777,1679,2989,12157
2023-09-05,29,3725,1287,3985,2755,3500,15252
2023-09-06,29,3667,2176,1459,3256,2728,13286
2023-09-07,29,3460,2519,3917,2109,2086,14091
2023-09-08,29,3622,2778,2098,1542,4543,14583
2023-09-09,29,3602,2316,3213,2973,3627,15731
2023-09-10,29,1860,1530,3917,2460,4348,14115
2023-09-11,29,3670,2402,1511,3662,3302,14547
2023-09-12,29,4204,1499,1796,1797,4241,13537
2023-09-13,29,2452,1475,1753,4202,4974,14856
2023-09-14,29,2605,1233,2611,2185,5898,14532
2023-09-15,29,4331,1727,1997,4082,5698,17835
2023-09-16,29,4645,1002,3275,2977,4640,16539
2023-09-17,29,4066,1054,1559,3950,2233,12862
2023-09-18,29,4120,1856,3325,3485,5409,18195
2023-09-19,29,2243,2186,3527,2843,3579,14378
2023-09-20,29,2123,995,3556,1558,5382,13614
2023-09-21,29,2215,1298,3067,3928,4288,14796
2023-09-22,29,2992,1126,1435,2696,5152,13401
2023-09-23,29,1107,1415,3822,4448,4018,14810
2023-09-24,29,1749,2286,2573,1596,3928,12132
2023-09-25,29,4256,1588,2894,3201,3489,15428
2023-09-26,29,2503,2732,2360,4098,4737,16430
2023-09-27,29,3098,1220,1397,2903,2031,10649
2023-09-28,29,2956,1500,2491,1860,2672,11479
2023-09-29,29,3675,2275,3429,4395,4282,18056
2023-09-30,29,2392,2308,2427,3144,4536,14807
2023-10-01,29,4495,1484,2263,2945,5883,17070
2023-10-02,29,3635,1298,2108,4176,5427,16644
2023-10-03,29,3736,1163,2195,3365,5326,15785
2023-10-04,29,2223,1892,2555,2528,3618,12816
2023-10-05,29,4361,891,1752,4071,4571,15646
2023-10-06,29,4302,1434,1591,2060,5057,14444
2023-10-07,29,3497,2797,3556,4048,2526,16424
2023-10-08,29,3376,2546,2969,3815,5842,18548
2023-10-09,29,3187,1971,2264,1571,5516,14509
2023-10-10,29,4489,1782,2487,2607,5137,16502
2023-10-11,29,2371,1933,2791,3695,3220,14010
2023-10-12,29,4702,1372,3880,4044,2021,16019
2023-10-13,29,1940,2734,3160,4479,2963,15276
2023-10-14,29,3085,2565,1551,2987,2195,12383
2023-10-15,29,1692,1891,2401,2172,4965,13121
2023-10-16,29,2420,2340,2785,1815,3967,13327
2023-10-17,29,3130,1862,2525,1934,2184,11635
2023-10-18,29,3651,2030,3310,2429,3036,14456
2023-10-19,29,4011,1752,2884,2519,4335,15501
2023-10-20,29,4264,2834,3305,1535,3247,15185
2023-10-21,29,2367,2371,3783,1670,2530,12721
2023-10-22,29,4077,2494,2078,3494,4185,16328
2023-10-23,29,2542,873,1507,3584,3767,12273
2023-10-24,29,3732,890,1487,2716,2954,11779
2023-10-25,29,3180,2327,3334,3265,4941,17047
2023-10-26,29,3275,2338,3689,3648,2014,14964
2023-10-27,29,4366,1711,2064,4135,5681,17957
2023-10-28,29,1877,1902,2403,4425,5748,16355
2023-10-29,29,4466,1739,3388,2814,4708,17115
2023-10-30,29,1014,2687,2334,4193,2554,12782
2023-10-31,29,1665,2173,1701,4203,2722,12464
2023-11-01,29,2381,1843,1623,2196,4501,12544
2023-11-02,29,4676,2140,2193,3082,2799,14890
2023-11-03,29,2651,2076,2508,1989,3699,12923
2023-11-04,29,3109,2991,2475,1587,5627,15789
2023-11-05,29,4156,2358,1854,4128,5873,18369
2023-11-06,29,4060,2506,2228,3784,2293,14871
2023-11-07,29,3143,2910,3248,3919,4583,17803
2023-11-08,29,1542,2983,1406,3920,4767,14618
2023-11-09,29,2595,2373,2116,3820,2681,13585
2023-11-10,29,4687,2311,1654,3160,4130,15942
2023-11-11,29,1072,2752,2236,4352,5695,16107
2023-11-12,29,3717,2687,2451,1633,3048,13536
2023-11-13,29,3959,2462,1343,1666,2145,11575
2023-11-14,29,1748,2539,2434,1537,4210,12468
2023-11-15,29,2082,1342,1504,3115,4746,12789
2023-11-16,29,1326,1930,3343,2183,3387,12169
2023-11-17,29,4178,2226,3741,2249,4682,17076
2023-11-18,29,2297,2785,2337,3242,5046,15707
2023-11-19,29,1558,2693,3589,3557,4374,15771
2023-11-20,29,2536,2356,3013,3885,3566,15356
2023-11-21,29,4219,1440,2321,3869,3210,15059
2023-11-22,29,3022,1023,1532,3145,4522,13244
2023-11-23,29,4463,1633,2964,3783,5053,17896
2023-11-24,29,3119,1907,1703,4049,3036,13814
2023-11-25,29,3550,1471,3942,1684,5607,16254
2023-11-26,29,1824,2968,1867,1718,2971,11348
2023-11-27,29,2275,2872,3149,1926,4472,14694
2023-11-28,29,1195,2341,1720,3771,2606,11633
2023-11-29,29,3754,2327,3768,2797,2127,14773
2023-11-30,29,2371,1557,3143,2051,2097,11219
2023-12-01,29,3647,1285,2167,2742,4635,14476
2023-12-02,29,1674,1056,2496,2447,3827,11500
2023-12-03,29,2229,2614,2645,3027,3145,13660
2023-12-04,29,3712,1151,3529,3875,2305,14572
2023-12-05,29,3230,827,3542,3548,4710,15857
2023-12-06,29,2520,2158,1899,4417,5309,16303
2023-12-07,29,1099,2416,2957,4378,4269,15119
2023-12-08,29,3282,1879,1688,3613,3623,14085
2023-12-09,29,3107,1532,2736,2774,3538,13687
2023-12-10,29,1793,2255,1906,4232,4042,14228
2023-12-11,29,3253,1903,1901,1890,3204,12151
2023-12-12,29,2586,2808,1473,3163,5272,15302
2023-12-13,29,3554,1908,3448,3180,2040,14130
2023-12-14,29,1826,2814,3750,2297,2728,13415
2023-12-15,29,4979,1118,2607,4224,5145,18073
2023-12-16,29,4327,2057,2368,1521,2656,12929
2023-12-17,29,2169,1043,3573,4314,3287,14386
2023-12-18,29,2841,1145,2237,4473,2509,13205
2023-12-19,29,3477,1516,3178,1998,5624,15793
2023-12-20,29,2091,2894,2878,1519,2623,12005
2023-12-21,29,1334,2179,3830,3901,2522,13766
2023-12-22,29,3639,927,3816,3625,5508,17515
2023-12-23,29,3994,1565,3679,2489,3323,15050
2023-12-24,29,2235,2829,2792,1871,3797,13524
2023-12-25,29,2693,2122,2521,1840,2497,11673
2023-12-26,29,2219,1519,2258,1983,2594,10573
2023-12-27,29,2296,2503,3086,1890,2841,12616
2023-12-28,29,2997,2250,1922,3411,4848,15428
2023-12-29,29,4686,2873,3806,3759,4405,19529
2023-12-30,29,3602,1031,1742,2420,2040,10835
2023-12-31,29,1057,2558,3815,1742,3387,12559
2022-01-01,30,3143,2189,2473,1785,5789,15379
2022-01-02,30,4842,2780,3182,4305,5238,20347
2022-01-03,30,2214,2942,1964,2441,2267,11828
2022-01-04,30,3846,1273,2692,3811,4115,15737
2022-01-05,30,2785,1258,3925,2795,4756,15519
2022-01-06,30,4390,1609,2742,4089,3825,16655
2022-01-07,30,4507,2294,2986,3769,2896,16452
2022-01-08,30,3966,1138,3789,3560,3892,16345
2022-01-09,30,1723,2117,3355,4155,3087,14437
2022-01-10,30,1676,1295,2143,2656,5703,13473
2022-01-11,30,3025,1243,2964,2173,4268,13673
2022-01-12,30,1247,1366,1276,3441,4954,12284
2022-01-13,30,3436,1716,3023,3675,3977,15827
2022-01-14,30,4699,1746,2819,3748,2943,15955
2022-01-15,30,2466,1461,1575,3428,4405,13335
2022-01-16,30,3690,2123,2572,3062,3845,15292
2022-01-17,30,1302,1392,1473,2530,3490,10187
2022-01-18,30,1929,2441,3157,3808,5092,16427
2022-01-19,30,4191,2308,1295,2777,4758,15329
2022-01-20,30,4673,1023,2484,3708,5861,17749
2022-01-21,30,2971,1155,3038,2041,4497,13702
2022-01-22,30,3531,1741,2692,2803,4126,14893
2022-01-23,30,1077,1923,1972,3813,5717,14502
2022-01-24,30,2950,2567,1313,2488,5993,15311
2022-01-25,30,2248,919,1906,2112,5830,13015
2022-01-26,30,4682,1814,2749,4336,2018,15599
2022-01-27,30,4668,2138,3360,3425,3105,16696
2022-01-28,30,1014,1022,1690,3040,3653,10419
2022-01-29,30,1764,1203,1619,3726,4956,13268
2022-01-30,30,2468,1143,2266,4000,5631,15508
2022-01-31,30,4059,1796,3733,3326,3884,16798
2022-02-01,30,1272,2816,1512,3143,5396,14139
2022-02-02,30,4123,867,2707,1930,5219,14846
2022-02-03,30,2198,2080,1538,3732,4662,14210
2022-02-04,30,4063,2182,3720,2452,4552,16969
2022-02-05,30,2242,2455,2305,4444,3891,15337
2022-02-06,30,2008,2023,1623,2416,5994,14064
2022-02-07,30,3671,1040,3014,2250,2822,12797
2022-02-08,30,3000,945,1379,3307,2112,10743
2022-02-09,30,1232,2402,2855,3741,5316,15546
2022-02-10,30,4244,1999,1429,2065,2569,12306
2022-02-11,30,1418,1295,3304,2516,4976,13509
2022-02-12,30,2633,1783,3053,2495,3626,13590
2022-02-13,30,1543,1400,3209,1658,3465,11275
2022-02-14,30,4056,2995,3354,3451,3008,16864
2022-02-15,30,2334,1731,3101,3700,5443,16309
2022-02-16,30,4741,2108,3913,1621,2518,14901
2022-02-17,30,3627,2436,1367,2032,4350,13812
2022-02-18,30,2864,2970,2519,4473,3859,16685
2022-02-19,30,3185,2183,2617,3817,3035,14837
2022-02-20,30,2718,2301,3724,2296,4918,15957
2022-02-21,30,2251,2967,1624,3936,2920,13698
2022-02-22,30,4211,2118,1930,2326,3693,14278
2022-02-23,30,2565,1436,3945,2952,4341,15239
2022-02-24,30,4000,1707,3474,3847,4624,17652
2022-02-25,30,4672,2730,3415,2193,3690,16700
2022-02-26,30,3373,1050,1979,4155,3101,13658
2022-02-27,30,3788,1553,3996,2903,2545,14785
2022-02-28,30,4949,1888,1661,1581,3873,13952
2022-03-01,30,4122,2552,1573,3965,3537,15749
2022-03-02,30,4911,846,1750,2470,4722,14699
2022-03-03,30,2176,2702,2910,2962,2821,13571
2022-03-04,30,3350,2054,2198,2901,3102,13605
2022-03-05,30,1001,1020,2945,1727,4309,11002
2022-03-06,30,2832,1072,3764,4416,5656,17740
2022-03-07,30,3311,1834,2219,3365,3414,14143
2022-03-08,30,3042,1842,1217,4274,2373,12748
2022-03-09,30,2604,1078,1982,2787,5997,14448
2022-03-10,30,3490,2059,2575,2932,5835,16891
2022-03-11,30,1693,2202,2887,3057,3198,13037
2022-03-12,30,1233,2928,2305,3931,4912,15309
2022-03-13,30,4171,2280,3755,1781,3781,15768
2022-03-14,30,1523,1436,1917,3243,3145,11264
2022-03-15,30,4222,941,3051,4482,2284,14980
2022-03-16,30,4499,2147,2347,2169,4893,16055
2022-03-17,30,3384,1050,3723,3399,5729,17285
2022-03-18,30,1410,1718,3127,1915,4378,12548
2022-03-19,30,3214,2611,2266,4459,2229,14779
2022-03-20,30,3225,2957,1862,4134,4127,16305
2022-03-21,30,1789,1636,3247,2739,5046,14457
2022-03-22,30,2257,1787,2225,3212,3477,12958
2022-03-23,30,4031,1661,1644,1865,3935,13136
2022-03-24,30,3095,2564,1489,1887,3292,12327
2022-03-25,30,4681,2247,1598,2174,5208,15908
2022-03-26,30,3408,2270,2172,1515,5592,14957
2022-03-27,30,1788,2496,3742,2281,5382,15689
2022-03-28,30,2326,915,2012,2361,5058,12672
2022-03-29,30,3205,1917,2698,3483,5125,16428
2022-03-30,30,3321,1347,2282,3661,4269,14880
2022-03-31,30,2207,1441,1321,1655,3147,9771
2022-04-01,30,4351,2772,2770,4202,3730,17825
2022-04-02,30,1956,1461,2370,2223,2453,10463
2022-04-03,30,4814,821,2973,2910,4084,15602
2022-04-04,30,4756,2961,1587,4479,2271,16054
2022-04-05,30,3684,879,2166,2270,5400,14399
2022-04-06,30,1066,1336,3099,2874,5447,13822
2022-04-07,30,2467,1770,2434,1729,5996,14396
2022-04-08,30,1757,2513,1268,4366,5563,15467
2022-04-09,30,2606,1650,1300,2227,3190,10973
2022-04-10,30,2244,1951,2193,2721,4341,13450
2022-04-11,30,4915,1365,1454,1868,2577,12179
2022-04-12,30,3330,1126,2822,2303,2552,12133
2022-04-13,30,4795,2501,1897,1974,3832,14999
2022-04-14,30,1788,2933,3934,3927,3697,16279
2022-04-15,30,3619,2912,1936,2992,3636,15095
2022-04-16,30,4550,914,2482,3196,3669,14811
2022-04-17,30,1284,1579,3406,1673,2750,10692
2022-04-18,30,4159,2018,3642,3590,2087,15496
2022-04-19,30,3043,1576,3796,1782,5329,15526
2022-04-20,30,2829,1938,2956,2646,4428,14797
2022-04-21,30,1214,2511,1422,2814,5568,13529
2022-04-22,30,3827,1891,3600,2272,2739,14329
2022-04-23,30,2747,2884,1683,3817,4018,15149
2022-04-24,30,2318,2905,1917,4030,3872,15042
2022-04-25,30,4549,1363,3922,1754,3134,14722
2022-04-26,30,1999,2974,3440,2604,3861,14878
2022-04-27,30,2318,2228,3329,2170,3197,13242
2022-04-28,30,1331,2586,2014,2655,5266,13852
2022-04-29,30,2797,2255,3067,3071,4578,15768
2022-04-30,30,1960,2611,3710,1987,4876,15144
2022-05-01,30,1413,2814,3492,4101,4696,16516
2022-05-02,30,1921,1494,3160,1983,5949,14507
2022-05-03,30,1389,2202,3497,3896,4056,15040
2022-05-04,30,3289,2361,1580,1571,5621,14422
2022-05-05,30,1374,2084,2232,4068,4281,14039
2022-05-06,30,4576,951,3606,3023,4089,16245
2022-05-07,30,1749,2561,3807,2411,4434,14962
2022-05-08,30,2022,991,1221,2754,4768,11756
2022-05-09,30,4462,1494,2383,1809,2287,12435
2022-05-10,30,4389,1013,1810,2721,4160,14093
2022-05-11,30,1703,1477,1794,4161,5152,14287
2022-05-12,30,3245,1647,3985,3294,5531,17702
2022-05-13,30,1796,2293,3167,4085,3549,14890
2022-05-14,30,1160,1633,2678,3440,3686,12597
2022-05-15,30,1197,1606,1228,2933,4559,11523
2022-05-16,30,4092,2679,2538,3821,5224,18354
2022-05-17,30,4344,2760,3021,3728,4193,18046
2022-05-18,30,1936,919,2461,2116,2810,10242
2022-05-19,30,1224,1614,2066,2812,3529,11245
2022-05-20,30,4813,2589,2972,3243,3453,17070
2022-05-21,30,3433,938,2457,4206,4675,15709
2022-05-22,30,2158,2794,1393,3213,3160,12718
2022-05-23,30,3088,2222,1606,3959,4595,15470
2022-05-24,30,3852,2136,1384,4300,2396,14068
2022-05-25,30,4995,1303,3347,1947,2848,14440
2022-05-26,30,1683,1982,3414,3454,4234,14767
2022-05-27,30,1261,1166,1968,2103,5316,11814
2022-05-28,30,4967,2126,2659,3912,2042,15706
2022-05-29,30,3552,1763,3620,3675,2958,15568
2022-05-30,30,3757,1429,1905,3906,3619,14616
2022-05-31,30,1474,962,3286,3222,5042,13986
2022-06-01,30,2090,2334,1395,1791,2928,10538
2022-06-02,30,1402,1191,2781,2077,4163,11614
2022-06-03,30,1888,2183,1667,3796,3992,13526
2022-06-04,30,1497,1591,1752,2305,4286,11431
2022-06-05,30,1052,1125,1659,1809,3433,9078
2022-06-06,30,2678,1415,2525,4136,4804,15558
2022-06-07,30,3856,2833,2413,2128,4000,15230
2022-06-08,30,2303,2501,1727,3955,3673,14159
2022-06-09,30,4796,2241,3806,2991,2265,16099
2022-06-10,30,1334,2382,3941,1842,2206,11705
2022-06-11,30,2247,978,1873,4315,5725,15138
2022-06-12,30,4040,1386,1833,2682,5280,15221
2022-06-13,30,3257,2037,3937,2214,4062,15507
2022-06-14,30,2592,2824,1734,1992,3108,12250
2022-06-15,30,4494,1538,2015,3020,2446,13513
2022-06-16,30,4815,1374,3349,2492,4810,16840
2022-06-17,30,1591,1302,3286,3727,2721,12627
2022-06-18,30,3902,2729,3886,3650,2619,16786
2022-06-19,30,1478,1158,2799,1748,4620,11803
2022-06-20,30,4766,1598,2989,1700,2351,13404
2022-06-21,30,3643,2868,1691,4330,3066,15598
2022-06-22,30,3047,1758,1500,2412,5306,14023
2022-06-23,30,3940,1995,3626,3506,3324,16391
2022-06-24,30,1948,1497,2731,1607,5473,13256
2022-06-25,30,1948,836,2032,3796,5629,14241
2022-06-26,30,2583,2497,3900,2935,3689,15604
2022-06-27,30,3360,1146,2336,3277,2443,12562
2022-06-28,30,1890,2710,1953,3077,2300,11930
2022-06-29,30,3750,2745,1661,2415,5113,15684
2022-06-30,30,3137,2213,3641,1724,2589,13304
2022-07-01,30,4928,1799,2257,2541,4695,16220
2022-07-02,30,4226,1536,2436,1733,5497,15428
2022-07-03,30,2061,2123,2504,1516,3246,11450
2022-07-04,30,4226,1120,1439,2092,4080,12957
2022-07-05,30,1041,2402,3317,4375,5569,16704
2022-07-06,30,3608,2397,3278,1900,2744,13927
2022-07-07,30,1829,2317,2929,4051,5680,16806
2022-07-08,30,2970,2721,2073,1854,5661,15279
2022-07-09,30,4118,1269,3620,2520,5124,16651
2022-07-10,30,2038,2259,1328,3728,3305,12658
2022-07-11,30,3186,1375,2769,3568,2702,13600
2022-07-12,30,1674,1664,2467,3689,3763,13257
2022-07-13,30,2001,1889,1763,4163,4967,14783
2022-07-14,30,4465,1057,2056,1766,4849,14193
2022-07-15,30,2401,1682,3507,3401,2408,13399
2022-07-16,30,1335,1323,1469,4114,5126,13367
2022-07-17,30,3263,1015,2210,1847,3918,12253
2022-07-18,30,2801,2287,3920,4146,3294,16448
2022-07-19,30,2050,2841,1905,3087,3027,12910
2022-07-20,30,2335,2189,3367,3044,2779,13714
2022-07-21,30,4970,2191,2563,3942,5533,19199
2022-07-22,30,1469,2103,3545,4425,2534,14076
2022-07-23,30,2788,1917,3679,3261,2208,13853
2022-07-24,30,4485,1488,2532,2554,4271,15330
2022-07-25,30,4007,2328,3159,3070,4829,17393
2022-07-26,30,1386,2526,2485,2349,4952,13698
2022-07-27,30,2674,2228,2687,1507,2165,11261
2022-07-28,30,1473,2458,2813,3676,2752,13172
2022-07-29,30,1320,1772,1764,3563,4519,12938
2022-07-30,30,4999,2111,3768,2861,4803,18542
2022-07-31,30,2762,2617,3568,1537,3060,13544
2022-08-01,30,1808,2666,3460,3975,4820,16729
2022-08-02,30,3884,1796,3792,2348,3574,15394
2022-08-03,30,4356,1190,2296,3046,4670,15558
2022-08-04,30,3599,1796,3710,2879,4734,16718
2022-08-05,30,4827,1304,1819,3267,2755,13972
2022-08-06,30,3031,2952,1912,2446,4059,14400
2022-08-07,30,2692,2324,2149,2714,5836,15715
2022-08-08,30,3564,1888,1757,2700,3997,13906
2022-08-09,30,4067,2076,3259,3180,5114,17696
2022-08-10,30,2505,2772,2131,3339,3437,14184
2022-08-11,30,3615,2891,2238,3288,4479,16511
2022-08-12,30,3275,2132,3317,4454,2352,15530
2022-08-13,30,1475,2201,2364,3776,3731,13547
2022-08-14,30,2542,1947,3695,1596,5909,15689
2022-08-15,30,4181,1265,3901,3496,4116,16959
2022-08-16,30,3020,948,1513,3978,3677,13136
2022-08-17,30,4584,1186,2138,4455,4695,17058
2022-08-18,30,2106,2345,2925,1752,3176,12304
2022-08-19,30,3304,2184,3319,2645,2500,13952
2022-08-20,30,1966,2204,2274,2722,5802,14968
2022-08-21,30,4610,1602,3167,2175,2702,14256
2022-08-22,30,1878,2432,2749,2840,2317,12216
2022-08-23,30,1627,2133,1387,1693,5643,12483
2022-08-24,30,3990,2828,1475,4009,5775,18077
2022-08-25,30,4846,1556,1747,2497,3783,14429
2022-08-26,30,2748,997,1683,2898,4921,13247
2022-08-27,30,4580,2084,1778,2891,3344,14677
2022-08-28,30,2383,1781,2719,3095,5311,15289
2022-08-29,30,4170,1117,2800,4260,3334,15681
2022-08-30,30,3571,2662,2527,1983,2347,13090
2022-08-31,30,2395,2630,2742,3937,5679,17383
2022-09-01,30,4955,913,3523,4008,2595,15994
2022-09-02,30,1046,1621,1639,3442,3125,10873
2022-09-03,30,3618,1679,3405,3954,5050,17706
2022-09-04,30,3632,913,3164,2887,3923,14519
2022-09-05,30,1990,1450,3270,2987,2749,12446
2022-09-06,30,2741,2054,2958,3445,4271,15469
2022-09-07,30,4580,1533,1595,1678,4895,14281
2022-09-08,30,4182,2881,3651,4042,4136,18892
2022-09-09,30,4608,2075,2697,3171,5923,18474
2022-09-10,30,1662,1676,3293,3140,2885,12656
2022-09-11,30,2943,1464,2984,3613,3227,14231
2022-09-12,30,4907,2842,1642,2166,5187,16744
2022-09-13,30,4825,2865,2676,2465,4561,17392
2022-09-14,30,1750,1097,2321,1600,3715,10483
2022-09-15,30,1249,1716,3113,2883,2037,10998
2022-09-16,30,3056,829,1271,4224,5169,14549
2022-09-17,30,3509,1820,2550,1746,5368,14993
2022-09-18,30,1590,1356,2398,3279,3162,11785
2022-09-19,30,1746,2662,2490,1959,3776,12633
2022-09-20,30,2017,1932,1234,2232,2715,10130
2022-09-21,30,3687,2420,1628,3964,5286,16985
2022-09-22,30,1134,1237,3297,3895,3873,13436
2022-09-23,30,2608,2446,3010,3729,2495,14288
2022-09-24,30,3355,1655,2046,4011,4299,15366
2022-09-25,30,1841,1528,1470,3546,5160,13545
2022-09-26,30,3034,1961,2482,2422,3435,13334
2022-09-27,30,4336,1065,1614,4226,3207,14448
2022-09-28,30,1228,2094,2672,3565,5454,15013
2022-09-29,30,4142,2872,2103,2930,5352,17399
2022-09-30,30,3773,2549,2908,2706,2024,13960
2022-10-01,30,1249,1409,2241,4332,3248,12479
2022-10-02,30,2684,1527,3888,4193,5113,17405
2022-10-03,30,4189,1131,1431,1639,5289,13679
2022-10-04,30,4423,1946,1421,1984,2318,12092
2022-10-05,30,4879,2542,3726,3054,2582,16783
2022-10-06,30,1647,1394,1997,4445,4262,13745
2022-10-07,30,3541,2111,1606,4461,3111,14830
2022-10-08,30,4131,1843,2318,4109,2298,14699
2022-10-09,30,2770,2270,3949,1583,3139,13711
2022-10-10,30,2620,2291,2203,2784,4957,14855
2022-10-11,30,3584,2626,3580,2830,2586,15206
2022-10-12,30,3319,2646,3596,3410,3483,16454
2022-10-13,30,2198,2577,2368,3777,2658,13578
2022-10-14,30,4369,844,3788,3907,4684,17592
2022-10-15,30,3749,1939,3610,2582,3398,15278
2022-10-16,30,1033,897,3324,1596,5293,12143
2022-10-17,30,3155,2785,1782,3586,5462,16770
2022-10-18,30,2192,2503,2750,2536,4225,14206
2022-10-19,30,2805,2276,1397,3219,4994,14691
2022-10-20,30,3672,2342,2187,2181,3637,14019
2022-10-21,30,1909,1540,1991,2672,4226,12338
2022-10-22,30,3503,1240,2283,3656,4965,15647
2022-10-23,30,1791,1599,1941,4448,2524,12303
2022-10-24,30,4144,1652,3767,1502,4295,15360
2022-10-25,30,2657,2507,1866,2147,5516,14693
2022-10-26,30,2216,2309,2427,3810,4363,15125
2022-10-27,30,4975,2539,1831,1563,5768,16676
2022-10-28,30,1189,2827,2305,3579,3173,13073
2022-10-29,30,2915,2438,2408,4500,2962,15223
2022-10-30,30,2095,2760,2859,3291,2450,13455
2022-10-31,30,3568,975,2671,3204,5466,15884
2022-11-01,30,4049,1916,3586,4156,2105,15812
2022-11-02,30,3092,1264,2792,3526,2673,13347
2022-11-03,30,2930,1210,2643,3523,3653,13959
2022-11-04,30,2910,1630,3539,3595,5174,16848
2022-11-05,30,3298,1088,1995,3777,5513,15671
2022-11-06,30,1784,1958,1286,3198,4480,12706
2022-11-07,30,3039,1169,2787,4075,4613,15683
2022-11-08,30,2759,1878,1951,3623,5347,15558
2022-11-09,30,1467,1122,3087,1564,5199,12439
2022-11-10,30,2836,1699,1520,4461,4319,14835
2022-11-11,30,3393,869,3534,3415,2406,13617
2022-11-12,30,1775,2811,1949,3912,2180,12627
2022-11-13,30,4088,2972,3655,3695,2830,17240
2022-11-14,30,2374,1071,2829,3978,2462,12714
2022-11-15,30,2969,1314,1292,1542,3349,10466
2022-11-16,30,4413,1425,3459,3178,5944,18419
2022-11-17,30,3676,1972,3239,1750,5406,16043
2022-11-18,30,1117,1739,1239,1511,5406,11012
2022-11-19,30,1855,2436,2063,3659,5461,15474
2022-11-20,30,4067,1003,2038,4139,3689,14936
2022-11-21,30,2859,839,1439,3145,2671,10953
2022-11-22,30,1667,2260,1293,2603,4664,12487
2022-11-23,30,1209,2263,3871,1820,5189,14352
2022-11-24,30,3671,2162,3146,3363,2991,15333
2022-11-25,30,2596,1008,2681,1863,4256,12404
2022-11-26,30,3347,2162,1364,3519,4828,15220
2022-11-27,30,4179,1366,3634,3119,2416,14714
2022-11-28,30,1795,1179,2554,3015,4988,13531
2022-11-29,30,3823,1716,2731,4072,4193,16535
2022-11-30,30,1885,1304,2414,4272,5481,15356
2022-12-01,30,1791,1260,2061,1893,4388,11393
2022-12-02,30,1525,2775,1381,4131,4240,14052
2022-12-03,30,2572,2152,2416,3274,3027,13441
2022-12-04,30,2602,2844,3908,2758,3405,15517
2022-12-05,30,3474,1560,1652,1754,3444,11884
2022-12-06,30,1736,2611,3508,3333,3877,15065
2022-12-07,30,3348,2608,1834,2726,3832,14348
2022-12-08,30,3465,1703,2067,1510,4759,13504
2022-12-09,30,1604,1474,1315,2381,2741,9515
2022-12-10,30,2477,2775,1436,3870,2230,12788
2022-12-11,30,2413,1524,3557,3205,5428,16127
2022-12-12,30,1626,1440,1502,1754,2333,8655
2022-12-13,30,1076,2099,1271,2813,3939,11198
2022-12-14,30,4598,1370,2436,3627,2465,14496
2022-12-15,30,2890,2582,3399,3856,5124,17851
2022-12-16,30,2708,2418,1419,4334,4729,15608
2022-12-17,30,4435,838,2976,2970,3036,14255
2022-12-18,30,3620,1539,3379,3058,4879,16475
2022-12-19,30,1069,2483,3278,4493,4575,15898
2022-12-20,30,1871,1469,3913,4252,2408,13913
2022-12-21,30,2667,2712,1704,2278,5251,14612
2022-12-22,30,2275,1890,3004,4316,5096,16581
2022-12-23,30,2654,1275,1648,3296,4697,13570
2022-12-24,30,4085,1455,2446,3244,5130,16360
2022-12-25,30,2535,1665,3134,2160,5832,15326
2022-12-26,30,3763,1222,2789,3725,5721,17220
2022-12-27,30,3358,2462,3547,3480,4112,16959
2022-12-28,30,4805,1923,2298,2280,5024,16330
2022-12-29,30,1761,2408,3071,3124,4827,15191
2022-12-30,30,1951,1359,3310,3194,3468,13282
2022-12-31,30,3037,2766,3398,4304,2036,15541
2023-01-01,30,1277,2894,1241,2506,3651,11569
2023-01-02,30,4621,1794,2873,1985,2682,13955
2023-01-03,30,3887,2750,3433,3394,2250,15714
2023-01-04,30,2210,1345,1472,2608,2986,10621
2023-01-05,30,3431,2774,2628,2342,4710,15885
2023-01-06,30,2158,1365,2412,1929,5025,12889
2023-01-07,30,4655,1259,2737,2460,5758,16869
2023-01-08,30,3673,2384,2766,3904,4503,17230
2023-01-09,30,4331,2211,3727,4392,2426,17087
2023-01-10,30,1738,1480,1753,3853,2660,11484
2023-01-11,30,4353,1558,2844,1992,4071,14818
2023-01-12,30,3864,2723,1823,4397,3401,16208
2023-01-13,30,3251,2759,2988,2746,3183,14927
2023-01-14,30,1657,1166,2642,2459,4742,12666
2023-01-15,30,4168,1677,3131,2619,3734,15329
2023-01-16,30,3500,1853,2304,1672,5822,15151
2023-01-17,30,1144,2560,2546,2856,4842,13948
2023-01-18,30,2357,2795,3096,4206,3058,15512
2023-01-19,30,1197,2349,2023,3330,3331,12230
2023-01-20,30,4228,1312,2699,2290,3091,13620
2023-01-21,30,1833,1035,1968,2449,3524,10809
2023-01-22,30,1639,2051,2499,1966,2393,10548
2023-01-23,30,2107,2049,2867,3210,5657,15890
2023-01-24,30,3539,1795,2228,1854,5386,14802
2023-01-25,30,3500,889,2339,2414,2477,11619
2023-01-26,30,1035,1575,3256,3601,5920,15387
2023-01-27,30,1233,1413,2083,2131,3411,10271
2023-01-28,30,2960,1148,3073,3543,2060,12784
2023-01-29,30,4662,1528,2999,3095,2134,14418
2023-01-30,30,3740,1621,1255,3813,4785,15214
2023-01-31,30,1482,2021,2030,1791,5557,12881
2023-02-01,30,1518,2020,3275,3255,4765,14833
2023-02-02,30,1334,2144,2262,3143,5146,14029
2023-02-03,30,4641,2868,2992,1986,5534,18021
2023-02-04,30,4575,1199,2677,2937,3369,14757
2023-02-05,30,1513,1539,2756,2360,4822,12990
2023-02-06,30,4695,819,3362,3595,2538,15009
2023-02-07,30,2993,1239,1962,2330,5778,14302
2023-02-08,30,1220,1651,2664,3776,3354,12665
2023-02-09,30,4290,2836,2314,3833,4403,17676
2023-02-10,30,1803,2365,3037,3344,4687,15236
2023-02-11,30,1649,1451,3561,4211,5900,16772
2023-02-12,30,1680,892,3162,2037,4711,12482
2023-02-13,30,2370,1074,2606,1960,5465,13475
2023-02-14,30,3280,2523,3132,3717,2448,15100
2023-02-15,30,3404,1265,2897,4297,5068,16931
2023-02-16,30,1142,2932,3099,2133,5555,14861
2023-02-17,30,4117,1899,2210,2921,2556,13703
2023-02-18,30,3495,2873,2607,2216,3565,14756
2023-02-19,30,4951,2649,2537,3536,2779,16452
2023-02-20,30,2462,1723,2482,2908,5801,15376
2023-02-21,30,3369,2649,3290,1779,3787,14874
2023-02-22,30,2320,2391,3941,2968,3279,14899
2023-02-23,30,3116,1189,2642,2629,2287,11863
2023-02-24,30,1118,1135,3074,2279,3030,10636
2023-02-25,30,4592,2351,1412,3697,2889,14941
2023-02-26,30,4480,1376,3720,1765,2808,14149
2023-02-27,30,4788,1341,1630,1598,2082,11439
2023-02-28,30,3590,1942,2160,2440,3256,13388
2023-03-01,30,4728,1159,3790,2918,4505,17100
2023-03-02,30,3089,2639,1670,3746,5939,17083
2023-03-03,30,3340,2175,1775,3618,2608,13516
2023-03-04,30,2002,2474,1462,1845,2975,10758
2023-03-05,30,2429,1926,3330,3237,5916,16838
2023-03-06,30,2167,1492,3609,3725,3268,14261
2023-03-07,30,2034,1412,2204,2605,2479,10734
2023-03-08,30,1905,1110,1511,2883,5240,12649
2023-03-09,30,3922,2235,3555,2604,2490,14806
2023-03-10,30,1142,2466,2307,4326,4656,14897
2023-03-11,30,2147,939,3789,4442,3942,15259
2023-03-12,30,3705,1187,1627,2743,5285,14547
2023-03-13,30,3959,2989,2408,3042,2143,14541
2023-03-14,30,4582,866,2359,3779,3066,14652
2023-03-15,30,3641,804,3373,2751,3325,13894
2023-03-16,30,2749,2653,3298,2051,3764,14515
2023-03-17,30,2328,1535,2160,3089,4169,13281
2023-03-18,30,2166,2615,3204,2435,5364,15784
2023-03-19,30,3647,2637,3806,4444,4902,19436
2023-03-20,30,4497,944,3439,1781,3240,13901
2023-03-21,30,2917,2778,2180,2484,3615,13974
2023-03-22,30,3415,805,3331,2263,2084,11898
2023-03-23,30,4443,1495,1933,4089,5457,17417
2023-03-24,30,2879,1898,3813,2660,5687,16937
2023-03-25,30,1616,2407,2769,2858,2561,12211
2023-03-26,30,1000,1315,2459,3710,4441,12925
2023-03-27,30,2588,2071,2561,2162,5987,15369
2023-03-28,30,4370,2954,3073,3182,4153,17732
2023-03-29,30,4888,2470,1858,1835,2701,13752
2023-03-30,30,4882,2350,2285,3246,4694,17457
2023-03-31,30,3618,2487,1614,3423,5775,16917
2023-04-01,30,2152,2885,3013,2321,5490,15861
2023-04-02,30,2985,2305,2440,3564,5933,17227
2023-04-03,30,1562,2066,3522,2501,5799,15450
2023-04-04,30,4800,2754,3767,2300,5182,18803
2023-04-05,30,1577,2178,3543,3013,2473,12784
2023-04-06,30,3988,987,3878,1948,3069,13870
2023-04-07,30,4345,1730,1667,1985,4531,14258
2023-04-08,30,4960,1972,3516,1902,5690,18040
2023-04-09,30,2519,888,2530,3384,4270,13591
2023-04-10,30,2255,1306,3211,2139,4778,13689
2023-04-11,30,4111,2428,3911,2107,5223,17780
2023-04-12,30,2278,1254,2811,2853,4701,13897
2023-04-13,30,1777,1691,1465,3805,3709,12447
2023-04-14,30,2623,1317,3289,4104,5729,17062
2023-04-15,30,1810,1633,1819,2000,5783,13045
2023-04-16,30,2339,1278,1318,2754,5618,13307
2023-04-17,30,4110,2689,2733,3358,4564,17454
2023-04-18,30,3229,1703,3908,4160,2492,15492
2023-04-19,30,1164,2062,2589,4249,2932,12996
2023-04-20,30,2577,1377,3218,3758,5977,16907
2023-04-21,30,2807,2489,3974,1578,4386,15234
2023-04-22,30,1630,2616,1541,1676,5406,12869
2023-04-23,30,4585,1707,1587,3989,5110,16978
2023-04-24,30,3153,1279,3259,1620,5768,15079
2023-04-25,30,3337,1624,2854,1642,3705,13162
2023-04-26,30,3640,2050,2474,4367,5822,18353
2023-04-27,30,4589,983,3403,2245,5236,16456
2023-04-28,30,1040,2045,1492,2973,2281,9831
2023-04-29,30,2066,1392,3093,3024,5696,15271
2023-04-30,30,3606,950,2366,3112,5210,15244
2023-05-01,30,4608,2360,2810,1739,3320,14837
2023-05-02,30,2597,2271,3091,4062,2792,14813
2023-05-03,30,3465,2114,2227,2431,3068,13305
2023-05-04,30,3753,1549,1875,3551,4056,14784
2023-05-05,30,1314,2763,3457,3559,3046,14139
2023-05-06,30,3864,1144,2659,3190,3069,13926
2023-05-07,30,4123,1416,3543,1543,5203,15828
2023-05-08,30,1595,2213,1245,3973,4027,13053
2023-05-09,30,1823,1281,1895,2958,4839,12796
2023-05-10,30,4652,2591,1645,4273,4070,17231
2023-05-11,30,4667,2071,1614,3947,5652,17951
2023-05-12,30,1813,2018,3106,4283,3963,15183
2023-05-13,30,2455,1862,1580,2346,5723,13966
2023-05-14,30,4169,2849,2276,2152,5680,17126
2023-05-15,30,4805,2685,3014,4463,3280,18247
2023-05-16,30,4551,2937,2881,1519,5365,17253
2023-05-17,30,1306,2348,1415,4315,3394,12778
2023-05-18,30,4586,1830,1524,2725,5424,16089
2023-05-19,30,3819,963,1925,4334,2668,13709
2023-05-20,30,3587,909,1375,3529,2037,11437
2023-05-21,30,4483,1056,3567,2298,3099,14503
2023-05-22,30,3235,1240,1835,2919,3201,12430
2023-05-23,30,1302,1717,1452,2581,2391,9443
2023-05-24,30,1094,1105,3533,4172,4428,14332
2023-05-25,30,4467,2148,2341,1567,5667,16190
2023-05-26,30,4160,2329,3587,4112,4934,19122
2023-05-27,30,3886,2259,3919,1765,4227,16056
2023-05-28,30,4847,2204,3840,3198,5121,19210
2023-05-29,30,3798,1881,1934,2723,2179,12515
2023-05-30,30,3972,2578,3768,2053,2205,14576
2023-05-31,30,3839,1384,1931,2285,2881,12320
2023-06-01,30,1234,2363,2777,1655,5226,13255
2023-06-02,30,4825,1599,1864,3267,4962,16517
2023-06-03,30,1592,2372,2557,2673,3692,12886
2023-06-04,30,2229,1351,3114,3386,4055,14135
2023-06-05,30,4083,1903,1678,4209,4001,15874
2023-06-06,30,2683,1850,1861,2173,5141,13708
2023-06-07,30,3585,1948,2036,2081,5811,15461
2023-06-08,30,1704,2046,3210,2080,3913,12953
2023-06-09,30,1954,2727,2338,3943,4614,15576
2023-06-10,30,1708,1149,2609,3522,4026,13014
2023-06-11,30,3294,2113,2536,2308,5953,16204
2023-06-12,30,1629,1339,2544,4342,4019,13873
2023-06-13,30,2645,2064,3435,3990,3017,15151
2023-06-14,30,4102,2878,1273,4334,2609,15196
2023-06-15,30,2125,2906,2162,2951,3428,13572
2023-06-16,30,1029,934,3477,3069,5467,13976
2023-06-17,30,2322,2828,2987,3318,3467,14922
2023-06-18,30,2502,2081,3437,2964,5699,16683
2023-06-19,30,3800,1625,3551,3861,2302,15139
2023-06-20,30,4111,2721,2511,2782,3252,15377
2023-06-21,30,4167,2742,2026,3083,4739,16757
2023-06-22,30,3793,1375,2972,1755,3099,12994
2023-06-23,30,3418,2746,3617,2276,5512,17569
2023-06-24,30,2527,933,1927,3854,3409,12650
2023-06-25,30,4616,1575,2345,1671,2441,12648
2023-06-26,30,3313,1289,3522,1583,2005,11712
2023-06-27,30,3777,1774,2208,1691,5835,15285
2023-06-28,30,1909,2430,3109,4227,5380,17055
2023-06-29,30,1436,1442,1617,1788,2427,8710
2023-06-30,30,4463,1005,3655,2243,2112,13478
2023-07-01,30,1358,2149,3708,4290,2593,14098
2023-07-02,30,4045,1957,1637,1991,5423,15053
2023-07-03,30,4687,2159,2566,3312,5757,18481
2023-07-04,30,2386,1192,2691,4228,2559,13056
2023-07-05,30,4543,2741,3362,3595,5506,19747
2023-07-06,30,2400,2779,1343,2396,3195,12113
2023-07-07,30,1567,2645,2081,1871,5897,14061
2023-07-08,30,1724,1295,1587,3812,2629,11047
2023-07-09,30,2151,1164,2313,3231,2683,11542
2023-07-10,30,4476,878,2149,2174,3383,13060
2023-07-11,30,2872,1382,3201,2409,3083,12947
2023-07-12,30,2288,1030,1713,1760,4388,11179
2023-07-13,30,2449,2128,3894,4081,3657,16209
2023-07-14,30,3980,1637,1788,3025,4085,14515
2023-07-15,30,4737,2601,1539,2569,3965,15411
2023-07-16,30,2759,2828,3935,2490,4077,16089
2023-07-17,30,1934,1642,3812,3223,4276,14887
2023-07-18,30,2346,2293,2346,3196,3319,13500
2023-07-19,30,3423,1447,3294,3412,2656,14232
2023-07-20,30,3597,1947,2251,3134,4902,15831
2023-07-21,30,1320,1756,3862,2531,2663,12132
2023-07-22,30,3334,1368,3867,2683,3912,15164
2023-07-23,30,1530,2603,2279,3045,4163,13620
2023-07-24,30,3642,1849,3820,4424,4640,18375
2023-07-25,30,3920,1542,1373,4118,2513,13466
2023-07-26,30,2400,1282,2261,3676,3008,12627
2023-07-27,30,3858,1035,1264,4403,3442,14002
2023-07-28,30,4577,2348,1892,3925,4886,17628
2023-07-29,30,3641,1711,3838,2573,5147,16910
2023-07-30,30,4671,2377,3463,3188,4904,18603
2023-07-31,30,2259,1609,1718,3230,4439,13255
2023-08-01,30,3285,1594,1684,1881,4789,13233
2023-08-02,30,3463,1331,1364,2461,2642,11261
2023-08-03,30,2083,1214,3376,2055,5646,14374
2023-08-04,30,2802,1135,3236,2022,5354,14549
2023-08-05,30,1823,2128,2687,4358,4065,15061
2023-08-06,30,3716,1728,3425,1680,3914,14463
2023-08-07,30,4465,1952,1555,3824,5155,16951
2023-08-08,30,1025,2947,1501,4268,4260,14001
2023-08-09,30,1913,2762,3239,3377,3029,14320
2023-08-10,30,1826,2744,1228,3567,2116,11481
2023-08-11,30,3951,1092,3051,1701,2441,12236
2023-08-12,30,4572,870,2825,3180,5368,16815
2023-08-13,30,4038,1372,2907,1614,2451,12382
2023-08-14,30,4190,2101,1626,2529,2770,13216
2023-08-15,30,1685,1576,3008,2030,4420,12719
2023-08-16,30,1479,1218,1460,4155,4992,13304
2023-08-17,30,1453,1439,2156,4149,5035,14232
2023-08-18,30,4184,2034,3568,2200,3420,15406
2023-08-19,30,4134,2238,1540,4155,5292,17359
2023-08-20,30,2346,893,1555,3673,4825,13292
2023-08-21,30,2093,1378,1589,3224,3950,12234
2023-08-22,30,2030,1899,3993,2457,3611,13990
2023-08-23,30,3634,2405,3507,1708,5525,16779
2023-08-24,30,2526,1386,1970,2457,2285,10624
2023-08-25,30,4553,1817,2843,4161,3626,17000
2023-08-26,30,4778,2122,2926,4252,4826,18904
2023-08-27,30,2412,1252,3039,2960,3389,13052
2023-08-28,30,2593,2442,3441,3639,2179,14294
2023-08-29,30,4080,2140,2582,4347,2792,15941
2023-08-30,30,3160,1810,2083,2745,2358,12156
2023-08-31,30,1996,2867,3324,2833,2327,13347
2023-09-01,30,3194,2286,3209,2407,2978,14074
2023-09-02,30,3149,1131,2788,2690,4171,13929
2023-09-03,30,2897,1175,2097,3674,4901,14744
2023-09-04,30,2550,1934,1301,4199,3582,13566
2023-09-05,30,3768,830,1210,2345,2102,10255
2023-09-06,30,4348,945,3850,2538,4374,16055
2023-09-07,30,1476,1057,2759,1615,2295,9202
2023-09-08,30,1117,1474,2419,4065,4869,13944
2023-09-09,30,4474,1478,2971,4414,2992,16329
2023-09-10,30,2787,1460,1657,2390,5921,14215
2023-09-11,30,1149,1075,2500,2088,3534,10346
2023-09-12,30,3599,2981,2720,1627,5952,16879
2023-09-13,30,1929,1064,1938,4277,2771,11979
2023-09-14,30,3218,2058,2092,1723,5097,14188
2023-09-15,30,3429,2561,3275,3128,4197,16590
2023-09-16,30,1825,1712,3553,3028,3906,14024
2023-09-17,30,2361,2039,3352,3164,5317,16233
2023-09-18,30,4687,2410,1750,3378,3387,15612
2023-09-19,30,3636,2295,1525,3405,3544,14405
2023-09-20,30,3889,2048,1595,3981,5471,16984
2023-09-21,30,3891,2186,2045,1922,2039,12083
2023-09-22,30,1737,838,3474,1715,4231,11995
2023-09-23,30,3586,2162,3004,1938,5941,16631
2023-09-24,30,3156,2692,1492,1697,3931,12968
2023-09-25,30,4812,1740,1446,1553,3959,13510
2023-09-26,30,3842,2456,1640,3780,5680,17398
2023-09-27,30,3929,2600,2684,1732,5935,16880
2023-09-28,30,1423,2767,1840,1801,3042,10873
2023-09-29,30,4669,1968,1980,2731,5652,17000
2023-09-30,30,3884,1027,2613,4353,3110,14987
2023-10-01,30,2084,2999,2722,3899,2983,14687
2023-10-02,30,4145,1746,2474,1697,3768,13830
2023-10-03,30,1098,2364,2707,2374,4605,13148
2023-10-04,30,1857,2552,2083,3362,4240,14094
2023-10-05,30,2498,1346,3308,2385,3103,12640
2023-10-06,30,2708,1486,3346,2874,4198,14612
2023-10-07,30,4675,2042,1397,4322,2516,14952
2023-10-08,30,3881,1568,3491,2779,4590,16309
2023-10-09,30,2951,1724,3592,3799,2874,14940
2023-10-10,30,1794,1753,3374,2330,3203,12454
2023-10-11,30,3793,935,2802,3716,5004,16250
2023-10-12,30,1268,1796,3335,3638,4814,14851
2023-10-13,30,1094,2227,3629,2796,3346,13092
2023-10-14,30,3884,1756,1358,2674,5122,14794
2023-10-15,30,2455,1553,1493,3106,2158,10765
2023-10-16,30,2307,2904,2470,4418,4960,17059
2023-10-17,30,2038,2261,2800,3003,2466,12568
2023-10-18,30,1814,1422,3578,3256,2080,12150
2023-10-19,30,1655,2279,2057,4265,4600,14856
2023-10-20,30,2187,2748,3525,2415,5931,16806
2023-10-21,30,2756,1746,3475,2611,4856,15444
2023-10-22,30,1495,1598,2100,2508,4366,12067
2023-10-23,30,3789,2746,3432,4440,3493,17900
2023-10-24,30,1847,1141,3652,3303,3987,13930
2023-10-25,30,3072,925,3422,3478,5237,16134
2023-10-26,30,1885,2103,1406,2531,3695,11620
2023-10-27,30,2675,1617,1581,1854,2875,10602
2023-10-28,30,4628,2530,3120,2847,2433,15558
2023-10-29,30,4864,1695,3919,3044,5924,19446
2023-10-30,30,2117,1717,2654,2583,2288,11359
2023-10-31,30,2638,1930,2927,3367,3223,14085
2023-11-01,30,2715,868,2533,2277,5162,13555
2023-11-02,30,1525,1435,2461,3009,4626,13056
2023-11-03,30,3052,2902,1469,2920,5786,16129
2023-11-04,30,2346,1634,1496,2210,4481,12167
2023-11-05,30,4807,1696,2924,3472,3565,16464
2023-11-06,30,3680,2532,3563,4226,2550,16551
2023-11-07,30,4257,2960,1758,3691,3822,16488
2023-11-08,30,3424,2057,3544,2684,3984,15693
2023-11-09,30,4894,2261,1758,2390,3878,15181
2023-11-10,30,4061,1671,1779,1553,2987,12051
2023-11-11,30,1026,2978,1446,1586,4968,12004
2023-11-12,30,2553,997,1671,4183,4627,14031
2023-11-13,30,3538,1059,3039,2125,4245,14006
2023-11-14,30,1741,1206,3160,4382,5923,16412
2023-11-15,30,2068,1316,3541,4417,5096,16438
2023-11-16,30,2693,1255,2607,1818,2307,10680
2023-11-17,30,4280,2315,1646,3025,2016,13282
2023-11-18,30,4273,2455,3817,3887,4427,18859
2023-11-19,30,4864,931,2417,2010,5966,16188
2023-11-20,30,2046,1891,2483,3019,4775,14214
2023-11-21,30,3372,2556,2161,1995,3709,13793
2023-11-22,30,1647,1948,3574,4462,3305,14936
2023-11-23,30,3910,2851,1702,2362,2630,13455
2023-11-24,30,1985,831,3278,3712,2384,12190
2023-11-25,30,3915,2792,1555,2625,3197,14084
2023-11-26,30,1252,2601,1787,3496,5233,14369
2023-11-27,30,3762,1332,2653,4354,3951,16052
2023-11-28,30,2013,915,1893,4072,5061,13954
2023-11-29,30,2187,1848,1243,2605,2280,10163
2023-11-30,30,3950,1800,3896,2516,3451,15613
2023-12-01,30,1435,1273,3848,1970,5832,14358
2023-12-02,30,1996,1092,2748,2845,5705,14386
2023-12-03,30,3934,2104,3355,2039,5184,16616
2023-12-04,30,3003,2844,3784,3444,4658,17733
2023-12-05,30,3079,1915,3112,4094,2277,14477
2023-12-06,30,4049,2063,1826,4186,2129,14253
2023-12-07,30,4870,1559,1490,1600,5764,15283
2023-12-08,30,1844,2534,2503,2084,2332,11297
2023-12-09,30,2235,920,3905,3403,5200,15663
2023-12-10,30,3665,2259,1598,3716,3864,15102
2023-12-11,30,4563,2120,3902,2172,5015,17772
2023-12-12,30,4810,1633,3962,1700,4013,16118
2023-12-13,30,1355,2286,1973,2110,3088,10812
2023-12-14,30,3103,2619,3401,2854,4589,16566
2023-12-15,30,1697,1804,1808,1894,3645,10848
2023-12-16,30,2525,1768,2037,3348,5333,15011
2023-12-17,30,4212,1760,3194,2077,2513,13756
2023-12-18,30,3651,1390,1764,3491,2774,13070
2023-12-19,30,1677,1454,1770,3557,5485,13943
2023-12-20,30,4454,2324,2098,4064,4585,17525
2023-12-21,30,4822,1766,3272,3480,4579,17919
2023-12-22,30,4248,2645,1650,3115,5397,17055
2023-12-23,30,1731,2330,3758,3718,3040,14577
2023-12-24,30,3321,2974,1946,1505,3058,12804
2023-12-25,30,2391,1528,1716,3891,4563,14089
2023-12-26,30,1637,2081,2295,2224,5351,13588
2023-12-27,30,4114,1374,2378,1829,3638,13333
2023-12-28,30,2831,2818,1783,3482,2857,13771
2023-12-29,30,1225,2162,3109,3391,3044,12931
2023-12-30,30,1136,2168,3045,1804,5020,13173
2023-12-31,30,1760,862,3015,3631,5157,14425
